time,job_id,num_gpu,submit_time,start_time,end_time,executed_time,JCT,duration,pending_time,preempt,promote
931258,21,4,912416,912416,931258,18842,18842,18842,0,0,0
931389,24,16,926450,926450,931389,4939,4939,4939,0,0,0
985990,41,1,982125,982125,985990,3865,3865,3865,0,0,0
1000104,39,4,963028,963028,1000104,37076,37076,37076,0,0,0
1002141,47,1,993353,993353,1002141,8788,8788,8788,0,0,0
1005484,53,1,1003841,1003841,1005484,1643,1643,1643,0,0,0
1007779,42,4,989813,989813,1007779,17966,17966,17966,0,0,0
1009393,58,1,1007947,1007947,1009393,1446,1446,1446,0,0,0
1010364,55,8,1004200,1004200,1010364,6164,6164,6164,0,0,0
1012535,57,1,1006297,1006297,1012535,6238,6238,6238,0,0,0
1022558,49,4,999486,999486,1022558,23072,23072,23072,0,0,0
1025289,64,4,1023510,1023510,1025289,1779,1779,1779,0,0,0
1039575,18,1,906242,906242,1039575,133333,133333,133333,0,0,0
1044629,63,1,1022908,1022908,1044629,21721,21721,21721,0,0,0
1057446,73,8,1033426,1033426,1057446,24020,24020,24020,0,0,0
1086977,86,1,1078349,1078349,1086977,8628,8628,8628,0,0,0
1114631,91,1,1083560,1083560,1114631,31071,31071,31071,0,0,0
1129450,17,1,906050,906050,1129450,223400,223400,223400,0,0,0
1138678,122,8,1115754,1115754,1138678,22924,22924,22924,0,0,0
1150477,54,1,1004148,1004148,1150477,146329,146329,146329,0,0,0
1154811,83,4,1068634,1068634,1154811,86177,86177,64510,21667,1,0
1156171,126,4,1149652,1149652,1156171,6519,6519,6519,0,0,0
1174016,130,1,1158164,1158164,1174016,15852,15852,15852,0,0,0
1174693,131,1,1158343,1158343,1174693,16350,16350,16350,0,0,0
1175823,124,4,1119028,1119028,1175823,56795,56795,53957,2838,1,0
1181992,141,4,1163262,1163262,1181992,18730,18730,18730,0,0,0
1182048,116,8,1105595,1105595,1182048,76453,76453,59061,17392,2,0
1183985,95,1,1093901,1093901,1183985,90084,90084,90084,0,0,0
1185991,111,1,1099017,1099017,1185991,86974,86974,86974,0,0,0
1203924,76,1,1058834,1058834,1203924,145090,145090,145090,0,0,0
1225185,170,4,1194187,1194187,1225185,30998,30998,30998,0,0,0
1226214,151,1,1165398,1165398,1226214,60816,60816,60816,0,0,0
1226629,174,16,1223535,1223535,1226629,3094,3094,3094,0,0,0
1235463,171,4,1194668,1194668,1235463,40795,40795,40795,0,0,0
1237035,177,1,1234963,1234963,1237035,2072,2072,2072,0,0,0
1250682,140,1,1161628,1161628,1250682,89054,89054,89054,0,0,0
1256230,181,4,1241695,1241695,1256230,14535,14535,14535,0,0,0
1268265,195,4,1251897,1251897,1268265,16368,16368,16368,0,0,0
1269291,202,4,1255332,1255332,1269291,13959,13959,13959,0,0,0
1270720,159,1,1165542,1165542,1270720,105178,105178,105178,0,0,0
1273437,199,4,1255259,1255259,1273437,18178,18178,18178,0,0,0
1274247,142,1,1165251,1165251,1274247,108996,108996,108996,0,0,0
1282302,156,1,1165490,1165490,1282302,116812,116812,116812,0,0,0
1294887,196,1,1252909,1252909,1294887,41978,41978,41978,0,0,0
1327421,228,8,1326576,1326576,1327421,845,845,845,0,0,0
1334342,89,1,1078558,1078558,1334342,255784,255784,188501,67283,5,0
1343547,133,1,1161506,1161506,1343547,182041,182041,149480,32561,3,0
1351301,182,1,1244100,1244100,1351301,107201,107201,107201,0,0,0
1359350,233,16,1357023,1357023,1359350,2327,2327,2327,0,0,0
1360275,232,16,1355804,1355804,1360275,4471,4471,4471,0,0,0
1373383,238,4,1369754,1369754,1373383,3629,3629,3629,0,0,0
1376722,235,1,1365390,1365390,1376722,11332,11332,11332,0,0,0
1383124,237,16,1368374,1368374,1383124,14750,14750,14750,0,0,0
1388696,191,1,1251322,1251322,1388696,137374,137374,137374,0,0,0
1391033,226,16,1312082,1312082,1391033,78951,78951,19896,59055,2,0
1393076,72,1,1030698,1030698,1393076,362378,362378,244449,117929,2,0
1398024,247,4,1378546,1378546,1398024,19478,19478,19478,0,0,0
1400433,186,1,1245315,1245315,1400433,155118,155118,155118,0,0,0
1403093,215,1,1280138,1280138,1403093,122955,122955,122955,0,0,0
1435357,241,4,1371422,1371422,1435357,63935,63935,63935,0,0,0
1442523,251,4,1431972,1431972,1442523,10551,10551,10551,0,0,0
1466557,256,16,1450087,1450087,1466557,16470,16470,16470,0,0,0
1466925,259,4,1466312,1466312,1466925,613,613,613,0,0,0
1468525,252,4,1432024,1432024,1468525,36501,36501,36501,0,0,0
1474973,257,4,1462880,1462880,1474973,12093,12093,12093,0,0,0
1477608,214,4,1279070,1279070,1477608,198538,198538,50978,147560,4,0
1503848,263,4,1500042,1500042,1503848,3806,3806,3806,0,0,0
1515811,265,4,1501577,1501577,1515811,14234,14234,14234,0,0,0
1520326,243,16,1372999,1372999,1520326,147327,147327,16603,130724,1,0
1526068,239,4,1370008,1370008,1526068,156060,156060,94742,61318,1,0
1531702,88,2,1078520,1078520,1531702,453182,453182,219464,233718,10,0
1532104,240,4,1371390,1371390,1532104,160714,160714,99920,60794,1,0
1558552,260,4,1495907,1495907,1558552,62645,62645,62645,0,0,0
1565469,269,4,1542833,1542833,1565469,22636,22636,22636,0,0,0
1576734,261,4,1497030,1497030,1576734,79704,79704,79704,0,0,0
1576950,272,8,1546316,1546316,1576950,30634,30634,30634,0,0,0
1579650,212,8,1277547,1277547,1579650,302103,302103,59189,242914,7,0
1585854,280,8,1584868,1584868,1585854,986,986,986,0,0,0
1594531,283,1,1590920,1590920,1594531,3611,3611,3611,0,0,0
1594878,291,1,1593034,1593034,1594878,1844,1844,1844,0,0,0
1596522,286,1,1592992,1592992,1596522,3530,3530,3530,0,0,0
1598909,160,1,1167323,1167323,1598909,431586,431586,360147,71439,5,0
1602288,289,1,1593019,1593019,1602288,9269,9269,9269,0,0,0
1602620,290,1,1593027,1593027,1602620,9593,9593,9593,0,0,0
1608283,300,4,1601178,1601178,1608283,7105,7105,7105,0,0,0
1608671,305,4,1602931,1602931,1608671,5740,5740,5740,0,0,0
1609462,304,4,1602805,1602805,1609462,6657,6657,6657,0,0,0
1610039,341,1,1609030,1609030,1610039,1009,1009,1009,0,0,0
1610482,347,1,1609092,1609092,1610482,1390,1390,1390,0,0,0
1610589,315,1,1608786,1608786,1610589,1803,1803,1803,0,0,0
1610733,343,1,1609064,1609064,1610733,1669,1669,1669,0,0,0
1610819,328,1,1608902,1608902,1610819,1917,1917,1917,0,0,0
1610975,314,1,1608778,1608778,1610975,2197,2197,2197,0,0,0
1611187,313,1,1608770,1608770,1611187,2417,2417,2417,0,0,0
1612162,310,1,1608397,1608397,1612162,3765,3765,3765,0,0,0
1612396,321,1,1608835,1608835,1612396,3561,3561,3561,0,0,0
1614091,348,1,1609100,1609100,1614091,4991,4991,4991,0,0,0
1614261,301,4,1601204,1601204,1614261,13057,13057,13057,0,0,0
1614470,338,1,1609005,1609005,1614470,5465,5465,5465,0,0,0
1616132,312,1,1608762,1608762,1616132,7370,7370,7370,0,0,0
1616634,354,1,1612763,1612763,1616634,3871,3871,3871,0,0,0
1622257,275,2,1560182,1560182,1622257,62075,62075,62075,0,0,0
1623492,337,1,1608998,1608998,1623492,14494,14494,14494,0,0,0
1626965,320,1,1608828,1608828,1626965,18137,18137,18137,0,0,0
1627645,288,1,1593012,1593012,1627645,34633,34633,34633,0,0,0
1632839,356,8,1629463,1629463,1632839,3376,3376,3376,0,0,0
1634983,351,1,1609140,1609140,1634983,25843,25843,25843,0,0,0
1635311,334,1,1608974,1608974,1635311,26337,26337,26337,0,0,0
1636358,353,16,1610336,1610336,1636358,26022,26022,25553,469,2,0
1638039,336,1,1608991,1608991,1638039,29048,29048,29048,0,0,0
1639936,339,1,1609014,1609014,1639936,30922,30922,30922,0,0,0
1643446,346,1,1609085,1609085,1643446,34361,34361,34361,0,0,0
1644498,309,1,1608348,1608348,1644498,36150,36150,36150,0,0,0
1646801,349,1,1609126,1609126,1646801,37675,37675,37675,0,0,0
1647902,295,1,1593071,1593071,1647902,54831,54831,54831,0,0,0
1648519,332,1,1608935,1608935,1648519,39584,39584,39584,0,0,0
1649290,333,1,1608942,1608942,1649290,40348,40348,40348,0,0,0
1659409,323,1,1608850,1608850,1659409,50559,50559,50559,0,0,0
1659875,318,1,1608814,1608814,1659875,51061,51061,51061,0,0,0
1663165,287,1,1593003,1593003,1663165,70162,70162,70162,0,0,0
1664870,363,1,1664264,1664264,1664870,606,606,606,0,0,0
1674022,296,8,1599339,1599339,1674022,74683,74683,49656,25027,1,0
1683406,317,1,1608801,1608801,1683406,74605,74605,74605,0,0,0
1686126,285,1,1592985,1592985,1686126,93141,93141,93141,0,0,0
1690720,92,1,1087027,1087027,1690720,603693,603693,354382,249311,10,0
1703059,366,1,1678208,1678208,1703059,24851,24851,24851,0,0,0
1719895,476,4,1714667,1714667,1719895,5228,5228,5228,0,0,0
1721693,470,4,1712214,1712214,1721693,9479,9479,9479,0,0,0
1726641,472,4,1713270,1713270,1726641,13371,13371,13371,0,0,0
1750131,404,1,1690844,1690844,1750131,59287,59287,59287,0,0,0
1756644,344,1,1609071,1609071,1756644,147573,147573,101992,45581,5,0
1757946,322,1,1608843,1608843,1757946,149103,149103,105653,43450,4,0
1759516,480,4,1754118,1754118,1759516,5398,5398,5398,0,0,0
1776208,484,4,1775797,1775797,1776208,411,411,411,0,0,0
1776502,394,1,1690772,1690772,1776502,85730,85730,85730,0,0,0
1790112,385,1,1690711,1690711,1790112,99401,99401,99401,0,0,0
1792483,372,1,1690262,1690262,1792483,102221,102221,102221,0,0,0
1792579,406,1,1690857,1690857,1792579,101722,101722,101722,0,0,0
1792698,402,1,1690828,1690828,1792698,101870,101870,101870,0,0,0
1792901,384,1,1690704,1690704,1792901,102197,102197,102197,0,0,0
1792986,382,1,1690688,1690688,1792986,102298,102298,102298,0,0,0
1800277,429,1,1691284,1691284,1800277,108993,108993,108993,0,0,0
1803574,401,1,1690821,1690821,1803574,112753,112753,112753,0,0,0
1804519,451,1,1691800,1691800,1804519,112719,112719,112719,0,0,0
1807215,445,1,1691652,1691652,1807215,115563,115563,115563,0,0,0
1825724,319,1,1608822,1608822,1825724,216902,216902,151052,65850,6,0
1826653,327,1,1608894,1608894,1826653,217759,217759,133730,84029,6,0
1833192,367,1,1685457,1685457,1833192,147735,147735,147735,0,0,0
1844326,490,4,1842655,1842655,1844326,1671,1671,1671,0,0,0
1869684,505,8,1867662,1867662,1869684,2022,2022,2022,0,0,0
1870638,357,1,1634921,1634921,1870638,235717,235717,182067,53650,8,0
1883338,500,8,1862599,1862599,1883338,20739,20739,20739,0,0,0
1887898,507,1,1873295,1873295,1887898,14603,14603,14603,0,0,0
1902209,513,16,1884835,1884835,1902209,17374,17374,17374,0,0,0
1903437,477,8,1724431,1724431,1903437,179006,179006,28821,150185,5,0
1908416,514,8,1886160,1886160,1908416,22256,22256,22256,0,0,0
1925945,509,1,1874029,1874029,1925945,51916,51916,51916,0,0,0
1927842,520,4,1925297,1925297,1927842,2545,2545,2545,0,0,0
1934988,335,1,1608983,1608983,1934988,326005,326005,194981,131024,10,0
1942276,330,1,1608921,1608921,1942276,333355,333355,198995,134360,13,0
1948035,532,1,1944973,1944973,1948035,3062,3062,3062,0,0,0
1953100,492,4,1844396,1844396,1953100,108704,108704,86534,22170,2,0
1963260,534,4,1949120,1949120,1963260,14140,14140,14140,0,0,0
1967158,552,1,1966322,1966322,1967158,836,836,836,0,0,0
1967849,551,1,1966298,1966298,1967849,1551,1551,1551,0,0,0
1975260,556,1,1974128,1974128,1975260,1132,1132,1132,0,0,0
1975430,352,1,1609148,1609148,1975430,366282,366282,221668,144614,9,0
1984481,531,4,1944769,1944769,1984481,39712,39712,39712,0,0,0
1991074,294,1,1593064,1593064,1991074,398010,398010,240635,157375,20,0
1993883,345,1,1609078,1609078,1993883,384805,384805,230792,154013,14,0
1994012,511,1,1876368,1876368,1994012,117644,117644,117644,0,0,0
1994778,550,1,1966274,1966274,1994778,28504,28504,28504,0,0,0
1995470,560,2,1978854,1978854,1995470,16616,16616,16616,0,0,0
2006525,284,1,1592975,1592975,2006525,413550,413550,256309,157241,18,0
2009229,567,2,1981247,1981247,2009229,27982,27982,27982,0,0,0
2010095,603,1,2008146,2008146,2010095,1949,1949,1949,0,0,0
2011072,613,1,2008386,2008386,2011072,2686,2686,2686,0,0,0
2011731,597,1,2007995,2007995,2011731,3736,3736,3736,0,0,0
2036652,601,1,2008130,2008130,2036652,28522,28522,28522,0,0,0
2037215,614,1,2008408,2008408,2037215,28807,28807,28807,0,0,0
2041105,607,1,2008290,2008290,2041105,32815,32815,32815,0,0,0
2041150,592,1,2007925,2007925,2041150,33225,33225,33225,0,0,0
2048443,582,4,2001933,2001933,2048443,46510,46510,46510,0,0,0
2048567,329,1,1608914,1608914,2048567,439653,439653,247724,191929,15,0
2050608,548,1,1966198,1966198,2050608,84410,84410,84410,0,0,0
2051891,544,1,1965715,1965715,2051891,86176,86176,86176,0,0,0
2055146,598,1,2008086,2008086,2055146,47060,47060,47060,0,0,0
2055872,292,1,1593050,1593050,2055872,462822,462822,271209,191613,19,0
2059580,569,1,1982000,1982000,2059580,77580,77580,77580,0,0,0
2060906,604,1,2008157,2008157,2060906,52749,52749,52749,0,0,0
2064114,605,1,2008170,2008170,2064114,55944,55944,55944,0,0,0
2071032,311,1,1608755,1608755,2071032,462277,462277,273838,188439,15,0
2076324,568,1,1981979,1981979,2076324,94345,94345,94345,0,0,0
2082263,599,1,2008098,2008098,2082263,74165,74165,74165,0,0,0
2086053,595,1,2007965,2007965,2086053,78088,78088,78088,0,0,0
2088911,342,1,1609055,1609055,2088911,479856,479856,288709,191147,13,0
2096910,620,1,2058069,2058069,2096910,38841,38841,38841,0,0,0
2112812,482,1,1773103,1773103,2112812,339709,339709,218757,120952,1,0
2113564,593,1,2007937,2007937,2113564,105627,105627,105627,0,0,0
2115802,600,1,2008116,2008116,2115802,107686,107686,107686,0,0,0
2128188,576,2,1996785,1996785,2128188,131403,131403,131403,0,0,0
2129893,545,1,1965766,1965766,2129893,164127,164127,164127,0,0,0
2139321,622,8,2133105,2133105,2139321,6216,6216,6216,0,0,0
2140173,326,1,1608886,1608886,2140173,531287,531287,339505,191782,18,0
2160663,627,8,2150018,2150018,2160663,10645,10645,10645,0,0,0
2163288,583,1,2006324,2006324,2163288,156964,156964,156964,0,0,0
2171849,636,2,2153195,2153195,2171849,18654,18654,18654,0,0,0
2188604,649,4,2186327,2186327,2188604,2277,2277,2277,0,0,0
2196512,501,1,1862795,1862795,2196512,333717,333717,275251,58466,4,0
2197640,656,4,2197006,2197006,2197640,634,634,634,0,0,0
2198390,651,4,2190311,2190311,2198390,8079,8079,8079,0,0,0
2206054,648,1,2183536,2183536,2206054,22518,22518,22518,0,0,0
2232551,638,1,2153529,2153529,2232551,79022,79022,79022,0,0,0
2237308,658,4,2200224,2200224,2237308,37084,37084,37084,0,0,0
2242643,660,4,2206543,2206543,2242643,36100,36100,36100,0,0,0
2257843,671,1,2223276,2223276,2257843,34567,34567,34567,0,0,0
2258902,647,1,2182300,2182300,2258902,76602,76602,76602,0,0,0
2259201,685,1,2249168,2249168,2259201,10033,10033,10033,0,0,0
2268386,672,4,2223453,2223453,2268386,44933,44933,44933,0,0,0
2296984,692,8,2281652,2281652,2296984,15332,15332,15332,0,0,0
2305968,693,4,2285347,2285347,2305968,20621,20621,20621,0,0,0
2308539,681,1,2237299,2237299,2308539,71240,71240,71240,0,0,0
2310973,703,1,2308721,2308721,2310973,2252,2252,2252,0,0,0
2315621,708,8,2310700,2310700,2315621,4921,4921,4921,0,0,0
2323899,713,1,2318623,2318623,2323899,5276,5276,5276,0,0,0
2330279,711,4,2314770,2314770,2330279,15509,15509,15509,0,0,0
2334872,695,1,2295536,2295536,2334872,39336,39336,39336,0,0,0
2349835,676,1,2225454,2225454,2349835,124381,124381,122945,1436,1,0
2367809,725,8,2335207,2335207,2367809,32602,32602,32602,0,0,0
2369456,724,1,2330881,2330881,2369456,38575,38575,38575,0,0,0
2377681,634,2,2153142,2153142,2377681,224539,224539,177818,46721,5,0
2385729,740,4,2379419,2379419,2385729,6310,6310,6310,0,0,0
2395607,729,1,2356683,2356683,2395607,38924,38924,38924,0,0,0
2408245,755,1,2406881,2406881,2408245,1364,1364,1364,0,0,0
2413366,761,1,2410799,2410799,2413366,2567,2567,2567,0,0,0
2417314,736,4,2373939,2373939,2417314,43375,43375,43375,0,0,0
2441562,759,1,2409923,2409923,2441562,31639,31639,31639,0,0,0
2445549,766,16,2419971,2419971,2445549,25578,25578,22068,3510,1,0
2474068,781,8,2462128,2462128,2474068,11940,11940,11940,0,0,0
2474789,783,8,2466707,2466707,2474789,8082,8082,8082,0,0,0
2478165,782,1,2464078,2464078,2478165,14087,14087,14087,0,0,0
2479268,775,1,2450238,2450238,2479268,29030,29030,29030,0,0,0
2510091,694,1,2288358,2288358,2510091,221733,221733,216161,5572,5,0
2532311,816,4,2530447,2530447,2532311,1864,1864,1864,0,0,0
2541717,791,1,2482274,2482274,2541717,59443,59443,59443,0,0,0
2543878,769,1,2420202,2420202,2543878,123676,123676,123676,0,0,0
2555380,814,4,2528328,2528328,2555380,27052,27052,27052,0,0,0
2561265,815,4,2530428,2530428,2561265,30837,30837,30837,0,0,0
2574863,407,1,1690862,1690862,2574863,884001,884001,246718,637283,6,0
2583452,826,4,2550621,2550621,2583452,32831,32831,32831,0,0,0
2610235,409,1,1690866,1690866,2610235,919369,919369,268409,650960,7,0
2662276,822,1,2540419,2540419,2662276,121857,121857,121857,0,0,0
2673013,837,2,2662093,2662093,2673013,10920,10920,10920,0,0,0
2682311,809,8,2507193,2507193,2682311,175118,175118,32958,142160,3,0
2714444,856,1,2705681,2705681,2714444,8763,8763,8763,0,0,0
2724131,546,1,1966138,1966138,2724131,757993,757993,223074,534919,5,0
2731645,851,4,2668703,2668703,2731645,62942,62942,62942,0,0,0
2745426,880,8,2738970,2738970,2745426,6456,6456,6456,0,0,0
2760656,890,1,2750632,2750632,2760656,10024,10024,10024,0,0,0
2765888,861,2,2736332,2736332,2765888,29556,29556,29556,0,0,0
2773823,831,1,2605962,2605962,2773823,167861,167861,155097,12764,6,0
2773883,912,4,2771579,2771579,2773883,2304,2304,2304,0,0,0
2776073,905,8,2767308,2767308,2776073,8765,8765,8765,0,0,0
2776225,898,1,2755645,2755645,2776225,20580,20580,20580,0,0,0
2779831,894,4,2754107,2754107,2779831,25724,25724,25724,0,0,0
2798791,928,1,2798007,2798007,2798791,784,784,784,0,0,0
2799395,909,1,2769560,2769560,2799395,29835,29835,29835,0,0,0
2802191,931,1,2801211,2801211,2802191,980,980,980,0,0,0
2802284,927,1,2797842,2797842,2802284,4442,4442,4442,0,0,0
2810112,925,4,2796000,2796000,2810112,14112,14112,14112,0,0,0
2812025,943,1,2809529,2809529,2812025,2496,2496,2496,0,0,0
2814912,951,4,2811545,2811545,2814912,3367,3367,3367,0,0,0
2817575,876,1,2738244,2738244,2817575,79331,79331,79331,0,0,0
2819240,954,16,2812234,2812234,2819240,7006,7006,7006,0,0,0
2822623,868,1,2736548,2736548,2822623,86075,86075,86075,0,0,0
2826492,935,1,2804436,2804436,2826492,22056,22056,22056,0,0,0
2827555,933,1,2801505,2801505,2827555,26050,26050,26050,0,0,0
2828955,916,2,2783923,2783923,2828955,45032,45032,45032,0,0,0
2832713,962,1,2826624,2826624,2832713,6089,6089,6089,0,0,0
2834394,950,1,2811290,2811290,2834394,23104,23104,23104,0,0,0
2840249,956,1,2816767,2816767,2840249,23482,23482,23482,0,0,0
2846300,978,8,2839393,2839393,2846300,6907,6907,6907,0,0,0
2856676,936,1,2804850,2804850,2856676,51826,51826,51826,0,0,0
2863332,948,1,2811215,2811215,2863332,52117,52117,52117,0,0,0
2863471,966,8,2829120,2829120,2863471,34351,34351,16741,17610,4,0
2871368,979,4,2839402,2839402,2871368,31966,31966,31966,0,0,0
2878009,929,1,2799257,2799257,2878009,78752,78752,78752,0,0,0
2889628,996,16,2880718,2880718,2889628,8910,8910,8910,0,0,0
2889680,995,1,2877619,2877619,2889680,12061,12061,12061,0,0,0
2894926,999,1,2882057,2882057,2894926,12869,12869,12869,0,0,0
2896538,1015,1,2893482,2893482,2896538,3056,3056,3056,0,0,0
2896584,1014,1,2893452,2893452,2896584,3132,3132,3132,0,0,0
2898663,1022,1,2896131,2896131,2898663,2532,2532,2532,0,0,0
2907505,1026,1,2904303,2904303,2907505,3202,3202,3202,0,0,0
2926551,938,1,2806604,2806604,2926551,119947,119947,119947,0,0,0
2931055,1009,4,2890440,2890440,2931055,40615,40615,40615,0,0,0
2937009,1017,1,2893731,2893731,2937009,43278,43278,43278,0,0,0
2938661,957,1,2821978,2821978,2938661,116683,116683,116683,0,0,0
2944191,993,1,2877529,2877529,2944191,66662,66662,66662,0,0,0
2945510,847,1,2662359,2662359,2945510,283151,283151,188897,94254,7,0
2955250,1034,1,2924989,2924989,2955250,30261,30261,30261,0,0,0
2967330,1011,8,2891633,2891633,2967330,75697,75697,31855,43842,1,0
2970106,1037,1,2961144,2961144,2970106,8962,8962,8962,0,0,0
2976999,1039,1,2968473,2968473,2976999,8526,8526,8526,0,0,0
2981728,1048,1,2978540,2978540,2981728,3188,3188,3188,0,0,0
2986093,1053,1,2982970,2982970,2986093,3123,3123,3123,0,0,0
2986437,1003,1,2882730,2882730,2986437,103707,103707,103707,0,0,0
2987579,555,1,1972359,1972359,2987579,1015220,1015220,225615,789605,4,0
2989406,973,16,2836301,2836301,2989406,153105,153105,24118,128987,9,0
2997787,977,4,2839259,2839259,2997787,158528,158528,67175,91353,5,0
3000386,1044,1,2972870,2972870,3000386,27516,27516,27516,0,0,0
3001043,1040,4,2969900,2969900,3001043,31143,31143,31143,0,0,0
3003332,1065,8,2997034,2997034,3003332,6298,6298,6298,0,0,0
3004118,1069,8,3003144,3003144,3004118,974,974,974,0,0,0
3010515,1041,1,2971369,2971369,3010515,39146,39146,39146,0,0,0
3014570,1068,8,3002159,3002159,3014570,12411,12411,12411,0,0,0
3026431,997,1,2880886,2880886,3026431,145545,145545,145545,0,0,0
3036180,1086,4,3020342,3020342,3036180,15838,15838,15838,0,0,0
3041730,1050,1,2980938,2980938,3041730,60792,60792,60792,0,0,0
3043382,1000,1,2882080,2882080,3043382,161302,161302,161302,0,0,0
3045544,1080,1,3015678,3015678,3045544,29866,29866,29866,0,0,0
3048792,1084,1,3018622,3018622,3048792,30170,30170,30170,0,0,0
3050333,1096,8,3046093,3046093,3050333,4240,4240,4240,0,0,0
3057135,1051,1,2982335,2982335,3057135,74800,74800,74800,0,0,0
3064789,1111,8,3058804,3058804,3064789,5985,5985,5985,0,0,0
3066018,1114,8,3059698,3059698,3066018,6320,6320,6320,0,0,0
3067408,1098,1,3051645,3051645,3067408,15763,15763,15763,0,0,0
3075478,1052,1,2982676,2982676,3075478,92802,92802,92802,0,0,0
3076797,1124,8,3069894,3069894,3076797,6903,6903,6903,0,0,0
3078438,1102,1,3055049,3055049,3078438,23389,23389,23389,0,0,0
3091568,1129,1,3073639,3073639,3091568,17929,17929,17929,0,0,0
3092625,1135,1,3081141,3081141,3092625,11484,11484,11484,0,0,0
3099604,1081,1,3018107,3018107,3099604,81497,81497,81497,0,0,0
3105274,1134,1,3081111,3081111,3105274,24163,24163,24163,0,0,0
3107377,1147,1,3097131,3097131,3107377,10246,10246,10246,0,0,0
3113519,1013,1,2891773,2891773,3113519,221746,221746,190848,30898,12,0
3116539,1155,16,3114442,3114442,3116539,2097,2097,2097,0,0,0
3132395,1046,1,2977576,2977576,3132395,154819,154819,133847,20972,4,0
3149404,1149,1,3102509,3102509,3149404,46895,46895,46895,0,0,0
3149621,1152,16,3107889,3107889,3149621,41732,41732,12775,28957,2,0
3151532,1089,1,3043312,3043312,3151532,108220,108220,108220,0,0,0
3153184,1118,1,3064913,3064913,3153184,88271,88271,88271,0,0,0
3155355,1159,1,3122038,3122038,3155355,33317,33317,33317,0,0,0
3161979,1164,8,3156300,3156300,3161979,5679,5679,5679,0,0,0
3164103,1163,4,3151206,3151206,3164103,12897,12897,12897,0,0,0
3181758,1145,8,3095341,3095341,3181758,86417,86417,46325,40092,6,0
3201917,1106,1,3056064,3056064,3201917,145853,145853,145853,0,0,0
3224357,1108,1,3056816,3056816,3224357,167541,167541,167541,0,0,0
3231691,1105,1,3055728,3055728,3231691,175963,175963,175963,0,0,0
3281087,1168,1,3165566,3165566,3281087,115521,115521,115521,0,0,0
3285830,1070,1,3004977,3004977,3285830,280853,280853,272199,8654,4,0
3340834,1255,1,3279710,3279710,3340834,61124,61124,61124,0,0,0
3352688,1244,1,3251739,3251739,3352688,100949,100949,100949,0,0,0
3354926,1274,8,3350039,3350039,3354926,4887,4887,4887,0,0,0
3356080,1262,1,3335050,3335050,3356080,21030,21030,21030,0,0,0
3358239,1276,8,3357468,3357468,3358239,771,771,771,0,0,0
3359545,1282,1,3359134,3359134,3359545,411,411,411,0,0,0
3363478,1301,1,3362009,3362009,3363478,1469,1469,1469,0,0,0
3365193,1311,1,3363038,3363038,3365193,2155,2155,2155,0,0,0
3366159,1304,1,3362093,3362093,3366159,4066,4066,4066,0,0,0
3368343,1327,1,3366667,3366667,3368343,1676,1676,1676,0,0,0
3369564,1280,1,3359133,3359133,3369564,10431,10431,10431,0,0,0
3370175,1331,1,3369000,3369000,3370175,1175,1175,1175,0,0,0
3372598,1319,1,3364413,3364413,3372598,8185,8185,8185,0,0,0
3389384,1259,1,3329599,3329599,3389384,59785,59785,59160,625,1,0
3389596,1284,4,3359587,3359587,3389596,30009,30009,29384,625,1,0
3397183,1263,1,3338630,3338630,3397183,58553,58553,58553,0,0,0
3398132,1290,1,3360234,3360234,3398132,37898,37898,37898,0,0,0
3399654,1322,1,3365657,3365657,3399654,33997,33997,33997,0,0,0
3401115,1344,8,3400170,3400170,3401115,945,945,945,0,0,0
3404887,1266,1,3342588,3342588,3404887,62299,62299,61674,625,1,0
3407440,1346,8,3401046,3401046,3407440,6394,6394,6394,0,0,0
3410859,1348,16,3402699,3402699,3410859,8160,8160,8160,0,0,0
3429060,1361,4,3418942,3418942,3429060,10118,10118,10118,0,0,0
3429793,1373,1,3428247,3428247,3429793,1546,1546,1546,0,0,0
3429958,1350,1,3404105,3404105,3429958,25853,25853,25853,0,0,0
3430487,1364,1,3419511,3419511,3430487,10976,10976,10976,0,0,0
3446427,1389,1,3444884,3444884,3446427,1543,1543,1543,0,0,0
3446985,1392,1,3444948,3444948,3446985,2037,2037,2037,0,0,0
3450180,1387,1,3444524,3444524,3450180,5656,5656,5656,0,0,0
3457996,1294,1,3360356,3360356,3457996,97640,97640,92331,5309,5,0
3461264,1391,1,3444925,3444925,3461264,16339,16339,16339,0,0,0
3467915,1354,1,3409100,3409100,3467915,58815,58815,58815,0,0,0
3473198,1283,1,3359380,3359380,3473198,113818,113818,111915,1903,3,0
3475492,1315,1,3363614,3363614,3475492,111878,111878,107259,4619,2,0
3476171,1352,1,3404165,3404165,3476171,72006,72006,72006,0,0,0
3481695,1357,1,3411603,3411603,3481695,70092,70092,70092,0,0,0
3481732,1261,1,3333053,3333053,3481732,148679,148679,141652,7027,1,0
3483670,1310,1,3362983,3362983,3483670,120687,120687,116273,4414,1,0
3490749,1281,1,3359133,3359133,3490749,131616,131616,129756,1860,3,0
3494147,1279,1,3359133,3359133,3494147,135014,135014,133115,1899,3,0
3496618,1316,1,3363638,3363638,3496618,132980,132980,126551,6429,1,0
3498979,1413,8,3497355,3497355,3498979,1624,1624,1624,0,0,0
3500452,1403,1,3455383,3455383,3500452,45069,45069,45069,0,0,0
3501899,1417,4,3500240,3500240,3501899,1659,1659,1659,0,0,0
3504058,1396,1,3445081,3445081,3504058,58977,58977,58977,0,0,0
3506223,1424,4,3502023,3502023,3506223,4200,4200,4200,0,0,0
3513025,1420,8,3501679,3501679,3513025,11346,11346,11346,0,0,0
3518425,1433,8,3512747,3512747,3518425,5678,5678,5678,0,0,0
3518517,1438,1,3517032,3517032,3518517,1485,1485,1485,0,0,0
3523176,1445,8,3518210,3518210,3523176,4966,4966,4966,0,0,0
3526612,1368,1,3427475,3427475,3526612,99137,99137,99137,0,0,0
3534963,1455,1,3530069,3530069,3534963,4894,4894,4894,0,0,0
3536072,1446,1,3518233,3518233,3536072,17839,17839,17839,0,0,0
3543797,1462,1,3541523,3541523,3543797,2274,2274,2274,0,0,0
3544464,1464,1,3541938,3541938,3544464,2526,2526,2526,0,0,0
3551193,1450,1,3529058,3529058,3551193,22135,22135,22135,0,0,0
3559233,1432,1,3511645,3511645,3559233,47588,47588,47588,0,0,0
3559370,1451,1,3529148,3529148,3559370,30222,30222,30222,0,0,0
3561301,1453,1,3529655,3529655,3561301,31646,31646,31646,0,0,0
3562075,1454,1,3529934,3529934,3562075,32141,32141,32141,0,0,0
3568373,1463,8,3541924,3541924,3568373,26449,26449,24808,1641,1,0
3580408,1458,1,3537196,3537196,3580408,43212,43212,43212,0,0,0
3580876,1457,1,3537065,3537065,3580876,43811,43811,43811,0,0,0
3584734,1456,1,3530171,3530171,3584734,54563,54563,54563,0,0,0
3591582,1473,1,3581313,3581313,3591582,10269,10269,10269,0,0,0
3592000,1459,1,3537306,3537306,3592000,54694,54694,54694,0,0,0
3592400,1426,8,3503418,3503418,3592400,88982,88982,23379,65603,5,0
3597997,1379,1,3437574,3437574,3597997,160423,160423,160423,0,0,0
3611362,1488,1,3604657,3604657,3611362,6705,6705,6705,0,0,0
3620398,1182,1,3193448,3193448,3620398,426950,426950,190897,236053,12,0
3623967,1508,1,3617797,3617797,3623967,6170,6170,6170,0,0,0
3625012,1523,1,3623039,3623039,3625012,1973,1973,1973,0,0,0
3625026,1475,1,3586937,3586937,3625026,38089,38089,38089,0,0,0
3625045,1522,1,3622956,3622956,3625045,2089,2089,2089,0,0,0
3627072,1512,1,3621074,3621074,3627072,5998,5998,5998,0,0,0
3628715,1501,1,3617060,3617060,3628715,11655,11655,11655,0,0,0
3630564,1474,1,3585504,3585504,3630564,45060,45060,45060,0,0,0
3632412,1514,1,3622084,3622084,3632412,10328,10328,10328,0,0,0
3632669,1477,4,3594743,3594743,3632669,37926,37926,37926,0,0,0
3633806,1472,1,3580224,3580224,3633806,53582,53582,53582,0,0,0
3634556,1526,8,3623438,3623438,3634556,11118,11118,11118,0,0,0
3636997,1499,1,3616896,3616896,3636997,20101,20101,20101,0,0,0
3637792,1497,1,3616104,3616104,3637792,21688,21688,21688,0,0,0
3643128,1503,1,3617456,3617456,3643128,25672,25672,25672,0,0,0
3644186,1521,1,3622884,3622884,3644186,21302,21302,21302,0,0,0
3647215,1502,1,3617144,3617144,3647215,30071,30071,30071,0,0,0
3648232,1513,1,3621920,3621920,3648232,26312,26312,26312,0,0,0
3650304,1376,1,3437032,3437032,3650304,213272,213272,183736,29536,8,0
3662232,1539,1,3635605,3635605,3662232,26627,26627,26627,0,0,0
3662815,1506,1,3617583,3617583,3662815,45232,45232,45232,0,0,0
3663487,1214,1,3193586,3193586,3663487,469901,469901,185774,284127,13,0
3665653,1534,1,3625896,3625896,3665653,39757,39757,39757,0,0,0
3667100,1538,1,3634332,3634332,3667100,32768,32768,32768,0,0,0
3669319,1494,1,3615514,3615514,3669319,53805,53805,53805,0,0,0
3672012,1519,1,3622703,3622703,3672012,49309,49309,49309,0,0,0
3672462,1532,1,3625250,3625250,3672462,47212,47212,47212,0,0,0
3683815,1442,1,3517854,3517854,3683815,165961,165961,165961,0,0,0
3686274,1443,1,3517999,3517999,3686274,168275,168275,166928,1347,1,0
3687174,1515,1,3622334,3622334,3687174,64840,64840,64840,0,0,0
3696391,1520,1,3622812,3622812,3696391,73579,73579,73579,0,0,0
3708994,1571,1,3706239,3706239,3708994,2755,2755,2755,0,0,0
3709678,1575,1,3707765,3707765,3709678,1913,1913,1913,0,0,0
3710058,1577,1,3708089,3708089,3710058,1969,1969,1969,0,0,0
3710484,1578,1,3708232,3708232,3710484,2252,2252,2252,0,0,0
3711127,1583,1,3708635,3708635,3711127,2492,2492,2492,0,0,0
3711349,1581,1,3708485,3708485,3711349,2864,2864,2864,0,0,0
3713594,1533,1,3625753,3625753,3713594,87841,87841,87841,0,0,0
3717730,1573,1,3706329,3706329,3717730,11401,11401,11401,0,0,0
3718692,1570,1,3706039,3706039,3718692,12653,12653,12653,0,0,0
3723198,1535,1,3626244,3626244,3723198,96954,96954,96954,0,0,0
3724205,1580,1,3708405,3708405,3724205,15800,15800,15800,0,0,0
3724708,1574,8,3706428,3706428,3724708,18280,18280,18280,0,0,0
3727298,1524,1,3623111,3623111,3727298,104187,104187,104187,0,0,0
3751512,1582,1,3708556,3708556,3751512,42956,42956,42956,0,0,0
3751766,1566,1,3705591,3705591,3751766,46175,46175,46175,0,0,0
3757458,1579,1,3708324,3708324,3757458,49134,49134,49134,0,0,0
3757599,1586,1,3708871,3708871,3757599,48728,48728,48728,0,0,0
3760326,1550,2,3685334,3685334,3760326,74992,74992,74992,0,0,0
3763137,1363,1,3419422,3419422,3763137,343715,343715,237154,106561,7,0
3776306,1596,1,3761771,3761771,3776306,14535,14535,14535,0,0,0
3800326,1612,1,3782099,3782099,3800326,18227,18227,18227,0,0,0
3804339,1548,1,3668548,3668548,3804339,135791,135791,135791,0,0,0
3807560,1613,1,3783673,3783673,3807560,23887,23887,23887,0,0,0
3808689,1611,4,3777479,3777479,3808689,31210,31210,31210,0,0,0
3850470,1634,2,3797326,3797326,3850470,53144,53144,53144,0,0,0
3850972,1659,8,3849649,3849649,3850972,1323,1323,1323,0,0,0
3857075,1609,1,3772020,3772020,3857075,85055,85055,85055,0,0,0
3869114,1614,1,3784102,3784102,3869114,85012,85012,85012,0,0,0
3876977,1637,2,3798139,3798139,3876977,78838,78838,78838,0,0,0
3881684,1661,1,3849992,3849992,3881684,31692,31692,31692,0,0,0
3890355,1635,2,3797920,3797920,3890355,92435,92435,92435,0,0,0
3903141,1667,8,3889980,3889980,3903141,13161,13161,13161,0,0,0
3952064,1686,1,3949869,3949869,3952064,2195,2195,2195,0,0,0
3952093,1687,1,3949952,3949952,3952093,2141,2141,2141,0,0,0
3957088,1682,8,3948277,3948277,3957088,8811,8811,8811,0,0,0
3957575,1676,4,3937928,3937928,3957575,19647,19647,19647,0,0,0
3961148,1633,1,3797268,3797268,3961148,163880,163880,163880,0,0,0
3962841,1708,1,3961673,3961673,3962841,1168,1168,1168,0,0,0
3962993,1706,1,3961531,3961531,3962993,1462,1462,1462,0,0,0
3963023,1710,1,3961834,3961834,3963023,1189,1189,1189,0,0,0
3963489,1700,1,3960993,3960993,3963489,2496,2496,2496,0,0,0
3964516,1711,1,3961903,3961903,3964516,2613,2613,2613,0,0,0
3964752,1695,1,3960326,3960326,3964752,4426,4426,4426,0,0,0
3965482,1674,4,3935479,3935479,3965482,30003,30003,30003,0,0,0
3966751,1696,1,3960736,3960736,3966751,6015,6015,6015,0,0,0
3969120,1688,1,3950047,3950047,3969120,19073,19073,19073,0,0,0
3969474,1715,8,3965169,3965169,3969474,4305,4305,4305,0,0,0
3971415,1690,1,3950183,3950183,3971415,21232,21232,21232,0,0,0
3972810,1685,1,3949787,3949787,3972810,23023,23023,23023,0,0,0
3976979,1721,8,3975795,3975795,3976979,1184,1184,1184,0,0,0
3979753,1707,1,3961599,3961599,3979753,18154,18154,18154,0,0,0
3979963,1714,8,3963849,3963849,3979963,16114,16114,16114,0,0,0
3981852,1699,1,3960924,3960924,3981852,20928,20928,20928,0,0,0
3991410,1722,8,3980117,3980117,3991410,11293,11293,11293,0,0,0
3993579,1709,1,3961747,3961747,3993579,31832,31832,31832,0,0,0
3993998,1718,1,3970334,3970334,3993998,23664,23664,23664,0,0,0
4001254,1698,8,3960830,3960830,4001254,40424,40424,39574,850,1,0
4015133,1727,1,4012586,4012586,4015133,2547,2547,2547,0,0,0
4016420,1728,4,4013947,4013947,4016420,2473,2473,2473,0,0,0
4016858,1684,1,3949690,3949690,4016858,67168,67168,67168,0,0,0
4024023,1740,8,4020490,4020490,4024023,3533,3533,3533,0,0,0
4024793,1726,1,4010915,4010915,4024793,13878,13878,13878,0,0,0
4027373,1729,1,4014555,4014555,4027373,12818,12818,12818,0,0,0
4028097,1731,4,4016264,4016264,4028097,11833,11833,11833,0,0,0
4030325,1732,1,4016446,4016446,4030325,13879,13879,13879,0,0,0
4037616,1744,8,4031959,4031959,4037616,5657,5657,5657,0,0,0
4041133,1746,8,4034191,4034191,4041133,6942,6942,6942,0,0,0
4041543,1745,8,4034063,4034063,4041543,7480,7480,7480,0,0,0
4051136,1736,4,4019116,4019116,4051136,32020,32020,32020,0,0,0
4054519,1733,1,4016536,4016536,4054519,37983,37983,37983,0,0,0
4060479,1701,1,3961080,3961080,4060479,99399,99399,99399,0,0,0
4065358,1758,8,4052711,4052711,4065358,12647,12647,12647,0,0,0
4083806,1764,8,4062291,4062291,4083806,21515,21515,21515,0,0,0
4087843,1767,4,4085795,4085795,4087843,2048,2048,2048,0,0,0
4112026,1734,1,4016712,4016712,4112026,95314,95314,95314,0,0,0
4118121,1565,1,3703723,3703723,4118121,414398,414398,216628,197770,7,0
4126893,1793,1,4124502,4124502,4126893,2391,2391,2391,0,0,0
4127347,1802,1,4126148,4126148,4127347,1199,1199,1199,0,0,0
4127746,1803,1,4126346,4126346,4127746,1400,1400,1400,0,0,0
4133654,1703,1,3961334,3961334,4133654,172320,172320,172320,0,0,0
4133729,1787,1,4109733,4109733,4133729,23996,23996,23996,0,0,0
4134288,1775,1,4092939,4092939,4134288,41349,41349,41349,0,0,0
4142064,1800,1,4125628,4125628,4142064,16436,16436,16436,0,0,0
4143670,1739,1,4020373,4020373,4143670,123297,123297,123297,0,0,0
4154854,1782,1,4104385,4104385,4154854,50469,50469,50469,0,0,0
4155995,1806,4,4138995,4138995,4155995,17000,17000,17000,0,0,0
4160080,1797,1,4125000,4125000,4160080,35080,35080,35080,0,0,0
4162062,1697,1,3960814,3960814,4162062,201248,201248,194317,6931,2,0
4166011,1801,1,4125921,4125921,4166011,40090,40090,40090,0,0,0
4169161,1799,1,4125286,4125286,4169161,43875,43875,43875,0,0,0
4170102,1691,1,3953261,3953261,4170102,216841,216841,206449,10392,1,0
4174803,1107,1,3056638,3056638,4174803,1118165,1118165,281853,836312,5,0
4188328,1820,4,4187223,4187223,4188328,1105,1105,1105,0,0,0
4204056,1830,8,4200134,4200134,4204056,3922,3922,3922,0,0,0
4205546,1822,4,4188140,4188140,4205546,17406,17406,17406,0,0,0
4205943,1831,1,4204965,4204965,4205943,978,978,978,0,0,0
4207828,1821,2,4187459,4187459,4207828,20369,20369,20369,0,0,0
4212079,1824,2,4189402,4189402,4212079,22677,22677,22677,0,0,0
4213408,1829,4,4197529,4197529,4213408,15879,15879,15879,0,0,0
4216144,1828,4,4197288,4197288,4216144,18856,18856,18856,0,0,0
4221952,1819,8,4187061,4187061,4221952,34891,34891,31703,3188,1,0
4227917,1792,1,4124425,4124425,4227917,103492,103492,103492,0,0,0
4235794,1846,8,4223886,4223886,4235794,11908,11908,11908,0,0,0
4239285,1835,1,4210537,4210537,4239285,28748,28748,28748,0,0,0
4239808,1847,1,4224234,4224234,4239808,15574,15574,15574,0,0,0
4244774,1834,8,4210203,4210203,4244774,34571,34571,33861,710,1,0
4248093,1854,1,4241485,4241485,4248093,6608,6608,6608,0,0,0
4252397,1833,1,4209674,4209674,4252397,42723,42723,42723,0,0,0
4260020,1840,4,4217853,4217853,4260020,42167,42167,42167,0,0,0
4263109,1865,1,4260901,4260901,4263109,2208,2208,2208,0,0,0
4284793,1869,4,4272964,4272964,4284793,11829,11829,11829,0,0,0
4285133,918,4,2786487,2786487,4285133,1498646,1498646,52835,1445811,9,0
4288491,1873,4,4280398,4280398,4288491,8093,8093,8093,0,0,0
4296647,1880,1,4292276,4292276,4296647,4371,4371,4371,0,0,0
4300946,1874,4,4280490,4280490,4300946,20456,20456,20456,0,0,0
4317230,1850,1,4226057,4226057,4317230,91173,91173,89198,1975,2,0
4320345,1917,1,4313213,4313213,4320345,7132,7132,7132,0,0,0
4323016,1878,1,4291633,4291633,4323016,31383,31383,31383,0,0,0
4323312,1903,4,4308202,4308202,4323312,15110,15110,15110,0,0,0
4327316,1919,1,4319218,4319218,4327316,8098,8098,8098,0,0,0
4327554,1909,4,4310775,4310775,4327554,16779,16779,16779,0,0,0
4329088,1896,1,4306288,4306288,4329088,22800,22800,22800,0,0,0
4339659,914,2,2782504,2782504,4339659,1557155,1557155,137147,1420008,20,0
4340134,1883,8,4298062,4298062,4340134,42072,42072,29667,12405,5,0
4348628,1891,4,4305250,4305250,4348628,43378,43378,43378,0,0,0
4349269,992,1,2877471,2877471,4349269,1471798,1471798,193578,1278220,5,0
4354467,1889,1,4299389,4299389,4354467,55078,55078,55078,0,0,0
4354758,1937,4,4353866,4353866,4354758,892,892,892,0,0,0
4354806,1925,1,4341492,4341492,4354806,13314,13314,13314,0,0,0
4360843,1939,4,4355252,4355252,4360843,5591,5591,5591,0,0,0
4365667,1815,1,4173649,4173649,4365667,192018,192018,189918,2100,4,0
4375714,1868,1,4272038,4272038,4375714,103676,103676,103471,205,1,0
4378476,1944,1,4364373,4364373,4378476,14103,14103,14103,0,0,0
4396089,1927,1,4353063,4353063,4396089,43026,43026,43026,0,0,0
4396361,1870,1,4275845,4275845,4396361,120516,120516,120311,205,1,0
4398029,1894,1,4306246,4306246,4398029,91783,91783,91783,0,0,0
4410375,1893,1,4306126,4306126,4410375,104249,104249,104249,0,0,0
4415201,1949,4,4374376,4374376,4415201,40825,40825,40825,0,0,0
4417007,1001,4,2882440,2882440,4417007,1534567,1534567,93888,1440679,15,0
4437003,1969,4,4432125,4432125,4437003,4878,4878,4878,0,0,0
4439486,1963,1,4419234,4419234,4439486,20252,20252,20252,0,0,0
4441390,1959,4,4392568,4392568,4441390,48822,48822,48822,0,0,0
4451462,1931,1,4353126,4353126,4451462,98336,98336,98336,0,0,0
4472816,1897,1,4306419,4306419,4472816,166397,166397,166397,0,0,0
4474296,1308,16,3362465,3362465,4474296,1111831,1111831,13827,1098004,4,0
4479397,1981,1,4477866,4477866,4479397,1531,1531,1531,0,0,0
4500544,1992,1,4491156,4491156,4500544,9388,9388,9388,0,0,0
4500761,1986,1,4486285,4486285,4500761,14476,14476,14476,0,0,0
4504695,1402,8,3449324,3449324,4504695,1055371,1055371,25616,1029755,3,0
4511437,1993,1,4498182,4498182,4511437,13255,13255,13255,0,0,0
4523705,1997,1,4499824,4499824,4523705,23881,23881,23881,0,0,0
4540715,1994,1,4498787,4498787,4540715,41928,41928,41928,0,0,0
4597662,1983,1,4483812,4483812,4597662,113850,113850,113850,0,0,0
4605145,1996,1,4499762,4499762,4605145,105383,105383,105383,0,0,0
4638279,1240,8,3231294,3231294,4638279,1406985,1406985,65172,1341813,2,0
4639900,1127,1,3072346,3072346,4639900,1567554,1567554,357389,1210165,2,0
4683617,944,8,2810181,2810181,4683617,1873436,1873436,69735,1803701,6,0
4684930,1272,16,3344326,3344326,4684930,1340604,1340604,13466,1327138,1,0
4788593,1091,8,3045764,3045764,4788593,1742829,1742829,129272,1613557,7,0
4789272,1558,16,3694118,3694118,4789272,1095154,1095154,12869,1082285,2,0
4878682,1649,8,3832671,3832671,4878682,1046011,1046011,113814,932197,1,0
4889493,1991,1,4489242,4489242,4889493,400251,400251,205865,194386,2,0
4895168,1804,8,4126644,4126644,4895168,768524,768524,40899,727625,1,0
4895862,1908,8,4310117,4310117,4895862,585745,585745,41594,544151,4,0
4897236,875,16,2737400,2737400,4897236,2159836,2159836,20415,2139421,4,0
4924113,1246,8,3255235,3255235,4924113,1668878,1668878,52150,1616728,3,0
4968482,1465,8,3543503,3543503,4968482,1424979,1424979,69689,1355290,2,0
4973675,757,16,2407489,2407489,4973675,2566186,2566186,17318,2548868,1,0
5010848,773,8,2446077,2446077,5010848,2564771,2564771,66632,2498139,1,0
5047781,982,4,2841605,2841605,5047781,2206176,2206176,85270,2120906,6,0
5063704,1143,4,3088134,3088134,5063704,1975570,1975570,64337,1911233,2,0
5079051,1224,1,3193628,3193628,5079051,1885423,1885423,224406,1661017,9,0
5095968,1233,1,3193663,3193663,5095968,1902305,1902305,241070,1661235,9,0
5098883,1323,1,3365692,3365692,5098883,1733191,1733191,195622,1537569,11,0
5098984,1216,1,3193593,3193593,5098984,1905391,1905391,244007,1661384,20,0
5102608,1215,1,3193590,3193590,5102608,1909018,1909018,247576,1661442,15,0
5104424,1351,1,3404131,3404131,5104424,1700293,1700293,194540,1505753,14,0
5118683,1337,8,3370849,3370849,5118683,1747834,1747834,38359,1709475,6,0
5131755,1347,1,3402672,3402672,5131755,1729083,1729083,225813,1503270,15,0
5144362,1405,1,3478648,3478648,5144362,1665714,1665714,206134,1459580,7,0
5177999,1407,4,3483316,3483316,5177999,1694683,1694683,94578,1600105,13,0
5190536,1295,1,3360396,3360396,5190536,1830140,1830140,304468,1525672,15,0
5197727,1289,1,3360183,3360183,5197727,1837544,1837544,327173,1510371,8,0
5198336,1349,1,3402969,3402969,5198336,1795367,1795367,292403,1502964,19,0
5206500,1439,1,3517155,3517155,5206500,1689345,1689345,268288,1421057,9,0
5208756,1590,4,3744447,3744447,5208756,1464309,1464309,59212,1405097,5,0
5219268,1665,2,3876469,3876469,5219268,1342799,1342799,109227,1233572,3,0
5222910,1388,1,3444873,3444873,5222910,1778037,1778037,297171,1480866,9,0
5224459,1493,1,3615392,3615392,5224459,1609067,1609067,285434,1323633,5,0
5234875,1742,1,4023745,4023745,5234875,1211130,1211130,204922,1006208,1,0
5250268,1594,4,3758807,3758807,5250268,1491461,1491461,100932,1390529,2,0
5259014,1500,1,3616971,3616971,5259014,1642043,1642043,307700,1334343,11,0
5261951,1765,8,4064308,4064308,5261951,1197643,1197643,51252,1146391,1,0
5275759,1796,1,4124790,4124790,5275759,1150969,1150969,219461,931508,6,0
5283730,1569,1,3705944,3705944,5283730,1577786,1577786,279502,1298284,2,0
5293796,1498,1,3616820,3616820,5293796,1676976,1676976,354809,1322167,11,0
5293893,1887,1,4299094,4299094,5293893,994799,994799,211472,783327,1,0
5295217,1678,2,3946168,3946168,5295217,1349049,1349049,183333,1165716,1,0
5300903,1702,1,3961236,3961236,5300903,1339667,1339667,285765,1053902,1,0
5334956,1692,1,3959146,3959146,5334956,1375810,1375810,319252,1056558,2,0
5374011,1487,1,3604303,3604303,5374011,1769708,1769708,435084,1334624,4,0
5380822,1798,1,4125138,4125138,5380822,1255684,1255684,324037,931647,5,0
5395007,1977,4,4457783,4457783,5395007,937224,937224,69399,867825,2,0
5398378,712,1,2317985,2317985,5398378,3080393,3080393,219614,2860779,2,0
5431901,1794,1,4124658,4124658,5431901,1307243,1307243,389810,917433,8,0
5435954,1978,4,4457837,4457837,5435954,978117,978117,110292,867825,2,0
5440940,1837,1,4214501,4214501,5440940,1226439,1226439,372888,853551,3,0
5455907,853,1,2671801,2671801,5455907,2784106,2784106,259339,2524767,10,0
5468363,913,1,2777405,2777405,5468363,2690958,2690958,238206,2452752,4,0
5470953,923,1,2790636,2790636,5470953,2680317,2680317,240845,2439472,3,0
5478718,610,1,2008353,2008353,5478718,3470365,3470365,386869,3083496,6,0
5482743,594,1,2007948,2007948,5482743,3474795,3474795,390818,3083977,6,0
5491124,1436,1,3516025,3516025,5491124,1975099,1975099,236977,1738122,11,0
5500583,994,1,2877562,2877562,5500583,2623021,2623021,270377,2352644,11,0
5510585,1848,1,4225088,4225088,5510585,1285497,1285497,229388,1056109,7,0
5543699,904,1,2762982,2762982,5543699,2780717,2780717,313869,2466848,5,0
5544677,1452,1,3529517,3529517,5544677,2015160,2015160,290636,1724524,11,0
5547406,1885,1,4298860,4298860,5547406,1248546,1248546,257825,990721,2,0
5551173,1406,1,3482800,3482800,5551173,2068373,2068373,296927,1771446,5,0
5563787,877,1,2738257,2738257,5563787,2825530,2825530,333870,2491660,8,0
5574094,1016,1,2893671,2893671,5574094,2680423,2680423,343871,2336552,9,0
5580324,1005,1,2886973,2886973,5580324,2693351,2693351,350373,2342978,9,0
5584942,1631,4,3796551,3796551,5584942,1788391,1788391,105556,1682835,3,0
5616577,643,16,2158700,2158700,5616577,3457877,3457877,56990,3400887,3,0
5619379,1031,1,2910102,2910102,5619379,2709277,2709277,389381,2319896,15,0
5623578,779,8,2454686,2454686,5623578,3168892,3168892,55170,3113722,3,0
5626250,1679,8,3946654,3946654,5626250,1679596,1679596,53468,1626128,10,0
5629194,819,4,2533783,2533783,5629194,3095411,3095411,105124,2990287,1,0
5634536,1884,1,4298657,4298657,5634536,1335879,1335879,353539,982340,2,0
5636480,617,8,2013159,2013159,5636480,3623321,3623321,53386,3569935,5,0
5765559,274,4,1550798,1550798,5765559,4214761,4214761,236226,3978535,6,0
5793711,1141,8,3086361,3086361,5793711,2707350,2707350,81968,2625382,5,0
5805635,1966,4,4429473,4429473,5805635,1376162,1376162,122260,1253902,2,0
5807810,426,1,1690924,1690924,5807810,4116886,4116886,395020,3721866,11,0
5848977,669,8,2220859,2220859,5848977,3628118,3628118,99416,3528702,1,0
5856283,1156,8,3114754,3114754,5856283,2741529,2741529,62680,2678849,2,0
5891662,1844,8,4222851,4222851,5891662,1668811,1668811,93735,1575076,2,0
5941529,813,4,2528322,2528322,5941529,3413207,3413207,161129,3252078,2,0
5944823,959,8,2824767,2824767,5944823,3120056,3120056,49761,3070295,8,0
5996363,1543,8,3655299,3655299,5996363,2341064,2341064,98018,2243046,4,0
6038945,1762,8,4053792,4053792,6038945,1985153,1985153,101006,1884147,9,0
6043107,293,1,1593057,1593057,6043107,4450050,4450050,416508,4033542,26,0
6098038,324,1,1608857,1608857,6098038,4489181,4489181,472086,4017095,18,0
6116437,1461,8,3539191,3539191,6116437,2577246,2577246,64609,2512637,9,0
6151277,1776,4,4094367,4094367,6151277,2056910,2056910,127218,1929692,4,0
6161075,1859,16,4259639,4259639,6161075,1901436,1901436,32961,1868475,4,0
6168792,1241,1,3237897,3237897,6168792,2930895,2930895,440168,2490727,13,0
6170794,926,1,2796380,2796380,6170794,3374414,3374414,408835,2965579,6,0
6172618,1128,1,3072686,3072686,6172618,3099932,3099932,393230,2706702,3,0
6180349,1132,1,3079575,3079575,6180349,3100774,3100774,400957,2699817,5,0
6195420,1020,1,2894811,2894811,6195420,3300609,3300609,415768,2884841,13,0
6201383,1838,4,4215093,4215093,6201383,1986290,1986290,103243,1883047,4,0
6230481,1948,4,4374344,4374344,6230481,1856137,1856137,126336,1729801,2,0
6231869,1161,1,3137006,3137006,6231869,3094863,3094863,453195,2641668,2,0
6262985,1888,1,4299244,4299244,6262985,1963741,1963741,470795,1492946,3,0
6288563,787,8,2479353,2479353,6288563,3809210,3809210,82290,3726920,3,0
6301316,1875,16,4284419,4284419,6301316,2016897,2016897,42161,1974736,2,0
6312857,1563,8,3703578,3703578,6312857,2609279,2609279,67773,2541506,4,0
6313891,491,1,1842658,1842658,6313891,4471233,4471233,484804,3986429,14,0
6317928,1049,1,2980720,2980720,6317928,3337208,3337208,488605,2848603,9,0
6322110,1999,1,4508448,4508448,6322110,1813662,1813662,470011,1343651,2,0
6330234,1716,8,3965506,3965506,6330234,2364728,2364728,72536,2292192,10,0
6343250,1780,1,4101388,4101388,6343250,2241862,2241862,492009,1749853,4,0
6343255,887,8,2743102,2743102,6343255,3600153,3600153,61142,3539011,8,0
6372503,969,8,2831821,2831821,6372503,3540682,3540682,90413,3450269,7,0
6377721,960,8,2825556,2825556,6377721,3552165,3552165,69779,3482386,12,0
6390655,702,16,2308613,2308613,6390655,4082042,4082042,34954,4047088,5,0
6397541,488,4,1840397,1840397,6397541,4557144,4557144,107887,4449257,9,0
6399601,825,2,2548896,2548896,6399601,3850705,3850705,185093,3665612,1,0
6425028,903,4,2762657,2762657,6425028,3662371,3662371,122313,3540058,17,0
6437053,1097,16,3050600,3050600,6437053,3386453,3386453,34023,3352430,5,0
6485756,1648,8,3829833,3829833,6485756,2655923,2655923,92680,2563243,5,0
6519420,1404,1,3458247,3458247,6519420,3061173,3061173,529612,2531561,9,0
6600135,970,8,2832444,2832444,6600135,3767691,3767691,145446,3622245,12,0
6621690,395,1,1690780,1690780,6621690,4930910,4930910,520384,4410526,13,0
6628524,104,1,1095751,1095751,6628524,5532773,5532773,508779,5023994,15,0
6645106,1119,8,3065037,3065037,6645106,3580069,3580069,81735,3498334,7,0
6648520,1683,1,3949616,3949616,6648520,2698904,2698904,510506,2188398,6,0
6672939,188,16,1245523,1245523,6672939,5427416,5427416,56259,5371157,8,0
6711359,1886,1,4298927,4298927,6711359,2412432,2412432,569116,1843316,6,0
6717103,1795,1,4124720,4124720,6717103,2592383,2592383,540141,2052242,14,0
6760915,756,8,2407234,2407234,6760915,4353681,4353681,110992,4242689,8,0
6767523,48,1,996568,996568,6767523,5770955,5770955,559872,5211083,26,0
6807622,1099,4,3053148,3053148,6807622,3754474,3754474,178338,3576136,11,0
6823545,1953,1,4384611,4384611,6823545,2438934,2438934,568484,1870450,7,0
6865910,549,1,1966249,1966249,6865910,4899661,4899661,354670,4544991,14,0
6904234,854,4,2703145,2703145,6904234,4201089,4201089,112524,4088565,13,0
6904556,1078,8,3013782,3013782,6904556,3890774,3890774,37369,3853405,2,0
6918291,1072,1,3005325,3005325,6918291,3912966,3912966,349012,3563954,6,0
6977251,350,1,1609133,1609133,6977251,5368118,5368118,466146,4901972,16,0
6984224,1540,16,3635675,3635675,6984224,3348549,3348549,25501,3323048,4,0
6986853,1386,1,3444367,3444367,6986853,3542486,3542486,379339,3163147,6,0
7006462,1669,4,3934756,3934756,7006462,3071706,3071706,103425,2968281,4,0
7018212,1490,8,3605476,3605476,7018212,3412736,3412736,78059,3334677,6,0
7027172,1125,1,3070169,3070169,7027172,3957003,3957003,419312,3537691,4,0
7031386,389,1,1690738,1690738,7031386,5340648,5340648,520370,4820278,7,0
7034693,871,4,2736613,2736613,7034693,4298080,4298080,144365,4153715,9,0
7054188,1967,4,4429857,4429857,7054188,2624331,2624331,110110,2514221,3,0
7121274,1360,4,3415395,3415395,7121274,3705879,3705879,211092,3494787,6,0
7125485,117,8,1105635,1105635,7125485,6019850,6019850,77576,5942274,2,0
7131656,1293,8,3360334,3360334,7131656,3771322,3771322,79661,3691661,16,0
7155967,1483,8,3602159,3602159,7155967,3553808,3553808,97835,3455973,12,0
7156864,213,4,1278989,1278989,7156864,5877875,5877875,69494,5808381,5,0
7157724,1449,1,3525329,3525329,7157724,3632395,3632395,476908,3155487,6,0
7160269,316,1,1608793,1608793,7160269,5551476,5551476,278817,5272659,18,0
7192559,114,8,1099265,1099265,7192559,6093294,6093294,70930,6022364,1,0
7195519,504,1,1864812,1864812,7195519,5330707,5330707,310435,5020272,9,0
7219685,588,1,2007737,2007737,7219685,5211948,5211948,302006,4909942,12,0
7227333,591,1,2007912,2007912,7227333,5219421,5219421,309632,4909789,21,0
7227579,612,1,2008376,2008376,7227579,5219203,5219203,283137,4936066,4,0
7307435,590,1,2007847,2007847,7307435,5299588,5299588,389304,4910284,8,0
7314564,655,4,2192489,2192489,7314564,5122075,5122075,75926,5046149,4,0
7319496,255,1,1450085,1450085,7319496,5869411,5869411,438178,5431233,7,0
7327181,554,1,1969507,1969507,7327181,5357674,5357674,409294,4948380,17,0
7343893,625,1,2149233,2149233,7343893,5194660,5194660,398986,4795674,7,0
7351556,805,1,2497520,2497520,7351556,4854036,4854036,299085,4554951,9,0
7405700,596,1,2007980,2007980,7405700,5397720,5397720,484625,4913095,7,0
7410198,331,1,1608929,1608929,7410198,5801269,5801269,528275,5272994,16,0
7422571,508,1,1874026,1874026,7422571,5548545,5548545,505218,5043327,5,0
7439422,917,2,2784159,2784159,7439422,4655263,4655263,170969,4484294,12,0
7448680,796,1,2484191,2484191,7448680,4964489,4964489,416381,4548108,18,0
7452048,797,1,2484263,2484263,7452048,4967785,4967785,419309,4548476,17,0
7458075,850,4,2668600,2668600,7458075,4789475,4789475,121157,4668318,1,0
7461849,1302,1,3362054,3362054,7461849,4099795,4099795,287904,3811891,16,0
7476017,1468,4,3571109,3571109,7476017,3904908,3904908,86775,3818133,12,0
7493058,1117,8,3060417,3060417,7493058,4432641,4432641,78711,4353930,5,0
7497416,1303,1,3362076,3362076,7497416,4135340,4135340,323564,3811776,19,0
7513437,1007,1,2889623,2889623,7513437,4623814,4623814,365642,4258172,20,0
7514762,1832,1,4208644,4208644,7514762,3306118,3306118,296455,3009663,5,0
7535763,932,1,2801445,2801445,7535763,4734318,4734318,404551,4329767,20,0
7540293,1285,1,3359789,3359789,7540293,4180504,4180504,366434,3814070,12,0
7609954,1791,8,4122404,4122404,7609954,3487550,3487550,129597,3357953,2,0
7619748,920,1,2787947,2787947,7619748,4831801,4831801,488504,4343297,14,0
7647146,1881,16,4292869,4292869,7647146,3354277,3354277,54376,3299901,2,0
7677054,1332,1,3369102,3369102,7677054,4307952,4307952,499864,3808088,8,0
7678628,1704,1,3961442,3961442,7678628,3717186,3717186,460617,3256569,2,0
7685167,848,1,2662435,2662435,7685167,5022732,5022732,554111,4468621,9,0
7733327,768,16,2420131,2420131,7733327,5313196,5313196,89701,5223495,2,0
7769273,1345,8,3400242,3400242,7769273,4369031,4369031,121001,4248030,5,0
7784869,1900,32,4308054,4308054,7784869,3476815,3476815,37010,3439805,14,0
7831534,1654,8,3841532,3841532,7831534,3990002,3990002,135383,3854619,10,0
7837053,1559,8,3694914,3694914,7837053,4142139,4142139,94810,4047329,8,0
7886062,1419,8,3501455,3501455,7886062,4384607,4384607,138959,4245648,7,0
7939486,1675,4,3937203,3937203,7939486,4002283,4002283,239165,3763118,3,0
7949635,1763,8,4055318,4055318,7949635,3894317,3894317,104752,3789565,8,0
7955061,834,2,2662033,2662033,7955061,5293028,5293028,423611,4869417,26,0
7958748,1176,8,3186211,3186211,7958748,4772537,4772537,108410,4664127,3,0
7988787,835,2,2662056,2662056,7988787,5326731,5326731,423033,4903698,16,0
8008490,1597,8,3761840,3761840,8008490,4246650,4246650,124799,4121851,8,0
8053239,1066,8,3001711,3001711,8053239,5051528,5051528,153154,4898374,7,0
8089847,524,1,1934815,1934815,8089847,6155032,6155032,847416,5307616,19,0
8121169,788,16,2480259,2480259,8121169,5640910,5640910,80569,5560341,2,0
8206207,1841,8,4218711,4218711,8206207,3987496,3987496,174043,3813453,4,0
8234605,547,1,1966174,1966174,8234605,6268431,6268431,844806,5423625,27,0
8304023,665,8,2209978,2209978,8304023,6094045,6094045,178411,5915634,7,0
8339106,1253,8,3276864,3276864,8339106,5062242,5062242,138793,4923449,3,0
8343693,340,1,1609023,1609023,8343693,6734670,6734670,623848,6110822,16,0
8376015,1858,4,4256980,4256980,8376015,4119035,4119035,244006,3875029,6,0
8391302,1365,16,3420130,3420130,8391302,4971172,4971172,70327,4900845,8,0
8438867,661,4,2206543,2206543,8438867,6232324,6232324,217656,6014668,3,0
8443623,234,1,1359082,1359082,8443623,7084541,7084541,628310,6456231,8,0
8509692,987,4,2850083,2850083,8509692,5659609,5659609,222080,5437529,5,0
8528285,1587,8,3717476,3717476,8528285,4810809,4810809,96638,4714171,4,0
8552351,697,8,2304602,2304602,8552351,6247749,6247749,107751,6139998,4,0
8567164,1719,4,3974316,3974316,8567164,4592848,4592848,213104,4379744,4,0
8653899,803,1,2495753,2495753,8653899,6158146,6158146,776215,5381931,7,0
8655382,1843,4,4222236,4222236,8655382,4433146,4433146,160239,4272907,7,0
8678313,949,1,2811277,2811277,8678313,5867036,5867036,906052,4960984,10,0
8700352,1136,8,3082127,3082127,8700352,5618225,5618225,126116,5492109,15,0
8702809,874,16,2737382,2737382,8702809,5965427,5965427,43363,5922064,16,0
8731603,1735,1,4016780,4016780,8731603,4714823,4714823,717764,3997059,9,0
8738428,303,4,1602535,1602535,8738428,7135893,7135893,243106,6892787,8,0
8741821,827,4,2550634,2550634,8741821,6191187,6191187,164659,6026528,2,0
8763758,1059,1,2991710,2991710,8763758,5772048,5772048,762140,5009908,14,0
8765353,674,8,2224179,2224179,8765353,6541174,6541174,108000,6433174,5,0
8767825,1777,1,4095020,4095020,8767825,4672805,4672805,753431,3919374,10,0
8779892,981,8,2839809,2839809,8779892,5940083,5940083,97128,5842955,14,0
8784319,1167,4,3163733,3163733,8784319,5620586,5620586,231241,5389345,6,0
8789000,1658,8,3845366,3845366,8789000,4943634,4943634,85679,4857955,2,0
8839407,953,4,2811641,2811641,8839407,6027766,6027766,258597,5769169,14,0
8882137,1970,8,4432290,4432290,8882137,4449847,4449847,123724,4326123,2,0
8911950,1599,8,3764063,3764063,8911950,5147887,5147887,144309,5003578,3,0
8938004,51,1,999843,999843,8938004,7938161,7938161,565576,7372585,22,0
8949283,849,4,2666580,2666580,8949283,6282703,6282703,268366,6014337,9,0
8952203,1842,4,4221846,4221846,8952203,4730357,4730357,233351,4497006,6,0
8998642,1879,1,4291700,4291700,8998642,4706942,4706942,878109,3828833,6,0
9018757,1042,1,2972754,2972754,9018757,6046003,6046003,706428,5339575,13,0
9033898,1811,1,4156320,4156320,9033898,4877578,4877578,555600,4321978,12,0
9073960,481,4,1766927,1766927,9073960,7307033,7307033,210220,7096813,9,0
9090949,776,2,2450480,2450480,9090949,6640469,6640469,475612,6164857,6,0
9111980,32,8,946857,946857,9111980,8165123,8165123,104459,8060664,1,0
9151474,40,1,981636,981636,9151474,8169838,8169838,779201,7390637,25,0
9151999,839,1,2662181,2662181,9151999,6489818,6489818,571408,5918410,25,0
9198098,998,1,2882011,2882011,9198098,6316087,6316087,615402,5700685,19,0
9206705,741,8,2379991,2379991,9206705,6826714,6826714,75137,6751577,2,0
9222162,143,1,1165268,1165268,9222162,8056894,8056894,904899,7151995,9,0
9241067,1019,1,2893851,2893851,9241067,6347216,6347216,928554,5418662,17,0
9304089,1929,1,4353125,4353125,9304089,4950964,4950964,632886,4318078,7,0
9315384,1818,1,4185054,4185054,9315384,5130330,5130330,837123,4293207,11,0
9329477,1077,4,3013382,3013382,9329477,6316095,6316095,168439,6147656,5,0
9366193,709,8,2312146,2312146,9366193,7054047,7054047,108124,6945923,5,0
9442180,961,8,2826337,2826337,9442180,6615843,6615843,184177,6431666,7,0
9462050,1412,4,3490509,3490509,9462050,5971541,5971541,149623,5821918,10,0
9477084,277,8,1580632,1580632,9477084,7896452,7896452,86026,7810426,3,0
9516136,749,8,2404498,2404498,9516136,7111638,7111638,109932,7001706,6,0
9529058,543,1,1964282,1964282,9529058,7564776,7564776,607223,6957553,18,0
9536470,1027,1,2905196,2905196,9536470,6631274,6631274,612352,6018922,16,0
9554775,812,8,2519332,2519332,9554775,7035443,7035443,109580,6925863,5,0
9555571,808,8,2502249,2502249,9555571,7053322,7053322,110358,6942964,6,0
9619515,1296,1,3360548,3360548,9619515,6258967,6258967,657536,5601431,22,0
9636700,489,1,1842565,1842565,9636700,7794135,7794135,714510,7079625,5,0
9642536,838,2,2662112,2662112,9642536,6980424,6980424,410873,6569551,15,0
9647115,942,1,2808913,2808913,9647115,6838202,6838202,662660,6175542,12,0
9677622,1517,1,3622500,3622500,9677622,6055122,6055122,755054,5300068,13,0
9697369,162,1,1167697,1167697,9697369,8529672,8529672,888019,7641653,8,0
9710449,1122,1,3068173,3068173,9710449,6642276,6642276,761950,5880326,7,0
9726458,1957,4,4392357,4392357,9726458,5334101,5334101,244300,5089801,4,0
9756274,71,4,1029550,1029550,9756274,8726724,8726724,177366,8549358,7,0
9797364,1004,1,2883291,2883291,9797364,6914073,6914073,812765,6101308,13,0
9800114,1712,1,3961974,3961974,9800114,5838140,5838140,731329,5106811,3,0
9835539,1074,1,3005404,3005404,9835539,6830135,6830135,565195,6264940,9,0
9836986,1964,1,4420096,4420096,9836986,5416890,5416890,876237,4540653,6,0
9867721,1509,1,3618303,3618303,9867721,6249418,6249418,755405,5494013,12,0
9868759,1023,1,2898363,2898363,9868759,6970396,6970396,811945,6158451,14,0
9931705,1369,1,3427983,3427983,9931705,6503722,6503722,1011330,5492392,17,0
9937223,1725,1,4006238,4006238,9937223,5930985,5930985,596417,5334568,3,0
9949060,1181,1,3193441,3193441,9949060,6755619,6755619,679140,6076479,19,0
9965089,223,8,1293192,1293192,9965089,8671897,8671897,103008,8568889,5,0
10050543,464,1,1692174,1692174,10050543,8358369,8358369,867381,7490988,16,0
10066623,885,8,2742912,2742912,10066623,7323711,7323711,85851,7237860,8,0
10093906,187,1,1245511,1245511,10093906,8848395,8848395,783417,8064978,2,0
10126671,1297,1,3360708,3360708,10126671,6765963,6765963,853349,5912614,22,0
10156342,832,1,2632713,2632713,10156342,7523629,7523629,777546,6746083,17,0
10183457,189,1,1245524,1245524,10183457,8937933,8937933,810009,8127924,2,0
10188349,1243,1,3251588,3251588,10188349,6936761,6936761,917702,6019059,24,0
10211126,1481,8,3601566,3601566,10211126,6609560,6609560,124449,6485111,4,0
10248358,1853,8,4235084,4235084,10248358,6013274,6013274,106969,5906305,2,0
10262027,1951,8,4375559,4375559,10262027,5886468,5886468,120618,5765850,3,0
10272811,1103,1,3055589,3055589,10272811,7217222,7217222,781334,6435888,7,0
10292346,828,4,2553029,2553029,10292346,7739317,7739317,259601,7479716,7,0
10431681,989,4,2855387,2855387,10431681,7576294,7576294,378347,7197947,7,0
10432204,525,1,1934900,1934900,10432204,8497304,8497304,505838,7991466,13,0
10498136,553,1,1968041,1968041,10498136,8530095,8530095,570871,7959224,14,0
10514203,299,4,1601071,1601071,10514203,8913132,8913132,259050,8654082,3,0
10543970,842,1,2662251,2662251,10543970,7881719,7881719,993975,6887744,21,0
10640742,562,2,1979101,1979101,10640742,8661641,8661641,461555,8200086,4,0
10652486,325,1,1608864,1608864,10652486,9043622,9043622,990370,8053252,24,0
10688077,1516,1,3622423,3622423,10688077,7065654,7065654,761639,6304015,9,0
10739523,467,8,1702189,1702189,10739523,9037334,9037334,174062,8863272,8,0
10768341,777,8,2452014,2452014,10768341,8316327,8316327,151657,8164670,7,0
10793367,589,1,2007756,2007756,10793367,8785611,8785611,866184,7919427,8,0
10793722,852,4,2671185,2671185,10793722,8122537,8122537,248108,7874429,8,0
10809072,25,16,926459,926459,10809072,9882613,9882613,45200,9837413,2,0
10866711,70,4,1028741,1028741,10866711,9837970,9837970,177284,9660686,7,0
10919361,216,16,1283033,1283033,10919361,9636328,9636328,82510,9553818,8,0
10941653,1934,1,4353128,4353128,10941653,6588525,6588525,500522,6088003,4,0
10954168,630,1,2152257,2152257,10954168,8801911,8801911,565174,8236737,7,0
10961367,675,8,2225095,2225095,10961367,8736272,8736272,101555,8634717,4,0
10993754,739,1,2377051,2377051,10993754,8616703,8616703,552945,8063758,10,0
11034329,1933,1,4353128,4353128,11034329,6681201,6681201,593198,6088003,4,0
11044188,1962,8,4417213,4417213,11044188,6626975,6626975,133992,6492983,5,0
11065193,731,1,2365059,2365059,11065193,8700134,8700134,623572,8076562,2,0
11080594,798,1,2485732,2485732,11080594,8594862,8594862,1027226,7567636,14,0
11113109,633,1,2152871,2152871,11113109,8960238,8960238,723994,8236244,5,0
11114472,454,1,1691903,1691903,11114472,9422569,9422569,1033473,8389096,15,0
11120915,585,1,2006559,2006559,11120915,9114356,9114356,1038668,8075688,21,0
11129990,629,1,2152220,2152220,11129990,8977770,8977770,740956,8236814,7,0
11132706,1985,4,4485874,4485874,11132706,6646832,6646832,258026,6388806,4,0
11142794,101,1,1095578,1095578,11142794,10047216,10047216,1046718,9000498,24,0
11151471,1079,8,3015240,3015240,11151471,8136231,8136231,138388,7997843,9,0
11158061,1816,1,4174044,4174044,11158061,6984017,6984017,717121,6266896,7,0
11190617,609,1,2008335,2008335,11190617,9182282,9182282,801241,8381041,6,0
11192196,380,1,1690344,1690344,11192196,9501852,9501852,875460,8626392,9,0
11194389,469,4,1712122,1712122,11194389,9482267,9482267,262622,9219645,7,0
11217267,439,1,1691534,1691534,11217267,9525733,9525733,1073647,8452086,15,0
11218022,704,1,2308795,2308795,11218022,8909227,8909227,777288,8131939,5,0
11223807,608,1,2008311,2008311,11223807,9215496,9215496,834358,8381138,9,0
11281016,1010,8,2891585,2891585,11281016,8389431,8389431,188881,8200550,6,0
11294292,1757,8,4050950,4050950,11294292,7243342,7243342,144751,7098591,5,0
11315267,727,1,2342253,2342253,11315267,8973014,8973014,872583,8100431,3,0
11336046,715,8,2319624,2319624,11336046,9016422,9016422,152585,8863837,4,0
11386170,922,1,2788786,2788786,11386170,8597384,8597384,1111622,7485762,16,0
11456041,1505,1,3617543,3617543,11456041,7838498,7838498,1131698,6706800,15,0
11464938,1905,8,4309641,4309641,11464938,7155297,7155297,141419,7013878,4,0
11474633,121,8,1114608,1114608,11474633,10360025,10360025,143132,10216893,6,0
11491357,502,4,1863192,1863192,11491357,9628165,9628165,284362,9343803,3,0
11549510,1221,1,3193612,3193612,11549510,8355898,8355898,1107997,7247901,19,0
11555515,1460,8,3537448,3537448,11555515,8018067,8018067,140536,7877531,8,0
11573900,611,1,2008366,2008366,11573900,9565534,9565534,436649,9128885,10,0
11594329,87,1,1078499,1078499,11594329,10515830,10515830,458795,10057035,16,0
11596018,22,4,912464,912464,11596018,10683554,10683554,145076,10538478,4,0
11611651,200,4,1255294,1255294,11611651,10356357,10356357,142390,10213967,8,0
11658086,82,1,1064215,1064215,11658086,10593871,10593871,526972,10066899,10,0
11666031,893,4,2753761,2753761,11666031,8912270,8912270,113019,8799251,8,0
11677760,794,1,2483310,2483310,11677760,9194450,9194450,438863,8755587,8,0
11725131,810,16,2509422,2509422,11725131,9215709,9215709,93174,9122535,3,0
11726858,245,4,1373901,1373901,11726858,10352957,10352957,257626,10095331,3,0
11742979,1544,4,3659762,3659762,11742979,8083217,8083217,121235,7961982,5,0
11755797,1061,1,2991731,2991731,11755797,8764066,8764066,498655,8265411,6,0
11790584,129,1,1157802,1157802,11790584,10632782,10632782,653007,9979775,18,0
11794107,127,1,1152816,1152816,11794107,10641291,10641291,656734,9984557,16,0
11841443,1088,8,3028259,3028259,11841443,8813184,8813184,168761,8644423,6,0
11845954,1618,4,3789445,3789445,11845954,8056509,8056509,208005,7848504,6,0
11885444,1759,16,4052828,4052828,11885444,7832616,7832616,70235,7762381,3,0
11885770,1867,1,4269940,4269940,11885770,7615830,7615830,1080780,6535050,12,0
11885843,190,1,1245696,1245696,11885843,10640147,10640147,1083946,9556201,5,0
11940315,204,1,1261278,1261278,11940315,10679037,10679037,1138341,9540696,7,0
11976370,77,1,1061017,1061017,11976370,10915353,10915353,845500,10069853,7,0
12002323,1409,1,3485998,3485998,12002323,8516325,8516325,696841,7819484,8,0
12006394,375,1,1690292,1690292,12006394,10316102,10316102,868900,9447202,11,0
12067581,227,2,1322871,1322871,12067581,10744710,10744710,609923,10134787,11,0
12070560,1201,1,3193537,3193537,12070560,8877023,8877023,1100717,7776306,16,0
12083338,906,1,2768096,2768096,12083338,9315242,9315242,843507,8471735,5,0
12110893,1213,1,3193582,3193582,12110893,8917311,8917311,1129222,7788089,23,0
12144857,1542,1,3654916,3654916,12144857,8489941,8489941,1136635,7353306,10,0
12157842,1943,16,4363214,4363214,12157842,7794628,7794628,115863,7678765,2,0
12163106,626,8,2149297,2149297,12163106,10013809,10013809,145320,9868489,7,0
12171308,1647,1,3827424,3827424,12171308,8343884,8343884,846674,7497210,4,0
12179400,985,1,2844243,2844243,12179400,9335157,9335157,1120572,8214585,19,0
12203316,1158,8,3114803,3114803,12203316,9088513,9088513,163888,8924625,5,0
12215804,1410,8,3486210,3486210,12215804,8729594,8729594,151418,8578176,9,0
12227981,1556,1,3692921,3692921,12227981,8535060,8535060,921641,7613419,7,0
12320444,1411,1,3487778,3487778,12320444,8832666,8832666,1014801,7817865,8,0
12347864,1663,1,3864395,3864395,12347864,8483469,8483469,924925,7558544,7,0
12358287,1153,16,3114349,3114349,12358287,9243938,9243938,80764,9163174,6,0
12436538,1921,8,4332923,4332923,12436538,8103615,8103615,219000,7884615,5,0
12443418,1267,1,3342636,3342636,12443418,9100782,9100782,1135266,7965516,20,0
12446572,1668,1,3900131,3900131,12446572,8546441,8546441,1023599,7522842,4,0
12451342,577,4,1999867,1999867,12451342,10451475,10451475,289379,10162096,10,0
12495284,866,1,2736499,2736499,12495284,9758785,9758785,1178689,8580096,21,0
12513533,1292,1,3360328,3360328,12513533,9153205,9153205,1153033,8000172,23,0
12689892,211,16,1275933,1275933,12689892,11413959,11413959,247842,11166117,10,0
12842293,281,4,1587106,1587106,12842293,11255187,11255187,440770,10814417,4,0
12940418,1035,1,2925137,2925137,12940418,10015281,10015281,1241095,8774186,27,0
12945264,1518,1,3622628,3622628,12945264,9322636,9322636,1160544,8162092,20,0
12967994,1673,4,3935370,3935370,12967994,9032624,9032624,310110,8722514,4,0
12988862,1623,1,3794720,3794720,12988862,9194142,9194142,1180915,8013227,15,0
13072389,1862,8,4260520,4260520,13072389,8811869,8811869,228263,8583606,4,0
13094619,1067,8,3001927,3001927,13094619,10092692,10092692,168871,9923821,7,0
13119493,891,8,2753751,2753751,13119493,10365742,10365742,172546,10193196,8,0
13194759,1057,1,2991688,2991688,13194759,10203071,10203071,1255519,8947552,34,0
13197104,1918,8,4318247,4318247,13197104,8878857,8878857,149838,8729019,4,0
13287073,679,8,2234074,2234074,13287073,11052999,11052999,239227,10813772,3,0
13304967,820,1,2536859,2536859,13304967,10768108,10768108,1223073,9545035,11,0
13350657,1809,8,4149178,4149178,13350657,9201479,9201479,195388,9006091,7,0
13413961,664,8,2207663,2207663,13413961,11206298,11206298,214919,10991379,6,0
13421817,1928,1,4353064,4353064,13421817,9068753,9068753,1217562,7851191,16,0
13425263,30,8,931720,931720,13425263,12493543,12493543,157078,12336465,5,0
13454196,579,4,1999909,1999909,13454196,11454287,11454287,339064,11115223,15,0
13454413,878,8,2738352,2738352,13454413,10716061,10716061,156319,10559742,8,0
13474157,965,16,2828509,2828509,13474157,10645648,10645648,97836,10547812,7,0
13489562,66,8,1024189,1024189,13489562,12465373,12465373,172367,12293006,7,0
13543560,1491,8,3611737,3611737,13543560,9931823,9931823,210960,9720863,13,0
13551949,1170,1,3166276,3166276,13551949,10385673,10385673,1265437,9120236,21,0
13628859,1895,1,4306246,4306246,13628859,9322613,9322613,1339806,7982807,13,0
13679749,792,1,2482324,2482324,13679749,11197425,11197425,1318505,9878920,23,0
13684636,1814,1,4170856,4170856,13684636,9513780,9513780,1274498,8239282,21,0
13764731,584,1,2006497,2006497,13764731,11758234,11758234,1358537,10399697,36,0
13766757,680,16,2234146,2234146,13766757,11532611,11532611,82516,11450095,8,0
13775793,915,2,2782611,2782611,13775793,10993182,10993182,653954,10339228,21,0
13783619,645,1,2162064,2162064,13783619,11621555,11621555,1315815,10305740,20,0
13844838,515,1,1889386,1889386,13844838,11955452,11955452,1375219,10580233,17,0
13847655,1248,8,3260958,3260958,13847655,10586697,10586697,166693,10420004,7,0
13906269,1466,8,3545877,3545877,13906269,10360392,10360392,222832,10137560,6,0
14009140,698,8,2305032,2305032,14009140,11704108,11704108,267789,11436319,6,0
14025830,1265,8,3342378,3342378,14025830,10683452,10683452,181427,10502025,7,0
14056099,986,1,2845707,2845707,14056099,11210392,11210392,1351577,9858815,17,0
14063327,20,4,912363,912363,14063327,13150964,13150964,339638,12811326,8,0
14065371,1950,8,4375472,4375472,14065371,9689899,9689899,167786,9522113,6,0
14079942,297,4,1601032,1601032,14079942,12478910,12478910,349307,12129603,5,0
14150357,1604,8,3769926,3769926,14150357,10380431,10380431,237175,10143256,9,0
14163868,205,8,1262028,1262028,14163868,12901840,12901840,181788,12720052,16,0
14201409,975,8,2838323,2838323,14201409,11363086,11363086,206188,11156898,12,0
14274714,802,8,2492333,2492333,14274714,11782381,11782381,279519,11502862,8,0
14312595,1421,8,3501680,3501680,14312595,10810915,10810915,206111,10604804,9,0
14378509,307,8,1604537,1604537,14378509,12773972,12773972,236002,12537970,9,0
14415590,1639,2,3798179,3798179,14415590,10617411,10617411,716206,9901205,8,0
14432574,1326,8,3365948,3365948,14432574,11066626,11066626,187996,10878630,11,0
14560453,377,1,1690306,1690306,14560453,12870147,12870147,1506156,11363991,26,0
14560755,487,8,1821990,1821990,14560755,12738765,12738765,171950,12566815,9,0
14661523,408,1,1690865,1690865,14661523,12970658,12970658,1476907,11493751,22,0
15012867,1620,8,3790518,3790518,15012867,11222349,11222349,523822,10698527,9,0
15058911,1225,1,3193632,3193632,15058911,11865279,11865279,1432210,10433069,23,0
15089908,244,4,1373136,1373136,15089908,13716772,13716772,379775,13336997,5,0
15104894,62,16,1022622,1022622,15104894,14082272,14082272,102534,13979738,5,0
15117778,168,1,1178118,1178118,15117778,13939660,13939660,310647,13629013,4,0
15121529,165,1,1167735,1167735,15121529,13953794,13953794,313967,13639827,3,0
15124448,457,1,1691957,1691957,15124448,13432491,13432491,304226,13128265,7,0
15250060,43,4,990126,990126,15250060,14259934,14259934,219464,14040470,3,0
15289572,659,4,2204380,2204380,15289572,13085192,13085192,246238,12838954,2,0
15316942,1126,1,3070500,3070500,15316942,12246442,12246442,490010,11756432,8,0
15321012,137,1,1161592,1161592,15321012,14159420,14159420,513449,13645971,4,0
15328928,112,1,1099054,1099054,15328928,14229874,14229874,521221,13708653,5,0
15331076,157,1,1165508,1165508,15331076,14165568,14165568,523606,13641962,4,0
15339136,433,1,1691387,1691387,15339136,13647749,13647749,531393,13116356,5,0
15340208,135,1,1161554,1161554,15340208,14178654,14178654,532683,13645971,4,0
15362383,1006,4,2888982,2888982,15362383,12473401,12473401,147241,12326160,4,0
15465109,138,1,1161607,1161607,15465109,14303502,14303502,657531,13645971,4,0
15488388,1362,8,3419095,3419095,15488388,12069293,12069293,60505,12008788,5,0
15492791,1568,1,3705784,3705784,15492791,11787007,11787007,324881,11462126,3,0
15515334,1355,1,3409908,3409908,15515334,12105426,12105426,450334,11655092,8,0
15523353,1377,1,3437326,3437326,15523353,12086027,12086027,355582,11730445,12,0
15553638,1677,4,3938171,3938171,15553638,11615467,11615467,139665,11475802,1,0
15588133,1557,1,3694117,3694117,15588133,11894016,11894016,420144,11473872,7,0
15589478,1617,4,3786367,3786367,15589478,11803111,11803111,175442,11627669,6,0
15608275,1394,1,3445013,3445013,15608275,12163262,12163262,440331,11722931,10,0
15616795,1382,1,3442593,3442593,15616795,12174202,12174202,448947,11725255,7,0
15624134,1356,1,3411546,3411546,15624134,12212588,12212588,559109,11653479,7,0
15673343,1898,1,4307079,4307079,15673343,11366264,11366264,478322,10887942,3,0
15708895,176,1,1233879,1233879,15708895,14475016,14475016,901824,13573192,1,0
15723161,1378,1,3437452,3437452,15723161,12285709,12285709,555378,11730331,11,0
15735025,1321,1,3365150,3365150,15735025,12369875,12369875,691974,11677901,19,0
15749128,1258,1,3316252,3316252,15749128,12432876,12432876,717440,11715436,14,0
15753322,1585,1,3708773,3708773,15753322,12044549,12044549,585340,11459209,4,0
15768966,1390,1,3444910,3444910,15768966,12324056,12324056,600973,11723083,5,0
15774180,85,16,1078287,1078287,15774180,14695893,14695893,94081,14601812,3,0
15803036,889,1,2745477,2745477,15803036,13057559,13057559,1452851,11604708,17,0
15856134,154,1,1165455,1165455,15856134,14690679,14690679,1048928,13641751,7,0
15857154,1567,1,3705704,3705704,15857154,12151450,12151450,689214,11462236,4,0
15868358,1636,1,3797987,3797987,15868358,12070371,12070371,1448291,10622080,13,0
15894790,571,1,1982224,1982224,15894790,13912566,13912566,1455166,12457400,17,0
15943213,1366,1,3426265,3426265,15943213,12516948,12516948,878591,11638357,8,0
15997022,1298,1,3361170,3361170,15997022,12635852,12635852,1483900,11151952,35,0
16005456,262,4,1498794,1498794,16005456,14506662,14506662,368976,14137686,15,0
16221867,1171,1,3166329,3166329,16221867,13055538,13055538,1672773,11382765,27,0
16227730,1882,1,4294766,4294766,16227730,11932964,11932964,1060394,10872570,2,0
16228424,410,1,1690870,1690870,16228424,14537554,14537554,1421401,13116153,7,0
16300043,183,4,1245265,1245265,16300043,15054778,15054778,434074,14620704,18,0
16317873,964,4,2828503,2828503,16317873,13489370,13489370,381380,13107990,16,0
16363240,1755,8,4044761,4044761,16363240,12318479,12318479,227709,12090770,9,0
16369605,760,1,2410770,2410770,16369605,13958835,13958835,1478476,12480359,19,0
16389742,1317,1,3363638,3363638,16389742,13026104,13026104,1347932,11678172,9,0
16415296,1741,4,4021739,4021739,16415296,12393557,12393557,394496,11999061,15,0
16456936,1367,1,3426742,3426742,16456936,13030194,13030194,1391934,11638260,9,0
16473705,1208,1,3193562,3193562,16473705,13280143,13280143,1496549,11783594,28,0
16499602,1730,1,4014622,4014622,16499602,12484980,12484980,1515033,10969947,11,0
16511732,947,1,2810948,2810948,16511732,13700784,13700784,1510108,12190676,23,0
16548944,1210,1,3193572,3193572,16548944,13355372,13355372,1533888,11821484,28,0
16667224,1333,4,3370210,3370210,16667224,13297014,13297014,528983,12768031,16,0
16747459,830,8,2560075,2560075,16747459,14187384,14187384,269026,13918358,4,0
16747469,1395,1,3445055,3445055,16747469,13302414,13302414,1512402,11790012,25,0
16772892,1220,1,3193608,3193608,16772892,13579284,13579284,1529093,12050191,37,0
16775469,1554,16,3692119,3692119,16775469,13083350,13083350,96656,12986694,4,0
16787950,128,8,1155403,1155403,16787950,15632547,15632547,202653,15429894,4,0
16978921,438,1,1691512,1691512,16978921,15287409,15287409,1711968,13575441,7,0
17004028,1422,8,3501849,3501849,17004028,13502179,13502179,217811,13284368,11,0
17050955,1083,1,3018485,3018485,17050955,14032470,14032470,1579621,12452849,30,0
17070498,657,4,2199808,2199808,17070498,14870690,14870690,406168,14464522,6,0
17089891,1531,1,3625213,3625213,17089891,13464678,13464678,1562185,11902493,21,0
17108614,1320,1,3365017,3365017,17108614,13743597,13743597,1573695,12169902,32,0
17111085,378,1,1690321,1690321,17111085,15420764,15420764,1573224,13847540,35,0
17159861,855,4,2703279,2703279,17159861,14456582,14456582,459164,13997418,17,0
17255988,1234,1,3193667,3193667,17255988,14062321,14062321,1671124,12391197,30,0
17267947,100,1,1095546,1095546,17267947,16172401,16172401,1589150,14583251,11,0
17285540,1165,4,3156678,3156678,17285540,14128862,14128862,412459,13716403,9,0
17329364,1771,1,4087394,4087394,17329364,13241970,13241970,1630850,11611120,29,0
17337262,52,4,1000852,1000852,17337262,16336410,16336410,404907,15931503,15,0
17361475,1047,1,2978463,2978463,17361475,14383012,14383012,1620757,12762255,40,0
17411044,302,2,1601625,1601625,17411044,15809419,15809419,852892,14956527,21,0
17529755,1790,8,4120747,4120747,17529755,13409008,13409008,320375,13088633,5,0
17602887,1973,4,4434399,4434399,17602887,13168488,13168488,481411,12687077,6,0
17656404,198,1,1254374,1254374,17656404,16402030,16402030,1675834,14726196,17,0
17666828,496,4,1846107,1846107,17666828,15820721,15820721,415729,15404992,16,0
17679797,845,4,2662324,2662324,17679797,15017473,15017473,420001,14597472,13,0
17721779,446,1,1691672,1691672,17721779,16030107,16030107,1685290,14344817,25,0
17722009,561,8,1978879,1978879,17722009,15743130,15743130,207471,15535659,10,0
17811244,688,1,2255571,2255571,17811244,15555673,15555673,1743448,13812225,23,0
17952353,1810,8,4151057,4151057,17952353,13801296,13801296,348344,13452952,5,0
17952390,529,4,1943224,1943224,17952390,16009166,16009166,415723,15593443,21,0
18129542,523,4,1931786,1931786,18129542,16197756,16197756,592860,15604896,18,0
18160167,1314,1,3363614,3363614,18160167,14796553,14796553,1700620,13095933,37,0
18229673,56,8,1005202,1005202,18229673,17224471,17224471,279754,16944717,15,0
18275712,411,1,1690872,1690872,18275712,16584840,16584840,1727631,14857209,25,0
18438564,910,8,2769942,2769942,18438564,15668622,15668622,373892,15294730,5,0
18520823,1275,8,3356017,3356017,18520823,15164806,15164806,294499,14870307,30,0
18629213,1974,8,4438429,4438429,18629213,14190784,14190784,321591,13869193,5,0
18808169,1372,1,3428118,3428118,18808169,15380051,15380051,1889794,13490257,12,0
18865903,621,8,2126772,2126772,18865903,16739131,16739131,272648,16466483,6,0
18890319,144,1,1165288,1165288,18890319,17725031,17725031,1770151,15954880,12,0
18902545,371,1,1690255,1690255,18902545,17212290,17212290,1758303,15453987,25,0
18907660,1336,8,3370630,3370630,18907660,15537030,15537030,223774,15313256,13,0
18994319,153,1,1165433,1165433,18994319,17828886,17828886,1848303,15980583,32,0
19027770,107,1,1095914,1095914,19027770,17931856,17931856,1803571,16128285,14,0
19147724,786,8,2479196,2479196,19147724,16668528,16668528,343606,16324922,12,0
19236242,1805,8,4138343,4138343,19236242,15097899,15097899,311468,14786431,5,0
19236511,1273,8,3345422,3345422,19236511,15891089,15891089,224393,15666696,10,0
19328491,721,7,2329770,2329770,19328491,16998721,16998721,349787,16648934,2,0
19422037,1236,1,3193678,3193678,19422037,16228359,16228359,1903723,14324636,34,0
19462241,393,1,1690765,1690765,19462241,17771476,17771476,1861647,15909829,33,0
19500263,1588,8,3718944,3718944,19500263,15781319,15781319,265179,15516140,6,0
19542984,1589,4,3744316,3744316,19542984,15798668,15798668,503548,15295120,24,0
19577929,161,1,1167678,1167678,19577929,18410251,18410251,1879245,16531006,43,0
19679254,60,4,1020508,1020508,19679254,18658746,18658746,565127,18093619,7,0
19684399,921,4,2788649,2788649,19684399,16895750,16895750,470633,16425117,18,0
19708667,1761,8,4053758,4053758,19708667,15654909,15654909,256184,15398725,12,0
19747324,184,1,1245289,1245289,19747324,18502035,18502035,1917802,16584233,29,0
19814082,1180,1,3193437,3193437,19814082,16620645,16620645,1956454,14664191,38,0
19824327,1694,1,3960254,3960254,19824327,15864073,15864073,1900906,13963167,30,0
19825250,1399,8,3448088,3448088,19825250,16377162,16377162,238638,16138524,9,0
19944630,1291,1,3360284,3360284,19944630,16584346,16584346,2024780,14559566,40,0
19969244,1849,8,4225292,4225292,19969244,15743952,15743952,261708,15482244,7,0
20032182,506,8,1872651,1872651,20032182,18159531,18159531,302577,17856954,6,0
20082132,771,8,2435862,2435862,20082132,17646270,17646270,289684,17356586,12,0
20175018,494,4,1845683,1845683,20175018,18329335,18329335,577638,17751697,15,0
20400042,958,8,2822534,2822534,20400042,17577508,17577508,467535,17109973,11,0
20403091,1195,1,3193505,3193505,20403091,17209586,17209586,1958210,15251376,38,0
20406854,1952,4,4384596,4384596,20406854,16022258,16022258,492703,15529555,14,0
20426536,1148,8,3099547,3099547,20426536,17326989,17326989,264785,17062204,10,0
20459915,575,1,1988402,1988402,20459915,18471513,18471513,2012057,16459456,48,0
20463728,1169,1,3165603,3165603,20463728,17298125,17298125,1976531,15321594,39,0
20518140,1287,1,3359893,3359893,20518140,17158247,17158247,2036016,15122231,38,0
20553214,45,4,991447,991447,20553214,19561767,19561767,533286,19028481,12,0
20578790,1160,1,3136944,3136944,20578790,17441846,17441846,2030335,15411511,34,0
20639598,1138,16,3082912,3082912,20639598,17556686,17556686,185416,17371270,10,0
20686476,863,2,2736378,2736378,20686476,17950098,17950098,1055272,16894826,38,0
20767560,1987,4,4486847,4486847,20767560,16280713,16280713,582761,15697952,10,0
20773554,570,1,1982201,1982201,20773554,18791353,18791353,2030426,16760927,29,0
20855982,1359,1,3412047,3412047,20855982,17443935,17443935,2111597,15332338,38,0
20911190,846,4,2662348,2662348,20911190,18248842,18248842,564407,17684435,13,0
20939480,246,4,1378443,1378443,20939480,19561037,19561037,542672,19018365,15,0
20950443,521,1,1925580,1925580,20950443,19024863,19024863,2071950,16952913,44,0
21022532,937,1,2805539,2805539,21022532,18216993,18216993,2163306,16053687,38,0
21054504,1595,1,3760386,3760386,21054504,17294118,17294118,2109087,15185031,12,0
21095381,624,1,2137254,2137254,21095381,18958127,18958127,2132994,16825133,22,0
21110470,1338,1,3371378,3371378,21110470,17739092,17739092,2126459,15612633,40,0
21127795,530,1,1944018,1944018,21127795,19183777,19183777,2138407,17045370,29,0
21133832,1120,1,3065304,3065304,21133832,18068528,18068528,2136536,15931992,30,0
21142049,1187,1,3193467,3193467,21142049,17948582,17948582,2129577,15819005,46,0
21193096,1178,1,3188566,3188566,21193096,18004530,18004530,2182554,15821976,24,0
21249701,1324,1,3365714,3365714,21249701,17883987,17883987,2196366,15687621,40,0
21306953,2,1,475911,475911,21306953,20831042,20831042,2206336,18624706,67,0
21338396,1342,4,3399195,3399195,21338396,17939201,17939201,571565,17367636,28,0
21384652,428,1,1691253,1691253,21384652,19693399,19693399,2223942,17469457,28,0
21468004,752,1,2406374,2406374,21468004,19061630,19061630,2275682,16785948,34,0
21539089,753,4,2406387,2406387,21539089,19132702,19132702,620152,18512550,17,0
21604096,1177,1,3188296,3188296,21604096,18415800,18415800,2247693,16168107,28,0
21653017,1958,1,4392441,4392441,21653017,17260576,17260576,2225889,15034687,31,0
21655810,175,1,1233608,1233608,21655810,20422202,20422202,2240304,18181898,28,0
21673014,397,1,1690793,1690793,21673014,19982221,19982221,2234085,17748136,40,0
21689238,455,1,1691921,1691921,21689238,19997317,19997317,2240023,17757294,40,0
21707651,463,1,1692088,1692088,21707651,20015563,20015563,2250864,17764699,36,0
21791906,1341,16,3374520,3374520,21791906,18417386,18417386,224330,18193056,12,0
21850428,1984,4,4485312,4485312,21850428,17365116,17365116,617602,16747514,17,0
21874164,360,1,1639334,1639334,21874164,20234830,20234830,2276674,17958156,46,0
21889722,1479,1,3595701,3595701,21889722,18294021,18294021,2273261,16020760,40,0
21901984,102,1,1095698,1095698,21901984,20806286,20806286,2273631,18532655,46,0
21929024,1073,1,3005327,3005327,21929024,18923697,18923697,2289501,16634196,47,0
21932740,146,1,1165316,1165316,21932740,20767424,20767424,2283312,18484112,23,0
21934211,152,1,1165414,1165414,21934211,20768797,20768797,2286369,18482428,43,0
21954688,437,1,1691493,1691493,21954688,20263195,20263195,2303199,17959996,16,0
21976204,1416,4,3499991,3499991,21976204,18476213,18476213,592943,17883270,16,0
22051937,164,1,1167724,1167724,22051937,20884213,20884213,2363803,18520410,21,0
22056206,453,1,1691844,1691844,22056206,20364362,20364362,2301568,18062794,41,0
22057221,448,1,1691744,1691744,22057221,20365477,20365477,2301054,18064423,35,0
22057924,1185,1,3193459,3193459,22057924,18864465,18864465,2291453,16573012,37,0
22064428,456,1,1691940,1691940,22064428,20372488,20372488,2308684,18063804,23,0
22105549,844,1,2662314,2662314,22105549,19443235,19443235,2343335,17099900,59,0
22150434,105,1,1095787,1095787,22150434,21054647,21054647,2358114,18696533,27,0
22171015,442,1,1691594,1691594,22171015,20479421,20479421,2328942,18150479,39,0
22258101,421,1,1690902,1690902,22258101,20567199,20567199,2414985,18152214,34,0
22276458,710,1,2313989,2313989,22276458,19962469,19962469,2330052,17632417,34,0
22341767,872,1,2736623,2736623,22341767,19605144,19605144,2422368,17182776,54,0
22369313,1288,1,3359921,3359921,22369313,19009392,19009392,2363024,16646368,44,0
22425282,1425,1,3502396,3502396,22425282,18922886,18922886,2391984,16530902,40,0
22475644,68,8,1025799,1025799,22475644,21449845,21449845,350315,21099530,12,0
22508971,224,16,1297699,1297699,22508971,21211272,21211272,183997,21027275,11,0
22617302,471,4,1712391,1712391,22617302,20904911,20904911,708768,20196143,17,0
22671122,723,8,2330062,2330062,22671122,20341060,20341060,350275,19990785,7,0
22683012,860,8,2725043,2725043,22683012,19957969,19957969,311555,19646414,10,0
22691857,1056,1,2991676,2991676,22691857,19700181,19700181,2418869,17281312,63,0
22861660,1021,1,2894838,2894838,22861660,19966822,19966822,2585400,17381422,50,0
22874853,1584,1,3708703,3708703,22874853,19166150,19166150,2425086,16741064,20,0
22898220,1656,1,3844194,3844194,22898220,19054026,19054026,2418423,16635603,27,0
22941845,734,8,2372549,2372549,22941845,20569296,20569296,350546,20218750,9,0
22946739,1916,1,4313042,4313042,22946739,18633697,18633697,2431556,16202141,14,0
22958331,268,4,1542152,1542152,22958331,21416179,21416179,635677,20780502,13,0
22966219,806,1,2497555,2497555,22966219,20468664,20468664,2480341,17988323,54,0
23142095,689,1,2261952,2261952,23142095,20880143,20880143,2655509,18224634,42,0
23173685,1256,4,3310232,3310232,23173685,19863453,19863453,653912,19209541,22,0
23428884,1770,1,4087366,4087366,23428884,19341518,19341518,2719815,16621703,40,0
23449180,15,4,884079,884079,23449180,22565101,22565101,651007,21914094,23,0
23469802,97,1,1095394,1095394,23469802,22374408,22374408,2558233,19816175,29,0
23484121,376,1,1690299,1690299,23484121,21793822,21793822,2540557,19253265,44,0
23545924,746,8,2388184,2388184,23545924,21157740,21157740,377479,20780261,10,0
23650114,1435,8,3515188,3515188,23650114,20134926,20134926,416591,19718335,11,0
23702565,1784,8,4105774,4105774,23702565,19596791,19596791,364871,19231920,8,0
23792306,1906,4,4309920,4309920,23792306,19482386,19482386,718788,18763598,10,0
23882739,398,1,1690800,1690800,23882739,22191939,22191939,2649615,19542324,47,0
23953864,883,8,2742538,2742538,23953864,21211326,21211326,391015,20820311,20,0
23970131,1592,4,3746495,3746495,23970131,20223636,20223636,654977,19568659,20,0
24082140,1807,4,4139356,4139356,24082140,19942784,19942784,754188,19188596,13,0
24107543,1123,1,3068989,3068989,24107543,21038554,21038554,2609499,18429055,42,0
24115264,1942,8,4363039,4363039,24115264,19752225,19752225,330591,19421634,10,0
24177158,1447,1,3520575,3520575,24177158,20656583,20656583,2669222,17987361,40,0
24222172,219,4,1284627,1284627,24222172,22937545,22937545,702524,22235021,15,0
24297461,266,8,1523791,1523791,24297461,22773670,22773670,405422,22368248,5,0
24487133,818,4,2533763,2533763,24487133,21953370,21953370,847120,21106250,12,0
24680630,81,1,1064146,1064146,24680630,23616484,23616484,2840252,20776232,36,0
25092543,435,1,1691432,1691432,25092543,23401111,23401111,3062415,20338696,42,0
25094784,719,8,2325593,2325593,25094784,22769191,22769191,334374,22434817,8,0
25120724,735,4,2373644,2373644,25120724,22747080,22747080,689031,22058049,16,0
25256559,1113,8,3059668,3059668,25256559,22196891,22196891,467063,21729828,11,0
25518423,1469,8,3571147,3571147,25518423,21947276,21947276,598327,21348949,7,0
25520525,1751,4,4040500,4040500,25520525,21480025,21480025,674717,20805308,17,0
25759918,386,1,1690717,1690717,25759918,24069201,24069201,2956127,21113074,47,0
25799088,1025,8,2899350,2899350,25799088,22899738,22899738,377261,22522477,11,0
25916633,1629,1,3796510,3796510,25916633,22120123,22120123,2837127,19282996,22,0
26116461,1940,8,4355438,4355438,26116461,21761023,21761023,537808,21223215,14,0
26184259,1055,1,2991565,2991565,26184259,23192694,23192694,2830093,20362601,60,0
26242246,1666,8,3876531,3876531,26242246,22365715,22365715,406350,21959365,10,0
26381145,683,8,2239109,2239109,26381145,24142036,24142036,489476,23652560,7,0
26508143,1204,1,3193548,3193548,26508143,23314595,23314595,2931630,20382965,47,0
26543004,677,1,2227724,2227724,26543004,24315280,24315280,2864575,21450705,38,0
26554248,716,8,2322470,2322470,26554248,24231778,24231778,367177,23864601,10,0
26576405,902,4,2759413,2759413,26576405,23816992,23816992,734259,23082733,17,0
26640566,652,8,2190994,2190994,26640566,24449572,24449572,426797,24022775,11,0
26687924,772,8,2446000,2446000,26687924,24241924,24241924,407938,23833986,12,0
26689049,1930,1,4353126,4353126,26689049,22335923,22335923,2860457,19475466,26,0
26859421,1576,1,3707853,3707853,26859421,23151568,23151568,3086744,20064824,38,0
26878356,793,1,2483261,2483261,26878356,24395095,24395095,2949228,21445867,53,0
27020851,132,1,1161486,1161486,27020851,25859365,25859365,3087265,22772100,27,0
27043390,684,1,2243824,2243824,27043390,24799566,24799566,2973449,21826117,42,0
27195282,65,16,1023955,1023955,27195282,26171327,26171327,337294,25834033,9,0
27298475,441,1,1691572,1691572,27298475,25606903,25606903,3079487,22527416,55,0
27300074,1644,32,3812815,3812815,27300074,23487259,23487259,94829,23392430,4,0
27303742,298,4,1601053,1601053,27303742,25702689,25702689,754465,24948224,15,0
27327867,306,4,1603522,1603522,27327867,25724345,25724345,779557,24944788,25,0
27569943,732,8,2365646,2365646,27569943,25204297,25204297,620851,24583446,8,0
27588984,1773,4,4089784,4089784,27588984,23499200,23499200,774624,22724576,18,0
27636126,449,1,1691765,1691765,27636126,25944361,25944361,3109980,22834381,44,0
27663452,1018,1,2893819,2893819,27663452,24769633,24769633,3092577,21677056,35,0
27689280,1299,8,3361217,3361217,27689280,24328063,24328063,407751,23920312,16,0
27701107,106,1,1095885,1095885,27701107,26605222,26605222,3118042,23487180,35,0
27702008,434,1,1691413,1691413,27702008,26010595,26010595,3110172,22900423,43,0
27720294,413,1,1690879,1690879,27720294,26029415,26029415,3129753,22899662,48,0
27954005,726,8,2336802,2336802,27954005,25617203,25617203,621456,24995747,5,0
27987725,811,8,2512642,2512642,27987725,25475083,25475083,423449,25051634,6,0
28014279,163,1,1167711,1167711,28014279,26846568,26846568,3166082,23680486,31,0
28031210,108,1,1098912,1098912,28031210,26932298,26932298,3182484,23749814,49,0
28064825,1199,1,3193525,3193525,28064825,24871300,24871300,3174657,21696643,55,0
28120662,1471,1,3580208,3580208,28120662,24540454,24540454,3203226,21337228,30,0
28280152,1935,1,4353129,4353129,28280152,23927023,23927023,3302210,20624813,34,0
28284847,967,4,2830160,2830160,28284847,25454687,25454687,804076,24650611,22,0
28341019,1231,1,3193655,3193655,28341019,25147364,25147364,3248886,21898478,53,0
28418061,1904,4,4309171,4309171,28418061,24108890,24108890,879215,23229675,21,0
28485293,424,1,1690915,1690915,28485293,26794378,26794378,3326943,23467435,43,0
28507708,765,8,2419952,2419952,28507708,26087756,26087756,430120,25657636,11,0
28534084,974,4,2837460,2837460,28534084,25696624,25696624,831798,24864826,17,0
28543325,1131,1,3078680,3078680,28543325,25464645,25464645,3264161,22200484,38,0
28559147,1507,1,3617610,3617610,28559147,24941537,24941537,3273626,21667911,51,0
28565065,1188,1,3193471,3193471,28565065,25371594,25371594,3261351,22110243,65,0
28670149,208,8,1272262,1272262,28670149,27397887,27397887,515632,26882255,16,0
28719240,1029,8,2907856,2907856,28719240,25811384,25811384,464599,25346785,12,0
28790502,1397,1,3445118,3445118,28790502,25345384,25345384,3351401,21993983,58,0
28829809,1743,8,4029548,4029548,28829809,24800261,24800261,451372,24348889,12,0
28915916,823,4,2541525,2541525,28915916,26374391,26374391,917711,25456680,23,0
28948801,940,8,2807448,2807448,28948801,26141353,26141353,449819,25691534,21,0
28972439,1510,1,3618823,3618823,28972439,25353616,25353616,3375057,21978559,55,0
29084604,666,8,2215343,2215343,29084604,26869261,26869261,537463,26331798,13,0
29133288,858,8,2705757,2705757,29133288,26427531,26427531,470253,25957278,12,0
29257477,1028,8,2907066,2907066,29257477,26350411,26350411,550025,25800386,9,0
29390209,1380,8,3439192,3439192,29390209,25951017,25951017,555729,25395288,27,0
30197765,242,16,1372983,1372983,30197765,28824782,28824782,1021300,27803482,7,0
30278524,1334,4,3370237,3370237,30278524,26908287,26908287,938280,25970007,30,0
30400017,650,8,2189591,2189591,30400017,28210426,28210426,552341,27658085,11,0
30485328,415,1,1690884,1690884,30485328,28794444,28794444,3614751,25179693,51,0
30503844,670,1,2223204,2223204,30503844,28280640,28280640,3520443,24760197,52,0
30504566,1130,8,3075245,3075245,30504566,27429321,27429321,434287,26995034,20,0
30508649,843,1,2662291,2662291,30508649,27846358,27846358,3538629,24307729,68,0
30511432,1430,1,3510026,3510026,30511432,27001406,27001406,3512289,23489117,60,0
30620736,1892,1,4305861,4305861,30620736,26314875,26314875,3585605,22729270,52,0
30704015,564,2,1979172,1979172,30704015,28724843,28724843,1868669,26856174,39,0
30712550,1866,4,4263429,4263429,30712550,26449121,26449121,898943,25550178,18,0
30724214,770,2,2427939,2427939,30724214,28296275,28296275,1812101,26484174,37,0
30832607,919,4,2786492,2786492,30832607,28046115,28046115,1012979,27033136,18,0
30879611,1142,8,3088041,3088041,30879611,27791570,27791570,497347,27294223,15,0
31128671,1418,16,3500440,3500440,31128671,27628231,27628231,473640,27154591,19,0
31167303,1998,8,4505802,4505802,31167303,26661501,26661501,489442,26172059,9,0
31305468,537,1,1952436,1952436,31305468,29353032,29353032,3814650,25538382,57,0
31406256,897,8,2755596,2755596,31406256,28650660,28650660,561882,28088778,14,0
31457743,1307,16,3362445,3362445,31457743,28095298,28095298,282004,27813294,17,0
31464354,1206,1,3193555,3193555,31464354,28270799,28270799,3697534,24573265,58,0
31491525,225,8,1300071,1300071,31491525,30191454,30191454,498668,29692786,14,0
31588663,1058,1,2991699,2991699,31588663,28596964,28596964,3842518,24754446,74,0
31639473,1223,1,3193624,3193624,31639473,28445849,28445849,3772365,24673484,69,0
31671528,1478,16,3595699,3595699,31671528,28075829,28075829,265590,27810239,12,0
32108257,194,4,1251798,1251798,32108257,30856459,30856459,1399368,29457091,21,0
32207351,279,16,1583559,1583559,32207351,30623792,30623792,339356,30284436,9,0
32333741,700,8,2305409,2305409,32333741,30028332,30028332,600829,29427503,14,0
32391436,1205,1,3193551,3193551,32391436,29197885,29197885,3861120,25336765,66,0
32412982,1189,1,3193474,3193474,32412982,29219508,29219508,3871408,25348100,67,0
32675626,96,1,1095354,1095354,32675626,31580272,31580272,4146987,27433285,39,0
32768693,1212,1,3193578,3193578,32768693,29575115,29575115,3947092,25628023,66,0
32956033,1434,4,3514253,3514253,32956033,29441780,29441780,1158929,28282851,30,0
33141278,465,1,1692806,1692806,33141278,31448472,31448472,4110922,27337550,63,0
33259102,934,1,2803110,2803110,33259102,30455992,30455992,4035348,26420644,64,0
33414975,1627,4,3796469,3796469,33414975,29618506,29618506,1140242,28478264,19,0
33563635,1808,8,4139733,4139733,33563635,29423902,29423902,647402,28776500,9,0
33771191,870,4,2736582,2736582,33771191,31034609,31034609,1216924,29817685,26,0
33904734,1112,4,3059288,3059288,33904734,30845446,30845446,1134458,29710988,22,0
34107773,587,8,2007731,2007731,34107773,32100042,32100042,713722,31386320,14,0
34170071,210,8,1273276,1273276,34170071,32896795,32896795,577992,32318803,14,0
34348198,1002,1,2882601,2882601,34348198,31465597,31465597,4307553,27158044,72,0
34399473,623,8,2136763,2136763,34399473,32262710,32262710,575998,31686712,10,0
34740962,1624,1,3794751,3794751,34740962,30946211,30946211,4488488,26457723,35,0
34920579,38,8,961993,961993,34920579,33958586,33958586,707797,33250789,10,0
35202763,185,8,1245296,1245296,35202763,33957467,33957467,810493,33146974,15,0
35219192,236,16,1368361,1368361,35219192,33850831,33850831,285990,33564841,12,0
35394685,763,16,2413166,2413166,35394685,32981519,32981519,443791,32537728,5,0
35618058,1920,8,4323830,4323830,35618058,31294228,31294228,755311,30538917,13,0
35651625,578,4,1999889,1999889,35651625,33651736,33651736,1129167,32522569,20,0
35697651,804,16,2495758,2495758,35697651,33201893,33201893,319685,32882208,7,0
35901082,881,8,2739645,2739645,35901082,33161437,33161437,747559,32413878,17,0
35985745,1309,8,3362801,3362801,35985745,32622944,32622944,631799,31991145,20,0
36213143,1398,8,3447475,3447475,36213143,32765668,32765668,783037,31982631,20,0
36333688,615,4,2008419,2008419,36333688,34325269,34325269,1248186,33077083,16,0
36352720,1408,16,3484665,3484665,36352720,32868055,32868055,300862,32567193,8,0
36380120,1605,8,3770058,3770058,36380120,32610062,32610062,593178,32016884,17,0
36726749,1200,1,3193529,3193529,36726749,33533220,33533220,4865844,28667376,65,0
37025812,1936,8,4353723,4353723,37025812,32672089,32672089,872759,31799330,9,0
37284947,493,8,1845539,1845539,37284947,35439408,35439408,835053,34604355,14,0
37454911,565,8,1980098,1980098,37454911,35474813,35474813,745873,34728940,7,0
37627550,1717,1,3969174,3969174,37627550,33658376,33658376,4780053,28878323,53,0
37636503,61,8,1022485,1022485,37636503,36614018,36614018,591447,36022571,18,0
37688409,1980,4,4471989,4471989,37688409,33216420,33216420,1211795,32004625,16,0
37720078,581,8,2001905,2001905,37720078,35718173,35718173,624851,35093322,19,0
37756562,1956,4,4389794,4389794,37756562,33366768,33366768,1222542,32144226,15,0
38104779,1414,8,3498818,3498818,38104779,34605961,34605961,945305,33660656,17,0
38191746,1971,4,4433484,4433484,38191746,33758262,33758262,1286177,32472085,31,0
38193817,1196,1,3193509,3193509,38193817,35000308,35000308,4868202,30132106,63,0
38242775,988,8,2855060,2855060,38242775,35387715,35387715,654538,34733177,11,0
38278375,1370,1,3428071,3428071,38278375,34850304,34850304,4901838,29948466,46,0
38432326,11,1,880119,880119,38432326,37552207,37552207,5106406,32445801,52,0
38534374,722,8,2329815,2329815,38534374,36204559,36204559,723259,35481300,10,0
38578577,1190,1,3193479,3193479,38578577,35385098,35385098,4961006,30424092,59,0
38582473,1902,32,4308065,4308065,38582473,34274408,34274408,157001,34117407,12,0
38613819,1227,1,3193640,3193640,38613819,35420179,35420179,4989174,30431005,72,0
38839203,1286,1,3359853,3359853,38839203,35479350,35479350,5199593,30279757,72,0
38913938,668,8,2220318,2220318,38913938,36693620,36693620,711545,35982075,15,0
38941708,1218,1,3193600,3193600,38941708,35748108,35748108,5016574,30731534,80,0
38942445,1562,8,3703503,3703503,38942445,35238942,35238942,626984,34611958,16,0
38977240,1197,1,3193513,3193513,38977240,35783727,35783727,5060658,30723069,71,0
38996968,1924,4,4340515,4340515,38996968,34656453,34656453,1271799,33384654,24,0
39000044,1217,1,3193597,3193597,39000044,35806447,35806447,5075047,30731400,81,0
39086106,801,8,2487790,2487790,39086106,36598316,36598316,730709,35867607,16,0
39206903,1932,1,4353128,4353128,39206903,34853775,34853775,5244559,29609216,35,0
39242459,968,4,2830704,2830704,39242459,36411755,36411755,1342925,35068830,26,0
39251712,1990,1,4489182,4489182,39251712,34762530,34762530,5187433,29575097,46,0
39351029,459,1,1692014,1692014,39351029,37659015,37659015,5378061,32280954,69,0
39403504,952,1,2811581,2811581,39403504,36591923,36591923,5308490,31283433,74,0
40062592,1922,8,4334396,4334396,40062592,35728196,35728196,1316545,34411651,18,0
40063919,388,1,1690731,1690731,40063919,38373188,38373188,5317013,33056175,45,0
40075929,1989,4,4487642,4487642,40075929,35588287,35588287,1325978,34262309,29,0
40093771,799,1,2485905,2485905,40093771,37607866,37607866,5376418,32231448,68,0
40106987,971,1,2836246,2836246,40106987,37270741,37270741,5324982,31945759,77,0
40330663,1104,1,3055694,3055694,40330663,37274969,37274969,5557370,31717599,69,0
40355426,1546,4,3661160,3661160,40355426,36694266,36694266,1354924,35339342,23,0
40453617,1,8,336541,336541,40453617,40117076,40117076,779751,39337325,7,0
40464152,74,16,1041491,1041491,40464152,39422661,39422661,347737,39074924,10,0
40481707,458,1,1692001,1692001,40481707,38789706,38789706,5404381,33385325,59,0
40486092,381,1,1690680,1690680,40486092,38795412,38795412,5409543,33385869,64,0
40513710,443,1,1691611,1691611,40513710,38822099,38822099,5436122,33385977,44,0
40534283,1012,4,2891765,2891765,40534283,37642518,37642518,1363527,36278991,21,0
40565522,167,1,1167770,1167770,40565522,39397752,39397752,5485400,33912352,71,0
40635844,158,1,1165528,1165528,40635844,39470316,39470316,5554576,33915740,64,0
40646704,1652,1,3834993,3834993,40646704,36811711,36811711,5432215,31379496,47,0
40743467,1653,1,3837215,3837215,40743467,36906252,36906252,5528554,31377698,44,0
40910933,253,4,1432085,1432085,40910933,39478848,39478848,1555744,37923104,19,0
41008302,517,8,1895072,1895072,41008302,39113230,39113230,800920,38312310,15,0
41033312,817,1,2532070,2532070,41033312,38501242,38501242,5570330,32930912,75,0
41039722,907,1,2768658,2768658,41039722,38271064,38271064,5576094,32694970,65,0
41074380,983,4,2842212,2842212,41074380,38232168,38232168,1446966,36785202,35,0
41147029,1375,8,3435762,3435762,41147029,37711267,37711267,774360,36936907,11,0
41506230,1541,8,3640312,3640312,41506230,37865918,37865918,1055265,36810653,13,0
41544906,1680,16,3947235,3947235,41544906,37597671,37597671,387532,37210139,9,0
41562694,13,1,880165,880165,41562694,40682529,40682529,5695853,34986676,58,0
41641292,148,1,1165345,1165345,41641292,40475947,40475947,5811505,34664442,84,0
41925993,368,1,1685688,1685688,41925993,40240305,40240305,6043073,34197232,68,0
41963453,764,8,2419614,2419614,41963453,39543839,39543839,753431,38790408,11,0
42030658,841,4,2662218,2662218,42030658,39368440,39368440,1511401,37857039,21,0
42235339,869,1,2736572,2736572,42235339,39498767,39498767,5978193,33520574,81,0
42346635,1972,4,4434338,4434338,42346635,37912297,37912297,1534354,36377943,30,0
42737676,364,8,1669444,1669444,42737676,41068232,41068232,1135043,39933189,10,0
42914898,510,8,1875106,1875106,42914898,41039792,41039792,923098,40116694,15,0
42942214,859,8,2712874,2712874,42942214,40229340,40229340,755137,39474203,12,0
43068598,1090,8,3045237,3045237,43068598,40023361,40023361,861521,39161840,24,0
43085544,1660,8,3849703,3849703,43085544,39235841,39235841,755828,38480013,12,0
43384846,1938,8,4355145,4355145,43384846,39029701,39029701,1032991,37996710,13,0
43396392,33,16,952206,952206,43396392,42444186,42444186,389016,42055170,13,0
43445586,1968,4,4431138,4431138,43445586,39014448,39014448,1515090,37499358,28,0
43518279,733,8,2366023,2366023,43518279,41152256,41152256,823303,40328953,15,0
43627091,751,8,2405183,2405183,43627091,41221908,41221908,856373,40365535,15,0
43717439,976,8,2838710,2838710,43717439,40878729,40878729,844809,40033920,16,0
43718940,1610,8,3777291,3777291,43718940,39941649,39941649,760504,39181145,11,0
43888423,1329,8,3367724,3367724,43888423,40520699,40520699,928998,39591701,19,0
44125226,1812,8,4158422,4158422,44125226,39966804,39966804,996785,38970019,16,0
44135210,172,4,1195817,1195817,44135210,42939393,42939393,1559851,41379542,23,0
44255971,222,4,1284745,1284745,44255971,42971226,42971226,1686559,41284667,26,0
44259718,908,8,2769355,2769355,44259718,41490363,41490363,780737,40709626,16,0
44424389,414,1,1690880,1690880,44424389,42733509,42733509,6398280,36335229,66,0
44729946,1237,8,3193759,3193759,44729946,41536187,41536187,1068686,40467501,16,0
44732927,1748,8,4037207,4037207,44732927,40695720,40695720,781396,39914324,17,0
44817849,1628,1,3796485,3796485,44817849,41021364,41021364,6309874,34711490,54,0
44851735,50,1,999520,999520,44851735,43852215,43852215,6318472,37533743,83,0
44897787,541,8,1959609,1959609,44897787,42938178,42938178,840317,42097861,18,0
44911194,542,8,1961540,1961540,44911194,42949654,42949654,801953,42147701,14,0
45106181,1760,8,4053733,4053733,45106181,41052448,41052448,978791,40073657,12,0
45214183,526,1,1935047,1935047,45214183,43279136,43279136,6532178,36746958,79,0
45616330,824,2,2541943,2541943,45616330,43074387,43074387,3626733,39447654,48,0
45783658,125,8,1133603,1133603,45783658,44650055,44650055,980107,43669948,10,0
45802256,483,8,1774938,1774938,45802256,44027318,44027318,852980,43174338,15,0
46045146,754,2,2406416,2406416,46045146,43638730,43638730,3537308,40101422,57,0
46159137,865,2,2736420,2736420,46159137,43422717,43422717,3456627,39966090,59,0
46308007,1306,1,3362419,3362419,46308007,42945588,42945588,6789943,36155645,51,0
46316527,1823,4,4188271,4188271,46316527,42128256,42128256,1630460,40497796,25,0
46488694,1946,8,4372263,4372263,46488694,42116431,42116431,997548,41118883,11,0
46536929,425,1,1690919,1690919,46536929,44846010,44846010,6770257,38075753,56,0
47340485,535,8,1951848,1951848,47340485,45388637,45388637,1641092,43747545,15,0
47440171,631,4,2152324,2152324,47440171,45287847,45287847,1771993,43515854,32,0
47666738,930,16,2800248,2800248,47666738,44866490,44866490,649105,44217385,11,0
47793553,1431,1,3510139,3510139,47793553,44283414,44283414,6944576,37338838,76,0
48019229,1705,8,3961472,3961472,48019229,44057757,44057757,1083953,42973804,14,0
48036679,1045,1,2972871,2972871,48036679,45063808,45063808,6933631,38130177,84,0
48102337,836,2,2662074,2662074,48102337,45440263,45440263,3555038,41885225,60,0
48222995,308,1,1606851,1606851,48222995,46616144,46616144,7122185,39493959,83,0
48548662,1955,4,4389277,4389277,48548662,44159385,44159385,2070817,42088568,31,0
48558911,98,1,1095479,1095479,48558911,47463432,47463432,7138947,40324485,57,0
48645260,201,4,1255314,1255314,48645260,47389946,47389946,1915529,45474417,28,0
49280510,359,1,1639287,1639287,49280510,47641223,47641223,7857669,39783554,77,0
49344465,862,2,2736359,2736359,49344465,46608106,46608106,3693525,42914581,60,0
49746224,840,4,2662195,2662195,49746224,47084029,47084029,2219756,44864273,30,0
49791738,1109,8,3057117,3057117,49791738,46734621,46734621,961889,45772732,15,0
49811902,1191,1,3193483,3193483,49811902,46618419,46618419,7189874,39428545,78,0
49852265,1482,8,3601585,3601585,49852265,46250680,46250680,967387,45283293,14,0
49871841,1724,4,4005336,4005336,49871841,45866505,45866505,1852390,44014115,20,0
50181827,1693,4,3959582,3959582,50181827,46222245,46222245,2111366,44110879,18,0
50237543,278,4,1581732,1581732,50237543,48655811,48655811,1924690,46731121,25,0
50404120,945,8,2810304,2810304,50404120,47593816,47593816,1103531,46490285,18,0
50456127,1300,1,3361468,3361468,50456127,47094659,47094659,7534036,39560623,82,0
50526656,1525,1,3623248,3623248,50526656,46903408,46903408,7502027,39401381,68,0
50726475,110,1,1098983,1098983,50726475,49627492,49627492,8055785,41571707,55,0
50881670,361,1,1639369,1639369,50881670,49242301,49242301,7955952,41286349,78,0
50998603,423,1,1690911,1690911,50998603,49307692,49307692,7845577,41462115,66,0
51024936,403,1,1690836,1690836,51024936,49334100,49334100,7873629,41460471,67,0
51047870,430,1,1691309,1691309,51047870,49356561,49356561,7895669,41460892,48,0
51216943,896,8,2755390,2755390,51216943,48461553,48461553,1114612,47346941,26,0
51238173,1172,8,3167276,3167276,51238173,48070897,48070897,981861,47089036,16,0
51307703,1250,8,3270949,3270949,51307703,48036754,48036754,1055664,46981090,8,0
51452692,1415,8,3498887,3498887,51452692,47953805,47953805,1091998,46861807,15,0
51491237,1689,8,3950080,3950080,51491237,47541157,47541157,1022196,46518961,15,0
52181380,1591,4,3746053,3746053,52181380,48435327,48435327,2660422,45774905,21,0
52416872,673,8,2223540,2223540,52416872,50193332,50193332,1231737,48961595,14,0
52556668,800,8,2486332,2486332,52556668,50070336,50070336,1137161,48933175,22,0
52576751,147,1,1165329,1165329,52576751,51411422,51411422,8064522,43346900,86,0
52776338,635,2,2153175,2153175,52776338,50623163,50623163,4215961,46407202,58,0
52935441,1175,4,3183638,3183638,52935441,49751803,49751803,2157324,47594479,22,0
52956448,1766,8,4072646,4072646,52956448,48883802,48883802,1033485,47850317,15,0
53308454,1960,8,4417144,4417144,53308454,48891310,48891310,1359841,47531469,18,0
53339726,1564,8,3703663,3703663,53339726,49636063,49636063,1056579,48579484,25,0
53471793,1954,4,4384943,4384943,53471793,49086850,49086850,2202991,46883859,32,0
53537484,180,4,1241289,1241289,53537484,52296195,52296195,2187666,50108529,29,0
53595294,864,2,2736397,2736397,53595294,50858897,50858897,4285650,46573247,50,0
53604010,911,8,2770483,2770483,53604010,50833527,50833527,1072994,49760533,18,0
53660539,1054,1,2989800,2989800,53660539,50670739,50670739,8387227,42283512,90,0
53770820,1325,1,3365736,3365736,53770820,50405084,50405084,8638474,41766610,88,0
53772706,1530,8,3624228,3624228,53772706,50148478,50148478,1071054,49077424,18,0
54002690,1496,8,3615601,3615601,54002690,50387089,50387089,1274202,49112887,21,0
54148895,1772,4,4089411,4089411,54148895,50059484,50059484,2281438,47778046,32,0
54231528,203,4,1255347,1255347,54231528,52976181,52976181,2246456,50729725,31,0
54266909,653,8,2191069,2191069,54266909,52075840,52075840,1117369,50958471,16,0
54340191,452,1,1691827,1691827,54340191,52648364,52648364,8840166,43808198,71,0
54501233,557,1,1974659,1974659,54501233,52526574,52526574,8989510,43537064,76,0
54956085,1024,8,2899015,2899015,54956085,52057070,52057070,1532647,50524423,15,0
55012751,1328,8,3367697,3367697,55012751,51645054,51645054,1136946,50508108,27,0
55421945,1427,8,3505880,3505880,55421945,51916065,51916065,1497405,50418660,19,0
55858241,1852,8,4231928,4231928,55858241,51626313,51626313,1518228,50108085,15,0
56014998,427,1,1691226,1691226,56014998,54323772,54323772,9103554,45220218,66,0
56127803,468,1,1703761,1703761,56127803,54424042,54424042,9123571,45300471,83,0
56221943,640,8,2154476,2154476,56221943,54067467,54067467,1233272,52834195,16,0
56563353,730,8,2362242,2362242,56563353,54201111,54201111,1462948,52738163,21,0
56763156,886,8,2743072,2743072,56763156,54020084,54020084,1324874,52695210,21,0
56929382,1179,1,3193433,3193433,56929382,53735949,53735949,9410840,44325109,99,0
57213984,1226,1,3193637,3193637,57213984,54020347,54020347,9562973,44457374,69,0
57390510,1642,8,3812024,3812024,57390510,53578486,53578486,1303703,52274783,18,0
57705784,1827,4,4197246,4197246,57705784,53508538,53508538,2572469,50936069,38,0
58234592,369,1,1685757,1685757,58234592,56548835,56548835,9839834,46709001,86,0
58344197,379,1,1690337,1690337,58344197,56653860,56653860,9427046,47226814,74,0
58352667,784,2,2470343,2470343,58352667,55882324,55882324,4794991,51087333,52,0
58538780,536,1,1952420,1952420,58538780,56586360,56586360,9858907,46727453,83,0
58611763,417,1,1690887,1690887,58611763,56920876,56920876,9687869,47233007,70,0
58615935,1271,1,3344219,3344219,58615935,55271716,55271716,9483699,45788017,88,0
58680333,387,1,1690724,1690724,58680333,56989609,56989609,9815726,47173883,75,0
58949937,1060,1,2991721,2991721,58949937,55958216,55958216,9777355,46180861,88,0
59131555,1872,4,4279427,4279427,59131555,54852128,54852128,2540394,52311734,38,0
59238416,267,4,1541381,1541381,59238416,57697035,57697035,2553856,55143179,29,0
59239510,362,1,1639430,1639430,59239510,57600080,57600080,9943597,47656483,88,0
59401409,833,1,2632777,2632777,59401409,56768632,56768632,9990437,46778195,100,0
59418258,718,8,2323037,2323037,59418258,57095221,57095221,1249702,55845519,14,0
59510846,1651,1,3834945,3834945,59510846,55675901,55675901,9944757,45731144,63,0
59730517,1750,4,4040328,4040328,59730517,55690189,55690189,2689900,53000289,29,0
60137370,59,16,1013092,1013092,60137370,59124278,59124278,1036052,58088226,12,0
60488544,466,1,1692810,1692810,60488544,58795734,58795734,10377210,48418524,92,0
60521072,774,8,2446230,2446230,60521072,58074842,58074842,1280900,56793942,13,0
60708841,867,4,2736539,2736539,60708841,57972302,57972302,2684914,55287388,45,0
60823693,1032,16,2917513,2917513,60823693,57906180,57906180,765382,57140798,13,0
60892549,1340,16,3374496,3374496,60892549,57518053,57518053,705620,56812433,20,0
60950269,1527,8,3623578,3623578,60950269,57326691,57326691,1355722,55970969,17,0
61124947,93,1,1088222,1088222,61124947,60036725,60036725,10669718,49367007,63,0
61208722,19,4,906308,906308,61208722,60302414,60302414,2777061,57525353,40,0
61248622,422,1,1690906,1690906,61248622,59557716,59557716,10637207,48920509,69,0
61344093,499,1,1860327,1860327,61344093,59483766,59483766,10725246,48758520,95,0
61468078,701,16,2305606,2305606,61468078,59162472,59162472,804660,58357812,14,0
61504213,516,1,1889570,1889570,61504213,59614643,59614643,10886441,48728202,92,0
61721180,1043,1,2972813,2972813,61721180,58748367,58748367,10780594,47967773,96,0
61912143,1183,1,3193452,3193452,61912143,58718691,58718691,10920843,47797848,98,0
62154295,1269,16,3343960,3343960,62154295,58810335,58810335,904333,57906002,8,0
62417148,1476,8,3594238,3594238,62417148,58822910,58822910,1636331,57186579,15,0
62514864,1638,2,3798158,3798158,62514864,58716706,58716706,5416081,53300625,39,0
62647171,1738,4,4019622,4019622,62647171,58627549,58627549,2821301,55806248,35,0
62819116,1947,8,4373176,4373176,62819116,58445940,58445940,1522073,56923867,14,0
63265816,447,1,1691721,1691721,63265816,61574095,61574095,11619852,49954243,74,0
63462539,485,8,1806785,1806785,63462539,61655754,61655754,1595286,60060468,9,0
63606358,540,1,1957901,1957901,63606358,61648457,61648457,11395011,50253446,76,0
63995656,1093,8,3045805,3045805,63995656,60949851,60949851,1791020,59158831,19,0
64251923,1268,8,3343017,3343017,64251923,60908906,60908906,1676045,59232861,20,0
64286805,1622,1,3794697,3794697,64286805,60492108,60492108,11076718,49415390,60,0
64755779,1495,1,3615597,3615597,64755779,61140182,61140182,11581092,49559090,60,0
65002157,1768,4,4086592,4086592,65002157,60915565,60915565,3018823,57896742,26,0
66263631,44,1,990526,990526,66263631,65273105,65273105,12953525,52319580,97,0
66301813,220,4,1284690,1284690,66301813,65017123,65017123,2999476,62017647,33,0
66512388,358,1,1639246,1639246,66512388,64873142,64873142,11901346,52971796,88,0
66580514,109,1,1098951,1098951,66580514,65481563,65481563,11877744,53603819,86,0
66612197,400,1,1690813,1690813,66612197,64921384,64921384,11657756,53263628,76,0
66613320,166,1,1167748,1167748,66613320,65445572,65445572,12030939,53414633,69,0
66617655,391,1,1690752,1690752,66617655,64926903,64926903,11790947,53135956,82,0
66644242,432,1,1691363,1691363,66644242,64952879,64952879,11750805,53202074,59,0
66661952,431,1,1691328,1691328,66661952,64970624,64970624,11742316,53228308,58,0
66689732,392,1,1690759,1690759,66689732,64998973,64998973,11730208,53268765,80,0
66750021,270,4,1544882,1544882,66750021,65205139,65205139,3193470,62011669,38,0
66940993,99,1,1095513,1095513,66940993,65845480,65845480,13646164,52199316,67,0
67126768,574,1,1988375,1988375,67126768,65138393,65138393,12007846,53130547,88,0
67727485,436,1,1691458,1691458,67727485,66036027,66036027,12835769,53200258,77,0
67774743,136,1,1161574,1161574,67774743,66613169,66613169,13201485,53411684,67,0
67873569,678,4,2227731,2227731,67873569,65645838,65645838,3163825,62482013,44,0
67879079,416,1,1690886,1690886,67879079,66188193,66188193,12923845,53264348,86,0
67977550,420,1,1690898,1690898,67977550,66286652,66286652,13021635,53265017,71,0
67988354,150,1,1165380,1165380,67988354,66822974,66822974,13405896,53417078,91,0
68018422,888,1,2743130,2743130,68018422,65275292,65275292,11698074,53577218,90,0
68343413,744,8,2385513,2385513,68343413,65957900,65957900,1830969,64126931,13,0
68482084,572,1,1982246,1982246,68482084,66499838,66499838,13387715,53112123,75,0
68556234,790,8,2480916,2480916,68556234,66075318,66075318,1746614,64328704,21,0
68732758,895,8,2755202,2755202,68732758,65977556,65977556,1754760,64222796,24,0
68881769,990,8,2857028,2857028,68881769,66024741,66024741,1678991,64345750,26,0
69073634,1036,16,2941883,2941883,69073634,66131751,66131751,946947,65184804,10,0
69108324,1192,1,3193487,3193487,69108324,65914837,65914837,12043796,53871041,104,0
69170645,873,1,2736644,2736644,69170645,66434001,66434001,13193863,53240138,87,0
69341423,1082,8,3018469,3018469,69341423,66322954,66322954,1775521,64547433,15,0
69479732,1242,16,3244126,3244126,69479732,66235606,66235606,983794,65251812,11,0
69788145,1441,1,3517379,3517379,69788145,66270766,66270766,12120892,54149874,92,0
69902678,1423,8,3501935,3501935,69902678,66400743,66400743,1735103,64665640,16,0
70166510,1254,1,3279636,3279636,70166510,66886874,66886874,12479660,54407214,88,0
70327096,1393,1,3444949,3444949,70327096,66882147,66882147,12645685,54236462,65,0
70777236,1615,4,3785220,3785220,70777236,66992016,66992016,3349861,63642155,26,0
71316890,1655,16,3841937,3841937,71316890,67474953,67474953,1304517,66170436,19,0
71328013,1664,1,3876343,3876343,71328013,67451670,67451670,12384851,55066819,65,0
71755264,1749,8,4039311,4039311,71755264,67715953,67715953,1901519,65814434,13,0
73369771,1625,1,3796419,3796419,73369771,69573352,69573352,15060331,54513021,52,0
73661877,1976,8,4444486,4444486,73661877,69217391,69217391,1918044,67299347,17,0
74267117,155,1,1165474,1165474,74267117,73101643,73101643,14366573,58735070,73,0
74387721,221,4,1284714,1284714,74387721,73103007,73103007,3728909,69374098,34,0
74721029,1914,1,4312695,4312695,74721029,70408334,70408334,14015582,56392752,46,0
74833540,691,8,2279591,2279591,74833540,72553949,72553949,1830066,70723883,23,0
75004198,963,16,2828497,2828497,75004198,72175701,72175701,1073783,71101918,19,0
75015824,1033,16,2924100,2924100,75015824,72091724,72091724,875265,71216459,15,0
75305071,1116,8,3060000,3060000,75305071,72245071,72245071,2059918,70185153,20,0
75451650,1194,1,3193499,3193499,75451650,72258151,72258151,14390133,57868018,88,0
75720442,1537,16,3631862,3631862,75720442,72088580,72088580,1172121,70916459,12,0
75801216,1371,1,3428093,3428093,75801216,72373123,72373123,14118177,58254946,72,0
75900854,4,8,543390,543390,75900854,75357464,75357464,2042779,73314685,9,0
76010841,248,8,1384680,1384680,76010841,74626161,74626161,2013187,72612974,22,0
76095677,539,8,1957199,1957199,76095677,74138478,74138478,1917212,72221266,18,0
76270624,373,1,1690269,1690269,76270624,74580355,74580355,15060824,59519531,81,0
76297391,699,8,2305071,2305071,76297391,73992320,73992320,1951309,72041011,29,0
76305507,663,4,2206945,2206945,76305507,74098562,74098562,3807040,70291522,32,0
76465092,0,1,0,0,76465092,76465092,76465092,15486530,60978562,101,0
76475411,145,1,1165303,1165303,76475411,75310108,75310108,15161868,60148240,73,0
76561463,720,8,2326979,2326979,76561463,74234484,74234484,2037091,72197393,19,0
77140157,738,8,2375225,2375225,77140157,74764932,74764932,2511083,72253849,23,0
77178290,807,8,2501458,2501458,77178290,74676832,74676832,1920525,72756307,20,0
77275860,780,8,2454711,2454711,77275860,74821149,74821149,1973474,72847675,22,0
77414379,1137,8,3082170,3082170,77414379,74332209,74332209,2064025,72268184,20,0
77426912,1239,16,3227030,3227030,77426912,74199882,74199882,929040,73270842,15,0
77490841,1173,8,3167913,3167913,77490841,74322928,74322928,1900907,72422021,25,0
78369014,1318,8,3363912,3363912,78369014,75005102,75005102,2691323,72313779,36,0
78401915,1428,8,3508947,3508947,78401915,74892968,74892968,1913288,72979680,26,0
78546616,1401,8,3449285,3449285,78546616,75097331,75097331,2003775,73093556,23,0
78651097,1593,8,3749178,3749178,78651097,74901919,74901919,2019081,72882838,26,0
78667155,1670,4,3934777,3934777,78667155,74732378,74732378,3806347,70926031,29,0
78740378,1779,8,4095109,4095109,78740378,74645269,74645269,2006823,72638446,25,0
78795059,1713,4,3963727,3963727,78795059,74831332,74831332,3816694,71014638,26,0
78980604,1979,8,4468456,4468456,78980604,74512148,74512148,2036612,72475536,17,0
79437615,193,8,1251720,1251720,79437615,78185895,78185895,2428459,75757436,21,0
79712274,231,8,1350010,1350010,79712274,78362264,78362264,2287772,76074492,21,0
79742648,558,2,1978456,1978456,79742648,77764192,77764192,7914270,69849922,59,0
79820387,479,8,1740302,1740302,79820387,78080085,78080085,2161374,75918711,21,0
80064611,419,1,1690894,1690894,80064611,78373717,78373717,16175850,62197867,74,0
80088459,637,4,2153445,2153445,80088459,77935014,77935014,4218126,73716888,35,0
80146707,884,8,2742846,2742846,80146707,77403861,77403861,2021497,75382364,24,0
80347501,899,8,2756946,2756946,80347501,77590555,77590555,2225997,75364558,19,0
80389358,980,8,2839765,2839765,80389358,77549593,77549593,2081445,75468148,20,0
80739528,1063,8,2996127,2996127,80739528,77743401,77743401,2445730,75297671,22,0
80900966,1139,16,3082926,3082926,80900966,77818040,77818040,1161865,76656175,21,0
81064411,1247,8,3255384,3255384,81064411,77809027,77809027,2184219,75624808,20,0
81203490,1312,1,3363209,3363209,81203490,77840281,77840281,16022352,61817929,89,0
81288365,1504,1,3617511,3617511,81288365,77670854,77670854,15856795,61814059,87,0
81490706,1561,1,3696452,3696452,81490706,77794254,77794254,16168187,61626067,62,0
81564729,1640,2,3798201,3798201,81564729,77766528,77766528,8266168,69500360,46,0
81690522,1643,8,3812798,3812798,81690522,77877724,77877724,2169679,75708045,18,0
81782559,1786,4,4107995,4107995,81782559,77674564,77674564,4040959,73633605,33,0
81840885,1926,8,4349964,4349964,81840885,77490921,77490921,2034751,75456170,22,0
82348208,1788,4,4110710,4110710,82348208,78237498,78237498,4588090,73649408,38,0
82387253,632,4,2152367,2152367,82387253,80234886,80234886,4299724,75935162,48,0
82774933,533,4,1946210,1946210,82774933,80828723,80828723,4738647,76090076,30,0
82776418,1110,8,3058458,3058458,82776418,79717960,79717960,2122895,77595065,19,0
82885128,707,16,2310637,2310637,82885128,80574491,80574491,1180524,79393967,22,0
83035913,1133,1,3079721,3079721,83035913,79956192,79956192,17163300,62792892,96,0
83130340,1277,20,3357934,3357934,83130340,79772406,79772406,938343,78834063,16,0
83227652,1616,4,3785531,3785531,83227652,79442121,79442121,4358731,75083390,32,0
83365837,1756,8,4049625,4049625,83365837,79316212,79316212,2256564,77059648,20,0
83434714,1184,1,3193455,3193455,83434714,80241259,80241259,17451773,62789486,104,0
83493689,1193,1,3193495,3193495,83493689,80300194,80300194,17445846,62854348,100,0
83596714,118,8,1105822,1105822,83596714,82490892,82490892,2509850,79981042,24,0
83917087,254,4,1432295,1432295,83917087,82484792,82484792,5192517,77292275,28,0
83951846,580,4,1999956,1999956,83951846,81951890,81951890,4749356,77202534,39,0
84063888,662,4,2206919,2206919,84063888,81856969,81856969,4738120,77118849,25,0
84105671,563,2,1979127,1979127,84105671,82126544,82126544,9166648,72959896,48,0
84387930,602,8,2008139,2008139,84387930,82379791,82379791,2629373,79750418,25,0
84462231,705,8,2309008,2309008,84462231,82153223,82153223,2296307,79856916,31,0
84761729,946,1,2810895,2810895,84761729,81950834,81950834,18198897,63751937,113,0
84999068,901,8,2758563,2758563,84999068,82240505,82240505,2425828,79814677,22,0
85140271,941,8,2807547,2807547,85140271,82332724,82332724,2503900,79828824,23,0
85602913,1092,8,3045783,3045783,85602913,82557130,82557130,2689432,79867698,27,0
85753749,396,1,1690786,1690786,85753749,84062963,84062963,19470558,64592405,86,0
85779584,460,1,1692034,1692034,85779584,84087550,84087550,19403845,64683705,91,0
85822006,1162,1,3138858,3138858,85822006,82683148,82683148,18632694,64050454,92,0
85857976,440,1,1691558,1691558,85857976,84166418,84166418,19550442,64615976,83,0
85880253,1260,8,3330983,3330983,85880253,82549270,82549270,2449519,80099751,21,0
85959725,1330,8,3367749,3367749,85959725,82591976,82591976,2393823,80198153,29,0
86300346,1343,8,3399506,3399506,86300346,82900840,82900840,2647727,80253113,14,0
86764446,1207,1,3193559,3193559,86764446,83570887,83570887,19375489,64195398,100,0
87392615,1229,1,3193648,3193648,87392615,84198967,84198967,19298838,64900129,89,0
87475365,1621,8,3790604,3790604,87475365,83684761,83684761,2343492,81341269,24,0
87554837,1769,4,4087155,4087155,87554837,83467682,83467682,4461746,79005936,32,0
87592280,1845,1,4222975,4222975,87592280,83369305,83369305,17927535,65441770,71,0
87778941,1672,4,3935213,3935213,87778941,83843728,83843728,4777041,79066687,27,0
87932217,1912,1,4312420,4312420,87932217,83619797,83619797,17791991,65827806,75,0
88076114,1941,8,4355598,4355598,88076114,83720516,83720516,2394832,81325684,20,0
88342971,80,4,1062187,1062187,88342971,87280784,87280784,5287995,81992789,36,0
88383840,119,8,1111825,1111825,88383840,87272015,87272015,2558620,84713395,21,0
88766623,178,8,1238400,1238400,88766623,87528223,87528223,2953093,84575130,30,0
88901318,271,4,1544974,1544974,88901318,87356344,87356344,5188442,82167902,47,0
88986041,503,4,1863316,1863316,88986041,87122725,87122725,5165779,81956946,22,0
89563506,644,8,2161910,2161910,89563506,87401596,87401596,3105283,84296313,21,0
90120177,829,4,2553043,2553043,90120177,87567134,87567134,5568087,81999047,45,0
90277818,474,1,1713634,1713634,90277818,88564184,88564184,21125651,67438533,103,0
90643596,1064,16,2996428,2996428,90643596,87647168,87647168,1599050,86048118,12,0
91090113,1150,8,3104922,3104922,91090113,87985191,87985191,2912361,85072830,30,0
91374149,1230,1,3193652,3193652,91374149,88180497,88180497,20392379,67788118,94,0
91493217,1737,8,4019436,4019436,91493217,87473781,87473781,2576651,84897130,20,0
91861582,1783,4,4104398,4104398,91861582,87757184,87757184,5416179,82341005,34,0
92155208,1890,4,4305223,4305223,92155208,87849985,87849985,5571721,82278264,34,0
92730713,103,1,1095725,1095725,92730713,91634988,91634988,22249131,69385857,92,0
92969692,79,8,1062109,1062109,92969692,91907583,91907583,3208691,88698892,19,0
93236136,69,4,1028041,1028041,93236136,92208095,92208095,5815447,86392648,28,0
93559191,37,8,961716,961716,93559191,92597475,92597475,3598447,88999028,15,0
94263396,134,1,1161521,1161521,94263396,93101875,93101875,22473122,70628753,96,0
94464064,217,4,1284564,1284564,94464064,93179500,93179500,5576679,87602821,43,0
94560271,399,1,1690807,1690807,94560271,92869464,92869464,21805883,71063581,84,0
94733167,276,4,1579787,1579787,94733167,93153380,93153380,6320419,86832961,42,0
94832819,475,1,1713637,1713637,94832819,93119182,93119182,21762548,71356634,98,0
95197525,123,1,1118114,1118114,95197525,94079411,94079411,23728033,70351378,79,0
96052067,478,8,1730719,1730719,96052067,94321348,94321348,3994920,90326428,19,0
96248543,374,1,1690276,1690276,96248543,94558267,94558267,23683703,70874564,80,0
96906436,497,4,1853263,1853263,96906436,95053173,95053173,7383731,87669442,28,0
96990670,390,1,1690745,1690745,96990670,95299925,95299925,24231651,71068274,85,0
98132131,690,8,2279108,2279108,98132131,95853023,95853023,4406824,91446199,23,0
98709880,767,16,2420053,2420053,98709880,96289827,96289827,2040950,94248877,18,0
98736358,1121,1,3067957,3067957,98736358,95668401,95668401,21342039,74326362,95,0
98781637,821,8,2538363,2538363,98781637,96243274,96243274,2722584,93520690,23,0
98787639,573,1,1982272,1982272,98787639,96805367,96805367,24034533,72770834,82,0
98916258,758,1,2409759,2409759,98916258,96506499,96506499,23118459,73388040,89,0
99595066,762,8,2411456,2411456,99595066,97183610,97183610,4200176,92983434,22,0
99763670,450,1,1691783,1691783,99763670,98071887,98071887,26563556,71508331,84,0
100097803,1101,8,3053861,3053861,100097803,97043942,97043942,3040664,94003278,33,0
100312690,1087,8,3025072,3025072,100312690,97287618,97287618,3329377,93958241,26,0
100432413,1146,8,3095703,3095703,100432413,97336710,97336710,3046372,94290338,26,0
100622335,1140,8,3083693,3083693,100622335,97538642,97538642,3453450,94085192,28,0
100751883,1095,8,3046027,3046027,100751883,97705856,97705856,3680294,94025562,30,0
100817233,1249,8,3265631,3265631,100817233,97551602,97551602,2833070,94718532,24,0
100985097,1154,16,3114403,3114403,100985097,97870694,97870694,1884473,95986221,15,0
101152858,1270,16,3344094,3344094,101152858,97808764,97808764,1870118,95938646,18,0
101543389,1264,1,3340533,3340533,101543389,98202856,98202856,22191385,76011471,99,0
101660442,1335,8,3370534,3370534,101660442,98289908,98289908,3197982,95091926,22,0
101868137,1385,8,3443903,3443903,101868137,98424234,98424234,3402191,95022043,19,0
102120850,1313,1,3363305,3363305,102120850,98757545,98757545,22723530,76034015,95,0
102477138,1448,8,3521490,3521490,102477138,98955648,98955648,3795458,95160190,37,0
102748843,1547,4,3665692,3665692,102748843,99083151,99083151,5614169,93468982,30,0
103879664,1545,4,3660369,3660369,103879664,100219295,100219295,7520528,92698767,41,0
103886058,1662,1,3858030,3858030,103886058,100028028,100028028,23150755,76877273,65,0
104094286,1646,8,3827358,3827358,104094286,100266928,100266928,3166951,97099977,20,0
104320226,1211,1,3193575,3193575,104320226,101126651,101126651,25235513,75891138,100,0
105266213,1650,4,3833043,3833043,105266213,101433170,101433170,6723575,94709595,26,0
105390038,1671,4,3935151,3935151,105390038,101454887,101454887,7022514,94432373,25,0
105554352,1235,1,3193670,3193670,105554352,102360682,102360682,26105465,76255217,102,0
106168514,1839,8,4216702,4216702,106168514,101951812,101951812,3732509,98219303,22,0
106296134,1857,1,4256276,4256276,106296134,102039858,102039858,23846854,78193004,76,0
106301489,1871,8,4275968,4275968,106301489,102025521,102025521,3373773,98651748,20,0
106339104,1781,4,4103465,4103465,106339104,102235639,102235639,6480325,95755314,33,0
106395024,1752,4,4040559,4040559,106395024,102354465,102354465,7012067,95342398,38,0
106548497,1910,1,4311954,4311954,106548497,102236543,102236543,24230871,78005672,82,0
107091636,1901,32,4308059,4308059,107091636,102783577,102783577,1296265,101487312,17,0
107548175,1863,4,4260899,4260899,107548175,103287276,103287276,6845751,96441525,47,0
107956949,1995,8,4499365,4499365,107956949,103457584,103457584,3760186,99697398,18,0
108535452,8,8,837589,837589,108535452,107697863,107697863,4639252,103058611,16,0
109027527,90,4,1081252,1081252,109027527,107946275,107946275,7777968,100168307,29,0
109075310,197,4,1253665,1253665,109075310,107821645,107821645,7349561,100472084,31,0
109080139,113,1,1099104,1099104,109080139,107981035,107981035,30550894,77430141,79,0
109799106,206,8,1262609,1262609,109799106,108536497,108536497,4654836,103881661,23,0
109862136,149,1,1165363,1165363,109862136,108696773,108696773,30664370,78032403,114,0
110044766,258,8,1463221,1463221,110044766,108581545,108581545,3872043,104709502,27,0
110169460,365,16,1669786,1669786,110169460,108499674,108499674,2155012,106344662,13,0
110246447,139,1,1161611,1161611,110246447,109084836,109084836,31051092,78033744,103,0
110699330,444,1,1691634,1691634,110699330,109007696,109007696,29895103,79112593,87,0
110783631,461,1,1692048,1692048,110783631,109091583,109091583,29736838,79354745,99,0
110906731,495,8,1845693,1845693,110906731,109061038,109061038,4457714,104603324,19,0
111080727,462,1,1692068,1692068,111080727,109388659,109388659,29994542,79394117,101,0
111478507,405,1,1690850,1690850,111478507,109787657,109787657,30879290,78908367,81,0
111550592,686,8,2252441,2252441,111550592,109298151,109298151,4010548,105287603,24,0
111627111,742,8,2381329,2381329,111627111,109245782,109245782,3789208,105456574,17,0
111788715,538,4,1952823,1952823,111788715,109835892,109835892,8759237,101076655,42,0
112083715,1202,1,3193540,3193540,112083715,108890175,108890175,29846516,79043659,94,0
112245379,619,1,2057998,2057998,112245379,110187381,110187381,31158874,79028507,91,0
112555653,743,8,2384534,2384534,112555653,110171119,110171119,4653231,105517888,22,0
112646612,748,8,2403395,2403395,112646612,110243217,110243217,4174658,106068559,23,0
112717655,892,8,2753753,2753753,112717655,109963902,109963902,3902826,106061076,31,0
113052621,879,8,2738353,2738353,113052621,110314268,110314268,4389680,105924588,39,0
113510884,1030,8,2908848,2908848,113510884,110602036,110602036,4228359,106373677,22,0
114030619,1094,8,3045855,3045855,114030619,110984764,110984764,4219631,106765133,33,0
114646862,682,1,2237532,2237532,114646862,112409330,112409330,32842623,79566707,88,0
114836780,14,1,881304,881304,114836780,113955476,113955476,36872754,77082722,111,0
114938041,1278,16,3358054,3358054,114938041,111579987,111579987,2203021,109376966,22,0
115331896,1251,8,3271106,3271106,115331896,112060790,112060790,4452440,107608350,21,0
115342724,1383,16,3443428,3443428,115342724,111899296,111899296,1819226,110080070,15,0
118866152,1437,4,3516892,3516892,118866152,115349260,115349260,11331431,104017829,41,0
119202456,1486,16,3603230,3603230,119202456,115599226,115599226,2342745,113256481,15,0
119789507,1555,4,3692850,3692850,119789507,116096657,116096657,7810029,108286628,39,0
120296381,1603,8,3769832,3769832,120296381,116526549,116526549,4709068,111817481,19,0
120588239,1626,4,3796441,3796441,120588239,116791798,116791798,8484093,108307705,30,0
121391423,1630,4,3796527,3796527,121391423,117594896,117594896,8695730,108899166,36,0
121893518,1641,2,3798226,3798226,121893518,118095292,118095292,16334046,101761246,52,0
122576826,1907,8,4310017,4310017,122576826,118266809,118266809,4484871,113781938,24,0
123302355,1945,16,4367266,4367266,123302355,118935089,118935089,2803548,116131541,19,0
123733688,9,8,837888,837888,123733688,122895800,122895800,5540214,117355586,25,0
124056339,16,8,896743,896743,124056339,123159596,123159596,5515923,117643673,22,0
124509795,36,8,956090,956090,124509795,123553705,123553705,5239798,118313907,13,0
124735418,28,8,930880,930880,124735418,123804538,123804538,5751923,118052615,18,0
124963728,46,4,991717,991717,124963728,123972011,123972011,11093523,112878488,29,0
125200568,1492,1,3615154,3615154,125200568,121585414,121585414,36070796,85514618,94,0
125337116,7,8,671239,671239,125337116,124665877,124665877,7090786,117575091,16,0
125551110,12,1,880145,880145,125551110,124670965,124670965,40594521,84076444,113,0
126077649,27,8,930730,930730,126077649,125146919,125146919,7248545,117898374,22,0
126797464,23,16,926406,926406,126797464,125871058,125871058,6129666,119741392,19,0
128913584,35,16,953317,953317,128913584,127960267,127960267,6716379,121243888,22,0
129158283,75,8,1042649,1042649,129158283,128115634,128115634,8601957,119513677,22,0
129942218,169,8,1181272,1181272,129942218,128760946,128760946,5786883,122974063,22,0
130200968,78,8,1062049,1062049,130200968,129138919,129138919,9153220,119985699,23,0
132203634,370,1,1685912,1685912,132203634,130517722,130517722,47509853,83007869,95,0
132656570,29,8,931137,931137,132656570,131725433,131725433,13672446,118052987,17,0
133779188,34,16,953266,953266,133779188,132825922,132825922,11771799,121054123,21,0
133901145,115,8,1101445,1101445,133901145,132799700,132799700,9989726,122809974,18,0
133949092,383,1,1690695,1690695,133949092,132258397,132258397,45017924,87240473,82,0
134340116,209,8,1273245,1273245,134340116,133066871,133066871,5286628,127780243,23,0
134895950,94,4,1092167,1092167,134895950,133803783,133803783,18024017,115779766,36,0
135258549,218,4,1284590,1284590,135258549,133973959,133973959,13614231,120359728,46,0
136945200,173,8,1207706,1207706,136945200,135737494,135737494,12758811,122978683,29,0
138244570,26,8,930392,930392,138244570,137314178,137314178,19708155,117606023,19,0
138337555,67,8,1025721,1025721,138337555,137311834,137311834,18271586,119040248,18,0
138375434,527,1,1936564,1936564,138375434,136438870,136438870,43059715,93379155,102,0
139076856,264,8,1501448,1501448,139076856,137575408,137575408,5607210,131968198,24,0
140327892,230,8,1339183,1339183,140327892,138988709,138988709,10795751,128192958,20,0
142603517,273,8,1550718,1550718,142603517,141052799,141052799,9000367,132052432,26,0
142712385,179,8,1240489,1240489,142712385,141471896,141471896,17513699,123958197,25,0
142723211,1186,1,3193463,3193463,142723211,139529748,139529748,42322463,97207285,101,0
145018416,249,8,1409023,1409023,145018416,143609393,143609393,14950628,128658765,26,0
145487086,418,1,1690891,1690891,145487086,143796195,143796195,51556152,92240043,87,0
145526912,486,16,1811759,1811759,145526912,143715153,143715153,5410354,138304799,16,0
146108387,522,4,1930098,1930098,146108387,144178289,144178289,10323533,133854756,41,0
146288988,31,8,938339,938339,146288988,145350649,145350649,27466505,117884144,17,0
149748162,355,8,1619883,1619883,149748162,148128279,148128279,14208845,133919434,20,0
149905933,512,16,1879956,1879956,149905933,148025977,148025977,7153512,140872465,15,0
150715800,229,8,1336414,1336414,150715800,149379386,149379386,21622689,127756697,26,0
150733316,84,8,1071580,1071580,150733316,149661736,149661736,28978763,120682973,27,0
151703425,473,1,1713480,1713480,151703425,149989945,149989945,55702697,94287248,91,0
152496466,207,8,1271714,1271714,152496466,151224752,151224752,24567830,126656922,27,0
152681581,1203,1,3193544,3193544,152681581,149488037,149488037,38211167,111276870,100,0
152834325,1198,1,3193517,3193517,152834325,149640808,149640808,42079141,107561667,101,0
153036055,586,8,2007701,2007701,153036055,151028354,151028354,7091188,143937166,25,0
153051203,618,8,2013228,2013228,153051203,151037975,151037975,4766307,146271668,27,0
153888389,616,2,2008509,2008509,153888389,151879880,151879880,31800659,120079221,78,0
154600808,566,8,1980210,1980210,154600808,152620598,152620598,9528670,143091928,21,0
155499149,518,8,1895143,1895143,155499149,153604006,153604006,15630351,137973655,17,0
156198724,639,8,2153614,2153614,156198724,154045110,154045110,7057807,146987303,26,0
164488479,519,16,1918310,1918310,164488479,162570169,162570169,17491737,145078432,12,0
168647948,606,8,2008272,2008272,168647948,166639676,166639676,22755184,143884492,26,0
169357653,667,16,2218836,2218836,169357653,167138817,167138817,3341120,163797697,17,0
170427479,3,8,476285,476285,170427479,169951194,169951194,52322471,117628723,13,0
170588581,1209,1,3193568,3193568,170588581,167395013,167395013,56081342,111313671,105,0
171788789,10,1,880076,880076,171788789,170908713,170908713,87572377,83336336,86,0
173419893,192,8,1251444,1251444,173419893,172168449,172168449,47986641,124181808,31,0
174426403,706,16,2310327,2310327,174426403,172116076,172116076,3716623,168399453,16,0
174480030,696,8,2297936,2297936,174480030,172182094,172182094,10108519,162073575,35,0
174890728,642,8,2157440,2157440,174890728,172733288,172733288,24217928,148515360,24,0
175581015,714,8,2319610,2319610,175581015,173261405,173261405,9152429,164108976,25,0
176776562,654,8,2191212,2191212,176776562,174585350,174585350,17109011,157476339,26,0
177673073,628,8,2150028,2150028,177673073,175523045,175523045,29449220,146073825,25,0
177916443,737,8,2374026,2374026,177916443,175542417,175542417,7838659,167703758,31,0
180390933,728,8,2344821,2344821,180390933,178046112,178046112,10802071,167244041,25,0
184826782,120,8,1114093,1114093,184826782,183712689,183712689,60897837,122814852,25,0
186004741,528,4,1941972,1941972,186004741,184062769,184062769,49473880,134588889,37,0
186786941,789,8,2480826,2480826,186786941,184306115,184306115,6729934,177576181,26,0
187404994,1219,1,3193604,3193604,187404994,184211390,184211390,56072167,128139223,113,0
189458145,717,8,2322912,2322912,189458145,187135233,187135233,20007446,167127787,26,0
189484002,857,8,2705699,2705699,189484002,186778303,186778303,5153296,181625007,26,0
191383589,1228,1,3193644,3193644,191383589,188189945,188189945,42151792,146038153,95,0
192162171,750,8,2404645,2404645,192162171,189757526,189757526,19542447,170215079,23,0
193987829,687,8,2252454,2252454,193987829,191735375,191735375,33761713,157973662,28,0
194055363,882,8,2739712,2739712,194055363,191315651,191315651,9396419,181919232,25,0
194379951,747,8,2403373,2403373,194379951,191976578,191976578,22501211,169475367,24,0
195360585,900,8,2758515,2758515,195360585,192602070,192602070,8305838,184296232,20,0
195836982,972,16,2836299,2836299,195836982,193000683,193000683,3074336,189926347,22,0
196036576,924,8,2795275,2795275,196036576,193241301,193241301,7250277,185991024,25,0
197831100,412,1,1690875,1690875,197831100,196140225,196140225,105310177,90830048,87,0
197920800,795,8,2483315,2483315,197920800,195437485,195437485,16212602,179224883,28,0
198714678,984,4,2842353,2842353,198714678,195872325,195872325,13689014,182183311,38,0
198932076,939,8,2807374,2807374,198932076,196124702,196124702,9935978,186188724,30,0
199060140,778,8,2454643,2454643,199060140,196605497,196605497,26198837,170406660,29,0
201793210,1062,8,2995996,2995996,201793210,198797214,198797214,8647793,190149421,24,0
203722736,991,8,2867960,2867960,203722736,200854776,200854776,12959502,187895274,25,0
203760922,1076,8,3013225,3013225,203760922,200747697,200747697,6712617,194035080,24,0
207104050,1100,8,3053489,3053489,207104050,204050561,204050561,8171638,195878923,32,0
208203272,1144,7,3088486,3088486,208203272,205114786,205114786,14905765,190209021,34,0
208662993,745,8,2388060,2388060,208662993,206274933,206274933,37817228,168457705,29,0
209381525,1257,4,3310362,3310362,209381525,206071163,206071163,12934118,193137045,46,0
210639731,1075,8,3005983,3005983,210639731,207633748,207633748,16373588,191260160,30,0
212859844,785,8,2472181,2472181,212859844,210387663,210387663,37237479,173150184,21,0
213042321,646,8,2170440,2170440,213042321,210871881,210871881,61850665,149021216,26,0
213885980,559,8,1978795,1978795,213885980,211907185,211907185,72269772,139637413,21,0
213903028,1166,16,3157915,3157915,213903028,210745113,210745113,3359496,207385617,19,0
216021680,1245,8,3252017,3252017,216021680,212769663,212769663,10062508,202707155,32,0
216055377,498,1,1860323,1860323,216055377,214195054,214195054,119701010,94494044,104,0
221560530,955,4,2814649,2814649,221560530,218745881,218745881,46858909,171886972,56,0
222731584,1252,8,3273178,3273178,222731584,219458406,219458406,14587626,204870780,22,0
223494873,282,8,1587573,1587573,223494873,221907300,221907300,89227976,132679324,26,0
225183866,1085,8,3019184,3019184,225183866,222164682,222164682,26208027,195956655,23,0
225472018,1353,8,3406034,3406034,225472018,222065984,222065984,7882683,214183301,26,0
225718096,6,8,627951,627951,225718096,225090145,225090145,107500942,117589203,14,0
226712730,1071,8,3005048,3005048,226712730,223707682,223707682,32614787,191092895,23,0
226790637,1157,8,3114770,3114770,226790637,223675867,223675867,21207596,202468271,26,0
226947346,641,8,2156743,2156743,226947346,224790603,224790603,77171107,147619496,35,0
227830603,1008,4,2890017,2890017,227830603,224940586,224940586,42515479,182425107,42,0
228460971,1232,1,3193659,3193659,228460971,225267312,225267312,65756326,159510986,102,0
228669194,5,8,600049,600049,228669194,228069145,228069145,110577404,117491741,17,0
231271810,1038,8,2964423,2964423,231271810,228307387,228307387,40011886,188295501,20,0
232003564,1429,8,3508975,3508975,232003564,228494589,228494589,5916935,222577654,29,0
232016218,1480,1,3599672,3599672,232016218,228416546,228416546,62400104,166016442,92,0
233830941,1400,8,3449080,3449080,233830941,230381861,230381861,10528217,219853644,28,0
234659641,1444,8,3518099,3518099,234659641,231141542,231141542,6018461,225123081,28,0
235035940,1339,8,3371496,3371496,235035940,231664444,231664444,20554493,211109951,26,0
235546731,1151,8,3107807,3107807,235546731,232438924,232438924,31805727,200633197,25,0
235872245,1470,8,3571448,3571448,235872245,232300797,232300797,6055180,226245617,18,0
236744089,1384,16,3443613,3443613,236744089,233300476,233300476,15165648,218134828,20,0
237067814,1489,8,3605180,3605180,237067814,233462634,233462634,5440101,228022533,26,0
239406976,1305,16,3362331,3362331,239406976,236044645,236044645,22442605,213602040,25,0
245403463,1174,8,3168827,3168827,245403463,242234636,242234636,39743062,202491574,30,0
246053996,1484,16,3603092,3603092,246053996,242450904,242450904,12940376,229510528,15,0
246556777,1549,16,3673785,3673785,246556777,242882992,242882992,3570536,239312456,16,0
246722236,1551,8,3688899,3688899,246722236,243033337,243033337,11524187,231509150,19,0
252754133,1560,8,3695009,3695009,252754133,249059124,249059124,10851509,238207615,16,0
255128544,1774,4,4090632,4090632,255128544,251037912,251037912,12401702,238636210,32,0
255528865,1374,16,3428655,3428655,255528865,252100210,252100210,35175517,216924693,13,0
257903611,1572,4,3706242,3706242,257903611,254197369,254197369,15216315,238981054,34,0
258105815,1600,8,3764205,3764205,258105815,254341610,254341610,7347677,246993933,22,0
259755052,250,8,1422864,1422864,259755052,258332188,258332188,127617186,130715002,17,0
260279464,1553,16,3691977,3691977,260279464,256587487,256587487,16242419,240345068,25,0
262510039,1467,8,3563716,3563716,262510039,258946323,258946323,32629400,226316923,28,0
264891537,1602,8,3764385,3764385,264891537,261127152,261127152,11554928,249572224,24,0
265743702,1601,8,3764312,3764312,265743702,261979390,261979390,12624474,249354916,37,0
266016895,1657,8,3845179,3845179,266016895,262171716,262171716,5461521,256710195,22,0
266477577,1681,8,3947752,3947752,266477577,262529825,262529825,5634503,256895322,22,0
268361695,1238,8,3195047,3195047,268361695,265166648,265166648,62369582,202797066,29,0
269488286,1720,8,3975440,3975440,269488286,265512846,265512846,7914260,257598586,15,0
269727289,1747,8,4036359,4036359,269727289,265690930,265690930,5189906,260501024,23,0
270083365,1632,1,3797231,3797231,270083365,266286134,266286134,82524932,183761202,74,0
271035039,1529,8,3623818,3623818,271035039,267411221,267411221,38733087,228678134,18,0
272367802,1723,8,3997704,3997704,272367802,268370098,268370098,9219458,259150640,24,0
272911599,1608,8,3771100,3771100,272911599,269140499,269140499,17987779,251152720,25,0
272945646,1619,8,3790445,3790445,272945646,269155201,269155201,15792875,253362326,37,0
273268503,1440,8,3517295,3517295,273268503,269751208,269751208,46459313,223291895,28,0
273907354,1381,8,3440492,3440492,273907354,270466862,270466862,54599706,215867156,22,0
275139437,1511,1,3619305,3619305,275139437,271520132,271520132,93064239,178455893,84,0
276004556,1817,4,4179419,4179419,276004556,271825137,271825137,12483241,259341896,36,0
279921039,1607,8,3770918,3770918,279921039,276150121,276150121,24968019,251182102,28,0
279953461,1785,4,4107881,4107881,279953461,275845580,275845580,19494751,256350829,34,0
280544898,1606,8,3770850,3770850,280544898,276774048,276774048,26122749,250651299,25,0
280785799,1789,16,4120729,4120729,280785799,276665070,276665070,3281741,273383329,15,0
281501923,1813,8,4169731,4169731,281501923,277332192,277332192,12768157,264564035,19,0
282805561,1115,8,3059922,3059922,282805561,279745639,279745639,80683740,199061899,36,0
283333772,1825,8,4194251,4194251,283333772,279139521,279139521,7992061,271147460,23,0
285183328,1485,4,3603227,3603227,285183328,281580101,281580101,72398779,209181322,43,0
287516876,1855,8,4245400,4245400,287516876,283271476,283271476,9738715,273532761,21,0
293728077,1778,8,4095052,4095052,293728077,289633025,289633025,27529624,262103401,26,0
294446320,1836,8,4214464,4214464,294446320,290231856,290231856,18572895,271658961,18,0
295705875,1876,8,4288803,4288803,295705875,291417072,291417072,6693789,284723283,20,0
299799909,1913,1,4312491,4312491,299799909,295487418,295487418,62625954,232861464,63,0
300021722,1754,16,4044551,4044551,300021722,295977171,295977171,29877366,266099805,20,0
305141055,1826,8,4194650,4194650,305141055,300946405,300946405,29413503,271532902,20,0
305159464,1861,8,4259695,4259695,305159464,300899769,300899769,16188569,284711200,26,0
306601913,1851,8,4229135,4229135,306601913,302372778,302372778,30359455,272013323,21,0
306706640,1753,16,4043556,4043556,306706640,302663084,302663084,38727546,263935538,18,0
312788275,1877,8,4289489,4289489,312788275,308498786,308498786,22273706,286225080,30,0
315183861,1645,8,3821570,3821570,315183861,311362291,311362291,55480088,255882203,20,0
315191463,1856,8,4248721,4248721,315191463,310942742,310942742,36619310,274323432,20,0
315226504,1961,8,4417173,4417173,315226504,310809331,310809331,8816635,301992696,25,0
316321256,1923,8,4336958,4336958,316321256,311984298,311984298,16118047,295866251,26,0
322127974,1598,8,3763948,3763948,322127974,318364026,318364026,71387803,246976223,29,0
322357028,1965,8,4421903,4421903,322357028,317935125,317935125,12193835,305741290,29,0
322885911,1899,32,4307901,4307901,322885911,318578010,318578010,17816468,300761542,19,0
324204384,1988,8,4487069,4487069,324204384,319717315,319717315,12780219,306937096,19,0
325221915,1528,8,3623665,3623665,325221915,321598250,321598250,93266754,228331496,25,0
335883780,1911,1,4312249,4312249,335883780,331571531,331571531,110295630,221275901,75,0
335983984,1915,1,4312850,4312850,335983984,331671134,331671134,93775074,237896060,58,0
344064354,1864,16,4260900,4260900,344064354,339803454,339803454,46423806,293379648,9,0
349325330,1860,8,4259669,4259669,349325330,345065661,345065661,66570238,278495423,22,0
353391752,1536,8,3628889,3628889,353391752,349762863,349762863,118994960,230767903,24,0
371677697,1982,8,4480780,4480780,371677697,367196917,367196917,61363173,305833744,24,0
390223808,1552,8,3691049,3691049,390223808,386532759,386532759,149053367,237479392,18,0
403286894,1975,8,4443663,4443663,403286894,398843231,398843231,92937712,305905519,20,0
544954427,1358,1,3411993,3411993,544954427,541542434,541542434,375733463,165808971,102,0
566901478,1222,1,3193617,3193617,566901478,563707861,563707861,424979556,138728305,101,0
