time,job_id,num_gpu,submit_time,start_time,end_time,executed_time,JCT,duration,pending_time,preempt,promote
10006,1,1,6,6,10006,10000,10000,10000,0,0,0
27794,2,1,6,6,27794,27788,27788,27788,0,0,0
47452,4,1,10,10,47452,47442,47442,47442,0,0,0
50932,24,1,44506,44506,50932,6426,6426,6426,0,0,0
71728,8,1,17,17,71728,71711,71711,71711,0,0,0
88003,18,1,44488,44488,88003,43515,43515,43515,0,0,0
95121,0,1,0,0,95121,95121,95121,95121,0,1,0
96445,7,1,14,14,96445,96431,96431,96431,0,0,0
138519,11,1,22,22,138519,138497,138497,138497,0,0,0
164380,13,1,26,26,164380,164354,164354,164354,0,0,0
205786,27,1,44508,44508,205786,161278,161278,161278,0,0,0
214591,9,1,18,18,214591,214573,214573,214573,0,0,0
227498,32,1,225010,225010,227498,2488,2488,2488,0,0,0
233159,30,1,224999,224999,233159,8160,8160,8160,0,0,0
249917,22,1,44500,44500,249917,205417,205417,205417,0,0,0
283022,15,1,30,30,283022,282992,282992,282992,0,0,0
329579,33,1,225012,225012,329579,104567,104567,104567,0,0,0
365796,41,4,291313,291313,365796,74483,74483,74483,0,0,0
398384,28,1,224994,224994,398384,173390,173390,173390,0,0,0
399086,25,1,44507,44507,399086,354579,354579,354579,0,0,0
399377,21,1,44498,44498,399377,354879,354879,354879,0,0,0
603106,53,4,510191,510191,603106,92915,92915,92915,0,0,0
621381,38,4,291295,291295,621381,330086,330086,330086,0,0,0
687598,58,4,632338,632338,687598,55260,55260,55260,0,0,0
696856,57,4,632336,632336,696856,64520,64520,64520,0,0,0
712420,55,4,632320,632320,712420,80100,80100,80100,0,0,0
864042,63,2,719754,719754,864042,144288,144288,144288,0,0,0
867080,86,4,810604,810619,867080,56461,56476,56461,15,0,0
970520,16,1,44477,44477,970520,926043,926043,926043,0,0,0
984696,117,2,961023,961023,984696,23673,23673,23673,0,0,0
991611,174,2,961222,961222,991611,30389,30389,30389,0,0,0
999359,124,2,961048,961048,999359,38311,38311,38311,0,0,0
1002479,151,2,961143,961143,1002479,41336,41336,41336,0,0,0
1006279,195,2,961295,961295,1006279,44984,44984,44984,0,0,0
1012266,181,2,961246,961246,1012266,51020,51020,51020,0,0,0
1013464,47,4,343925,343925,1013464,669539,669539,669539,0,0,0
1015365,177,2,961233,961287,1015365,54078,54132,54078,54,0,0
1016891,126,2,961055,961062,1016891,55829,55836,55829,7,0,0
1018751,202,2,961318,961318,1018751,57433,57433,57433,0,0,0
1019046,170,2,961208,961208,1019046,57838,57838,57838,0,0,0
1022086,199,2,961308,961308,1022086,60778,60778,60778,0,0,0
1027060,64,2,719767,719767,1027060,307293,307293,307293,0,0,0
1030754,122,2,961041,961041,1030754,69713,69713,69713,0,0,0
1033257,212,2,961361,961361,1033257,71896,71896,71896,0,0,0
1044154,141,2,961106,961106,1044154,83048,83048,83048,0,0,0
1048758,62,2,719748,719748,1048758,329010,329010,329010,0,0,0
1049861,65,2,719816,719816,1049861,330045,330045,330045,0,0,0
1064984,66,2,719849,719849,1064984,345135,345135,345135,0,0,0
1066313,133,2,961078,961078,1066313,105235,105235,105235,0,0,0
1072947,156,2,961160,961160,1072947,111787,111787,111787,0,0,0
1084511,159,2,961171,961174,1084511,123337,123340,123337,3,0,0
1090899,111,2,961001,961001,1090899,129898,129898,129898,0,0,0
1103498,23,1,44500,44500,1103498,1058998,1058998,1058998,0,0,0
1104681,3,1,6,6,1104681,1104675,1104675,1104675,0,1,0
1121471,142,2,961109,961109,1121471,160362,160362,160362,0,0,0
1140848,34,1,225015,225015,1140848,915833,915833,915833,0,0,0
1194062,168,2,961201,961201,1194062,232861,232861,232861,0,0,0
1197799,12,1,25,25,1197799,1197774,1197774,1197774,0,0,0
1241879,54,4,510211,510211,1241879,731668,731668,731668,0,0,0
1249597,135,2,961086,961086,1249597,288511,288511,288511,0,0,0
1270183,17,1,44477,44477,1270183,1225706,1225706,1225706,0,0,0
1321597,56,4,632320,632320,1321597,689277,689277,689277,0,0,0
1354721,35,1,225016,225016,1354721,1129705,1129705,1129705,0,0,0
1370455,116,2,961019,961019,1370455,409436,409436,409436,0,0,0
1413576,140,2,961102,961102,1413576,452474,452474,452474,0,0,0
1419824,49,4,343982,343982,1419824,1075842,1075842,1075842,0,0,0
1448552,171,2,961211,961222,1448552,487330,487341,487330,11,0,0
1470560,157,2,961164,961181,1470560,509379,509396,509379,17,0,0
1491022,165,2,961191,961201,1491022,529821,529831,529821,10,0,0
1513741,144,2,961118,961150,1513741,552591,552623,552591,32,0,0
1535095,92,4,810997,867080,1535095,668015,724098,668015,56083,0,0
1574674,205,2,961332,961332,1574674,613342,613342,613342,0,0,0
1631892,130,2,961069,961069,1631892,670823,670823,670823,0,0,0
1635696,118,2,961026,961026,1635696,674670,674670,674670,0,0,0
1657823,169,2,961204,961290,1657823,696533,696619,696533,86,0,0
1762890,112,2,961004,961004,1762890,801886,801886,801886,0,0,0
1786147,247,2,1743130,1743130,1786147,43017,43017,43017,0,0,0
1796723,128,2,961062,961069,1796723,835654,835661,835654,7,0,0
1799376,193,2,961287,961305,1799376,838071,838089,838071,18,0,0
1807549,154,2,961153,961185,1807549,846364,846396,846364,32,0,0
1809282,233,2,1743072,1743072,1809282,66210,66210,66210,0,0,0
1816253,251,2,1743145,1743145,1816253,73108,73108,73108,0,0,0
1820420,238,2,1743092,1743092,1820420,77328,77328,77328,0,0,0
1820651,259,2,1743194,1743194,1820651,77457,77457,77457,0,0,0
1820655,232,2,1743067,1743067,1820655,77588,77588,77588,0,0,0
1854061,291,1,1837969,1837969,1854061,16092,16092,16092,0,0,0
1855451,301,1,1838064,1838064,1855451,17387,17387,17387,0,0,0
1855926,283,1,1837887,1837887,1855926,18039,18039,18039,0,0,0
1860644,382,1,1838943,1838943,1860644,21701,21701,21701,0,0,0
1860927,384,1,1838962,1838962,1860927,21965,21965,21965,0,0,0
1864015,305,1,1838105,1838105,1864015,25910,25910,25910,0,0,0
1867203,296,1,1838014,1838014,1867203,29189,29189,29189,0,0,0
1868904,304,1,1838090,1838090,1868904,30814,30814,30814,0,0,0
1870497,347,1,1838569,1838569,1870497,31928,31928,31928,0,0,0
1871302,286,1,1837922,1837922,1871302,33380,33380,33380,0,0,0
1872288,275,2,1829695,1829695,1872288,42593,42593,42593,0,0,0
1873852,314,1,1838201,1838201,1873852,35651,35651,35651,0,0,0
1874248,315,1,1838219,1838219,1874248,36029,36029,36029,0,0,0
1875023,363,1,1838723,1838723,1875023,36300,36300,36300,0,0,0
1875633,289,1,1837949,1837949,1875633,37684,37684,37684,0,0,0
1876006,321,1,1838276,1838276,1876006,37730,37730,37730,0,0,0
1876194,310,1,1838151,1838151,1876194,38043,38043,38043,0,0,0
1876194,353,1,1838628,1838628,1876194,37566,37566,37566,0,0,0
1878340,328,1,1838357,1838357,1878340,39983,39983,39983,0,0,0
1879048,341,1,1838500,1838500,1879048,40548,40548,40548,0,0,0
1883217,60,2,719728,719728,1883217,1163489,1163489,1163489,0,0,0
1883716,252,2,1743149,1743149,1883716,140567,140567,140567,0,0,0
1890591,256,2,1743175,1743175,1890591,147416,147416,147416,0,0,0
1892595,356,1,1838662,1838662,1892595,53933,53933,53933,0,0,0
1894206,394,1,1892950,1892950,1894206,1256,1256,1256,0,0,0
1896000,76,4,810492,810492,1896000,1085508,1085508,1085508,0,0,0
1901832,395,1,1893036,1893036,1901832,8796,8796,8796,0,0,0
1905106,385,1,1838970,1838970,1905106,66136,66136,66136,0,0,0
1905375,354,1,1838637,1838637,1905375,66738,66738,66738,0,0,0
1908941,407,2,1900833,1900934,1908941,8007,8108,8007,101,0,0
1909136,343,1,1838535,1838535,1909136,70601,70601,70601,0,0,0
1911129,313,1,1838185,1838185,1911129,72944,72944,72944,0,0,0
1916043,19,1,44488,44488,1916043,1871555,1871555,1871555,0,0,0
1916335,307,1,1838123,1838123,1916335,78212,78212,78212,0,0,0
1918886,372,1,1838835,1838835,1918886,80051,80051,80051,0,0,0
1919591,406,2,1900806,1901098,1919591,18493,18785,18493,292,0,0
1925802,290,1,1837957,1837957,1925802,87845,87845,87845,0,0,0
1926848,198,2,961305,961308,1926848,965540,965543,965540,3,0,0
1931796,409,2,1901098,1905375,1931796,26421,30698,26421,4277,0,0
1940242,367,1,1838759,1838759,1940242,101483,101483,101483,0,0,0
1947567,398,2,1900661,1908941,1947567,38626,46906,38626,8280,0,0
1948275,266,2,1829632,1829632,1948275,118643,118643,118643,0,0,0
1950301,338,1,1838474,1838474,1950301,111827,111827,111827,0,0,0
1955108,401,2,1900676,1909136,1955108,45972,54432,45972,8460,0,0
1965951,404,2,1900755,1916335,1965951,49616,65196,49616,15580,0,0
1970265,402,2,1900719,1919591,1970265,50674,69546,50674,18872,0,0
1974435,312,1,1838174,1838174,1974435,136261,136261,136261,0,0,0
1997260,210,2,961349,984696,1997260,1012564,1035911,1012564,23347,0,0
2013933,223,4,1730216,1838005,2013933,175928,283717,175928,107789,0,0
2016758,246,2,1743125,1743125,2016758,273633,273633,273633,0,0,0
2022001,235,2,1743079,1743079,2022001,278922,278922,278922,0,0,0
2023504,413,1,1986341,1986341,2023504,37163,37163,37163,0,0,0
2027217,380,1,1838925,1838925,2027217,188292,188292,188292,0,0,0
2033389,348,1,1838585,1838585,2033389,194804,194804,194804,0,0,0
2042475,89,4,810916,810916,2042475,1231559,1231559,1231559,0,0,0
2044039,272,2,1829675,1829675,2044039,214364,214364,214364,0,0,0
2056955,263,2,1743219,1743219,2056955,313736,313736,313736,0,0,0
2065959,392,1,1892825,1892825,2065959,173134,173134,173134,0,0,0
2081955,300,1,1838055,1838055,2081955,243900,243900,243900,0,0,0
2090834,269,2,1829653,1829653,2090834,261181,261181,261181,0,0,0
2095477,200,2,961312,961332,2095477,1134145,1134165,1134145,20,0,0
2115393,303,1,1838081,1838081,2115393,277312,277312,277312,0,0,0
2115818,410,4,1911117,2013933,2115818,101885,204701,101885,102816,0,0
2118038,451,4,2059042,2095477,2118038,22561,58996,22561,36435,0,0
2119892,299,1,1838046,1838046,2119892,281846,281846,281846,0,0,0
2129963,208,2,961343,991611,2129963,1138352,1168620,1138352,30268,0,0
2135219,309,1,1838141,1838141,2135219,297078,297078,297078,0,0,0
2139711,320,1,1838268,1838268,2139711,301443,301443,301443,0,0,0
2154587,83,4,810564,810573,2154587,1344014,1344023,1344014,9,0,0
2155955,426,4,2058866,2115818,2155955,40137,97089,40137,56952,0,0
2163556,445,4,2058992,2118038,2163556,45518,104564,45518,59046,0,0
2176386,288,1,1837940,1837940,2176386,338446,338446,338446,0,0,0
2180224,336,1,1838448,1838448,2180224,341776,341776,341776,0,0,0
2181135,393,1,1892933,1892933,2181135,288202,288202,288202,0,0,0
2190243,125,2,961051,961051,2190243,1229192,1229192,1229192,0,0,0
2207500,265,2,1829629,1829629,2207500,377871,377871,377871,0,0,0
2212399,457,4,2059102,2119892,2212399,92507,153297,92507,60790,0,0
2215891,399,2,1900666,1926848,2215891,289043,315225,289043,26182,0,0
2243685,162,2,961181,961185,2243685,1282500,1282504,1244502,38002,1,0
2245284,484,4,2230255,2230277,2245284,15007,15029,15007,22,0,0
2245441,480,4,2230241,2230343,2245441,15098,15200,15098,102,0,0
2248618,375,1,1838866,1838866,2248618,409752,409752,409752,0,0,0
2251357,160,2,961174,1002479,2251357,1248878,1290183,1248878,41305,0,0
2264613,477,4,2230229,2243685,2264613,20928,34384,20928,13456,0,0
2271059,470,4,2230205,2245284,2271059,25775,40854,25775,15079,0,0
2272235,91,4,810994,810994,2272235,1461241,1461241,1409109,52132,1,0
2272457,513,4,2230381,2245284,2272457,27173,42076,27173,14903,0,0
2273827,476,4,2230226,2245441,2273827,28386,43601,28386,15215,0,0
2279100,302,1,1838073,1838073,2279100,441027,441027,441027,0,0,0
2299190,100,2,960960,960960,2299190,1338230,1338230,1293269,44961,1,0
2302428,415,4,2058785,2154587,2302428,147841,243643,147841,95802,0,0
2311615,366,1,1838750,1838750,2311615,472865,472865,472865,0,0,0
2315139,421,4,2058830,2155955,2315139,159184,256309,159184,97125,0,0
2325380,505,4,2230346,2251357,2325380,74023,95034,74023,21011,0,0
2326242,389,1,1839011,1839011,2326242,487231,487231,487231,0,0,0
2342392,472,4,2230212,2264613,2342392,77779,112180,77779,34401,0,0
2343445,137,2,961092,961092,2343445,1382353,1382353,1331392,50961,1,0
2345245,411,4,1911136,2042475,2345245,302770,434109,302770,131339,0,0
2348452,455,4,2059079,2163556,2348452,184896,289373,184896,104477,0,0
2361645,490,4,2230277,2271059,2361645,90586,131368,90586,40782,0,0
2374440,295,1,1838005,1838005,2374440,536435,536435,536435,0,0,0
2380356,525,4,2230435,2272235,2380356,108121,149921,108121,41800,0,0
2381854,45,4,343918,343918,2381854,2037936,2037936,1934260,103676,1,0
2385748,334,1,1838416,1838416,2385748,547332,547332,547332,0,0,0
2388110,5,1,11,11,2388110,2388099,2388099,2388099,0,26,0
2389570,323,1,1838303,1838303,2389570,551267,551267,551267,0,0,0
2392637,337,1,1838466,1838466,2392637,554171,554171,554171,0,0,0
2403324,14,1,29,29,2403324,2403295,2403295,2403295,0,28,0
2411241,146,2,961125,961150,2411241,1450091,1450116,1396021,54095,1,0
2421560,29,1,224997,224997,2421560,2196563,2196563,2187333,9230,11,0
2426600,520,4,2230413,2272457,2426600,154143,196187,154143,42044,0,0
2428043,504,4,2230343,2273827,2428043,154216,197700,154216,43484,0,0
2437665,414,4,2058781,2212399,2437665,225266,378884,225266,153618,0,0
2449626,532,4,2394731,2426600,2449626,23026,54895,23026,31869,0,0
2460787,297,1,1838022,1838022,2460787,622765,622765,622765,0,0,0
2461400,318,1,1838250,1838250,2461400,623150,623150,623150,0,0,0
2466032,551,4,2394804,2428043,2466032,37989,71228,37989,33239,0,0
2471981,226,2,1743040,1743040,2471981,728941,728941,728941,0,0,0
2487071,215,4,1730160,1838038,2487071,649033,756911,649033,107878,0,0
2497161,364,1,1838732,1838732,2497161,658429,658429,658429,0,0,0
2497645,351,1,1838611,1838611,2497645,659034,659034,659034,0,0,0
2505998,511,4,2230371,2299190,2505998,206808,275627,206808,68819,0,0
2512100,346,1,1838560,1838560,2512100,673540,673540,673540,0,0,0
2526224,483,4,2230252,2302428,2526224,223796,295972,223796,72176,0,0
2538304,97,2,960948,960948,2538304,1577356,1577356,1499754,77602,3,0
2540332,464,4,2230184,2315139,2540332,225193,310148,225193,84955,0,0
2561747,227,2,1743044,1743044,2561747,818703,818703,790443,28260,1,0
2564881,552,4,2394808,2437665,2564881,127216,170073,127216,42857,0,0
2565419,287,1,1837931,1837931,2565419,727488,727488,712381,15107,15,0
2570407,237,2,1743086,1743086,2570407,827321,827321,793899,33422,1,0
2570748,510,4,2230367,2325380,2570748,245368,340381,245368,95013,0,0
2591586,491,4,2230280,2342392,2591586,249194,361306,249194,112112,0,0
2596723,280,2,1829720,1829720,2596723,767003,767003,730120,36883,1,0
2599565,496,4,2230304,2343445,2599565,256120,369261,256120,113141,0,0
2608291,482,4,2230248,2345245,2608291,263046,378043,263046,114997,0,0
2615614,186,2,961263,1018751,2615614,1596863,1654351,1552369,101982,2,0
2624197,424,4,2058855,2348452,2624197,275745,565342,275745,289597,0,0
2639523,298,1,1838038,1838038,2639523,801485,801485,784679,16806,16,0
2645513,273,2,1829683,1829683,2645513,815830,815830,770751,45079,1,0
2645599,529,4,2394720,2449626,2645599,195973,250879,195973,54906,0,0
2652605,153,2,961150,1019046,2652605,1633559,1691455,1581579,109876,3,0
2659200,408,2,1900934,1931796,2659200,727404,758266,727404,30862,0,0
2663837,349,1,1838594,1855926,2663837,807911,825243,807911,17332,9,0
2675825,360,1,1838697,1860644,2675825,815181,837128,810392,26736,7,0
2695102,530,4,2394724,2466032,2695102,229070,300378,229070,71308,0,0
2730831,333,1,1838407,1838407,2730831,892424,892424,860427,31997,24,0
2736741,523,4,2230424,2361645,2736741,375096,506317,375096,131221,0,0
2743488,540,4,2394763,2487071,2743488,256417,348725,256417,92308,0,0
2753904,225,2,1743036,1743036,2753904,1010868,1010868,906959,103909,4,0
2765339,560,8,2762368,2764860,2765339,479,2971,479,2492,0,0
2766418,556,8,2762351,2765339,2766418,1079,4067,1079,2988,0,0
2767494,258,2,1743190,1743190,2767494,1024304,1024304,919463,104841,11,0
2768429,561,8,2764715,2766418,2768429,2011,3714,2011,1703,0,0
2771180,568,8,2764803,2768429,2771180,2751,6377,2751,3626,0,0
2771248,517,4,2230398,2380356,2771248,390892,540850,390892,149958,0,0
2782044,378,1,1838892,1871302,2782044,910742,943152,910742,32410,39,0
2793766,438,4,2058942,2381854,2793766,411912,734824,411912,322912,0,0
2795826,565,8,2764735,2771180,2795826,24646,31091,24646,6445,0,0
2798468,194,2,961290,1022086,2798468,1776382,1837178,1659740,177438,22,0
2812219,577,8,2788528,2795826,2812219,16393,23691,16393,7298,0,0
2824229,557,8,2762365,2798468,2824229,25761,61864,25761,36103,0,0
2829238,285,1,1837914,1837914,2829238,991324,991324,955811,35513,76,0
2831013,433,4,2058897,2385748,2831013,445265,772116,445265,326851,0,0
2834831,332,1,1838397,1874248,2834831,960583,996434,960583,35851,75,0
2837240,417,4,2058800,2389570,2837240,447670,778440,447670,330770,0,0
2841205,26,1,44508,44508,2841205,2796697,2796697,2690105,106592,114,0
2850193,569,8,2764860,2812219,2850193,37974,85333,37974,47359,0,0
2851878,582,8,2842990,2850193,2851878,1685,8888,1685,7203,0,0
2866308,571,8,2778451,2824229,2866308,42079,87857,42079,45778,0,0
2873869,579,8,2831118,2837240,2873869,36629,42751,36629,6122,0,0
2880327,574,8,2787624,2831013,2880327,49314,92703,49314,43389,0,0
2881345,119,2,961030,961030,2881345,1920315,1920315,1726919,193396,42,0
2881650,583,8,2866521,2873869,2881650,7781,15129,7781,7348,0,0
2890320,268,2,1829649,1829649,2890320,1060671,1060671,928709,131962,52,0
2896091,10,1,21,21,2896091,2896070,2896070,2788612,107458,153,0
2902482,575,8,2787660,2851878,2902482,50604,114822,50604,64218,0,0
2918287,539,4,2394759,2505998,2918287,412289,523528,412289,111239,0,0
2921934,6,1,12,12,2921934,2921922,2921922,2799809,122113,183,0
2940627,578,8,2831097,2866308,2940627,74319,109530,74319,35211,0,0
2944544,541,4,2394767,2526224,2944544,418320,549777,418320,131457,0,0
2966534,581,8,2831155,2880327,2966534,86207,135379,86207,49172,0,0
2967202,59,2,719719,719719,2967202,2247483,2247483,2016359,231124,105,0
2989491,279,2,1829716,1829716,2989491,1159775,1159775,981202,178573,117,0
2992105,489,4,2230273,2540332,2992105,451773,761832,451773,310059,0,0
3007984,386,1,1838980,1878340,3007984,1129644,1169004,1118769,50235,161,0
3027993,515,4,2230391,2564881,3027993,463112,797602,463112,334490,0,0
3030251,837,1,3028125,3028125,3030251,2126,2126,2126,0,0,0
3034261,507,4,2230353,2570407,3034261,463854,803908,463854,340054,0,0
3043301,826,1,3028099,3028099,3043301,15202,15202,15202,0,0,0
3044094,845,1,3028204,3028204,3044094,15890,15890,15890,0,0,0
3049533,846,1,3028215,3028215,3049533,21318,21318,21318,0,0,0
3059021,816,1,3028078,3028078,3059021,30943,30943,30943,0,0,0
3059708,847,1,3028440,3028440,3059708,31268,31268,31268,0,0,0
3063711,809,1,3028064,3028064,3063711,35647,35647,35647,0,0,0
3063765,808,1,3028063,3028063,3063765,35702,35702,35702,0,0,0
3064874,842,1,3028136,3028136,3064874,36738,36738,36738,0,0,0
3072008,812,1,3028070,3028070,3072008,43938,43938,43938,0,0,0
3074088,810,1,3028066,3028066,3074088,46022,46022,46022,0,0,0
3082368,794,1,3028033,3028033,3082368,54335,54335,54335,0,0,0
3082538,741,1,3027899,3027899,3082538,54639,54639,54639,0,0,0
3087414,697,1,3027713,3027713,3087414,59701,59701,59701,0,0,0
3089035,711,1,3027739,3027739,3089035,61296,61296,61296,0,0,0
3089373,692,1,3027697,3027697,3089373,61676,61676,61676,0,0,0
3091452,756,1,3027935,3027935,3091452,63517,63517,63517,0,0,0
3094895,787,1,3028016,3028016,3094895,66879,66879,66879,0,0,0
3100202,782,1,3028004,3028004,3100202,72198,72198,72198,0,0,0
3100413,558,8,2762366,2881650,3100413,218763,338047,218763,119284,0,0
3105068,827,1,3028099,3028099,3105068,76969,76969,76969,0,0,0
3107331,838,1,3028126,3028126,3107331,79205,79205,79205,0,0,0
3110997,834,1,3028117,3028117,3110997,82880,82880,82880,0,0,0
3113530,835,1,3028120,3028120,3113530,85410,85410,85410,0,0,0
3115492,749,1,3027919,3027919,3115492,87573,87573,87573,0,0,0
3121101,848,1,3028452,3028452,3121101,92649,92649,92649,0,0,0
3121294,775,1,3027988,3027988,3121294,93306,93306,93306,0,0,0
3122870,777,1,3027992,3027992,3122870,94878,94878,94878,0,0,0
3124263,713,1,3027778,3027778,3124263,96485,96485,96485,0,0,0
3124710,371,1,1838825,1879048,3124710,1245662,1285885,1220270,65615,176,0
3124839,844,1,3028157,3028157,3124839,96682,96682,96682,0,0,0
3126572,716,1,3027848,3027848,3126572,98724,98724,98724,0,0,0
3129292,759,1,3027943,3027943,3129292,101349,101349,101349,0,0,0
3131453,703,1,3027724,3027724,3131453,103729,103729,103729,0,0,0
3131985,475,4,2230222,2570748,3131985,561237,901763,561237,340526,0,0
3134542,702,1,3027724,3027724,3134542,106818,106818,106818,0,0,0
3138287,564,8,2764726,2890320,3138287,247967,373561,247967,125594,0,0
3138507,831,1,3028112,3028112,3138507,110395,110395,110395,0,0,0
3138606,724,1,3027864,3027864,3138606,110742,110742,110742,0,0,0
3138978,839,1,3028130,3028130,3138978,110848,110848,110848,0,0,0
3140265,736,1,3027887,3027887,3140265,112378,112378,112378,0,0,0
3143160,755,1,3027931,3027931,3143160,115229,115229,115229,0,0,0
3143372,832,1,3028113,3028113,3143372,115259,115259,115259,0,0,0
3145325,685,1,3027673,3027673,3145325,117652,117652,117652,0,0,0
3145762,757,1,3027937,3027937,3145762,117825,117825,117825,0,0,0
3151155,725,1,3027866,3027866,3151155,123289,123289,123289,0,0,0
3152381,576,8,2788525,2902482,3152381,249899,363856,249899,113957,0,0
3155289,534,4,2394738,2591586,3155289,563703,760551,563703,196848,0,0
3158867,843,1,3028139,3028139,3158867,130728,130728,130728,0,0,0
3160402,656,1,3027595,3027595,3160402,132807,132807,132807,0,0,0
3161905,603,1,3027133,3027133,3161905,134772,134772,134772,0,0,0
3164028,715,1,3027819,3027819,3164028,136209,136209,136209,0,0,0
3164682,339,1,1838483,1892595,3164682,1272087,1326199,1239110,87089,178,0
3165982,466,4,2230191,2596723,3165982,569259,935791,569259,366532,0,0
3166422,260,2,1743198,1743198,3166422,1423224,1423224,1239296,183928,175,0
3170134,463,4,2230181,2599565,3170134,570569,939953,570569,369384,0,0
3182276,542,4,2394771,2608291,3182276,573985,787505,573985,213520,0,0
3183470,669,1,3027629,3027629,3183470,155841,155841,155841,0,0,0
3190006,613,1,3027181,3027181,3190006,162825,162825,162825,0,0,0
3193369,708,1,3027735,3027735,3193369,165634,165634,165634,0,0,0
3197279,317,1,1838242,1940242,3197279,1257037,1359037,1257037,102000,192,0
3200892,597,1,3027091,3027091,3200892,173801,173801,173801,0,0,0
3202526,425,4,2058862,2624197,3202526,578329,1143664,578329,565335,0,0
3206697,695,1,3027709,3027709,3206697,178988,178988,178988,0,0,0
3210312,671,1,3027633,3027633,3210312,182679,182679,182679,0,0,0
3221579,830,1,3028108,3028108,3221579,193471,193471,193471,0,0,0
3230474,474,4,2230219,2645599,3230474,584875,1000255,584875,415380,0,0
3235754,567,8,2764786,2940627,3235754,295127,470968,295127,175841,0,0
3260043,617,1,3027237,3027237,3260043,232806,232806,232806,0,0,0
3270766,253,2,1743159,1743159,3270766,1527607,1527607,1318556,209051,186,0
3272565,636,1,3027362,3027362,3272565,245203,245203,245203,0,0,0
3276051,783,1,3028008,3028008,3276051,248043,248043,248043,0,0,0
3285733,781,1,3028003,3028003,3285733,257730,257730,257730,0,0,0
3288567,622,1,3027271,3027271,3288567,261296,261296,259497,1799,1,0
3294692,672,1,3027637,3027637,3294692,267055,267055,261234,5821,1,0
3302705,825,1,3028095,3028095,3302705,274610,274610,268564,6046,1,0
3303367,819,1,3028082,3028082,3303367,275285,275285,269228,6057,1,0
3304935,774,1,3027984,3027984,3304935,276951,276951,270847,6104,1,0
3316425,771,1,3027980,3027980,3316425,288445,288445,273283,15162,1,0
3317407,376,1,1838875,1950301,3317407,1367106,1478532,1340461,138071,185,0
3326410,649,1,3027552,3027552,3326410,298858,298858,277455,21403,1,0
3338409,766,1,3027966,3027966,3338409,310443,310443,279548,30895,1,0
3339276,620,1,3027263,3027263,3339276,312013,312013,280430,31583,1,0
3350527,768,1,3027969,3027969,3350527,322558,322558,286963,35595,4,0
3364927,788,1,3028019,3028019,3364927,336908,336908,301247,35661,5,0
3370198,761,1,3027957,3027957,3370198,342241,342241,305467,36774,3,0
3382031,841,1,3028134,3072008,3382031,310023,353897,310023,43874,1,0
3383393,439,4,2058946,2659200,3383393,724193,1324447,651892,672555,1,0
3396574,638,1,3027369,3027369,3396574,369205,369205,323198,46007,9,0
3421272,822,1,3028090,3082368,3421272,338904,393182,338904,54278,2,0
3427944,660,1,3027602,3027602,3427944,400342,400342,345862,54480,24,0
3451310,555,8,2762344,2966534,3451310,484776,688966,374522,314444,1,0
3452327,531,4,2394727,2695102,3452327,757225,1057600,684768,372832,17,0
3475977,397,2,1900657,2056955,3475977,1419022,1575320,1267837,307483,167,0
3491065,559,8,2762367,2992105,3491065,498960,728698,374522,354176,1,0
3530274,828,1,3028104,3087414,3530274,442860,502170,442860,59310,6,0
3548564,840,1,3028131,3089035,3548564,459529,520433,459529,60904,5,0
3581975,524,4,2230431,2736741,3581975,845234,1351544,730674,620870,8,0
3583731,746,1,3027911,3027911,3583731,555820,555820,491005,64815,36,0
3593966,20,1,44497,44497,3593966,3549469,3549469,3165582,383887,297,0
3604170,800,1,3028045,3105068,3604170,499102,576125,499102,77023,3,0
3668198,815,1,3028075,3107331,3668198,560867,640123,560867,79256,4,0
3679872,650,1,3027558,3027558,3679872,652314,652314,569118,83196,14,0
3683832,322,1,1838284,2027217,3683832,1656615,1845548,1457937,387611,224,0
3697259,665,1,3027622,3027637,3697259,669622,669637,581854,87783,13,0
3712682,196,2,961298,1048758,3712682,2663924,2751384,2092351,659033,184,0
3756220,563,8,2764723,3027133,3756220,729087,991497,520970,470527,1,0
3769817,856,4,3721511,3721552,3769817,48265,48306,48265,41,0,0
3779602,627,1,3027298,3027362,3779602,752240,752304,657192,95112,44,0
3794221,676,1,3027644,3027644,3794221,766577,766577,669987,96590,17,0
3795987,621,1,3027267,3027267,3795987,768720,768720,671478,97242,24,0
3801401,479,4,2230238,2743488,3801401,1057913,1571163,792011,779152,27,0
3813652,861,4,3721529,3756220,3813652,57432,92123,57432,34691,0,0
3815022,377,1,1838883,2033389,3815022,1781633,1976139,1505580,470559,243,0
3856780,868,4,3721559,3756220,3856780,100560,135221,100560,34661,0,0
3860206,836,1,3028121,3126572,3860206,733634,832085,733634,98451,8,0
3868144,875,1,3867133,3867133,3868144,1011,1011,1011,0,0,0
3868164,132,2,961075,961075,3868164,2907089,2907089,2163411,743678,192,0
3879642,779,1,3027995,3129292,3879642,750350,851647,747261,104386,7,0
3889148,874,4,3721586,3769817,3889148,119331,167562,119331,48231,0,0
3891949,885,4,3873106,3889148,3891949,2801,18843,2801,16042,0,0
3895053,880,4,3873036,3891949,3895053,3104,22017,3104,18913,0,0
3896251,876,1,3867169,3867169,3896251,29082,29082,29082,0,0,0
3905953,894,4,3890341,3895053,3905953,10900,15612,10900,4712,0,0
3921288,878,4,3873009,3905953,3921288,15335,48279,15335,32944,0,0
3921469,422,4,2058837,2944544,3921469,976925,1862632,838076,1024556,3,0
3936710,814,1,3028074,3138507,3936710,798203,908636,798203,110433,7,0
3939113,821,1,3028086,3138606,3939113,800507,911027,800507,110520,7,0
3947207,807,1,3028060,3138978,3947207,808229,919147,808229,110918,7,0
3951073,893,4,3890336,3921288,3951073,29785,60737,29785,30952,0,0
3953024,883,4,3873097,3921469,3953024,31555,79927,31555,48372,0,0
3955072,805,1,3028056,3140265,3955072,814807,927016,814807,112209,7,0
3964329,820,1,3028085,3143160,3964329,821169,936244,821169,115075,7,0
3964755,701,1,3027720,3143372,3964755,821383,937035,821383,115652,7,0
3968297,732,1,3027879,3145325,3968297,822972,940418,822972,117446,7,0
3973826,801,1,3028049,3145762,3973826,828064,945777,828064,117713,8,0
3981340,860,4,3721525,3801401,3981340,179939,259815,179939,79876,0,0
4003923,726,1,3027868,3151155,4003923,852768,976055,852768,123287,8,0
4030662,562,8,2764717,3451310,4030662,579352,1265945,579352,686593,0,0
4031007,884,4,3873101,3951073,4031007,79934,157906,79934,77972,0,0
4032075,871,4,3721571,3813652,4032075,218423,310504,218423,92081,0,0
4042385,891,4,3890327,3953024,4042385,89361,152058,89361,62697,0,0
4054041,797,1,3028040,3158867,4054041,895174,1026001,895174,130827,6,0
4055748,796,1,3028037,3160402,4055748,895346,1027711,895346,132365,5,0
4065826,881,4,3873089,3964329,4065826,101497,192737,101497,91240,0,0
4072836,131,2,961072,1072947,4072836,2999889,3111764,2202747,909017,152,0
4097944,829,1,3028108,3161905,4097944,936039,1069836,935385,134451,4,0
4098786,879,4,3873028,3964755,4098786,134031,225758,134031,91727,0,0
4099531,587,8,3011382,3491065,4099531,608466,1088149,608466,479683,0,0
4121735,902,1,4098906,4098906,4121735,22829,22829,22829,0,0,0
4135145,753,1,3027927,3166422,4135145,968723,1107218,968723,138495,1,0
4145555,886,4,3890306,3981340,4145555,164215,255249,164215,91034,0,0
4147908,396,1,1893136,2058866,4147908,2089042,2254772,1570685,684087,231,0
4152814,42,4,291315,291315,4152814,3861499,3861499,2239303,1622196,4,0
4154387,793,1,3028029,3170134,4154387,984253,1126358,984253,142105,2,0
4167317,855,4,3721507,3856780,4167317,310537,445810,310537,135273,0,0
4178220,790,1,3028025,3170134,4178220,1008086,1150195,1008086,142109,5,0
4185500,887,4,3890310,4003923,4185500,181577,295190,181577,113613,0,0
4199458,700,1,3027720,3170134,4199458,1029324,1171738,1029324,142414,6,0
4213469,722,1,3027860,3170134,4213469,1043335,1185609,1043335,142274,7,0
4224579,512,4,2230378,3202526,4224579,1022053,1994201,1022053,972148,1,0
4260066,901,8,4047477,4099531,4260066,160535,212589,160535,52054,0,0
4267243,905,8,4217249,4260066,4267243,7177,49994,7177,42817,0,0
4272621,854,4,3721503,3868164,4272621,404457,551118,404457,146661,0,0
4293486,255,2,1743167,1743167,4293486,2550319,2550319,1591897,958422,158,0
4303330,553,4,2394811,3230474,4303330,1072856,1908519,1072856,835663,0,0
4312918,898,4,3916185,4030662,4312918,282256,396733,282256,114477,0,0
4331483,897,4,3916170,4030662,4331483,300821,415313,300821,114492,0,0
4337627,740,1,3027896,3183470,4337627,1154157,1309731,1150794,158937,9,0
4351847,909,4,4343680,4343680,4351847,8167,8167,8167,0,0,0
4352421,903,8,4131053,4267243,4352421,85178,221368,85178,136190,0,0
4355308,912,8,4349687,4352421,4355308,2887,5621,2887,2734,0,0
4376068,446,4,2059007,3285733,4376068,1090335,2317061,1090335,1226726,0,0
4407637,643,1,3027432,3197279,4407637,1210358,1380205,1210358,169847,9,0
4411453,823,1,3028090,3200892,4411453,1210561,1383363,1210561,172802,9,0
4420498,911,4,4348474,4349687,4420498,70811,72024,70811,1213,0,0
4433867,535,4,2394741,3304935,4433867,1128932,2039126,1128932,910194,0,0
4434184,709,1,3027735,3206697,4434184,1227487,1406449,1227487,178962,9,0
4436024,906,8,4301307,4355308,4436024,80716,134717,80716,54001,0,0
4457022,729,1,3027873,3210312,4457022,1246710,1429149,1246710,182439,10,0
4459164,916,4,4390118,4420498,4459164,38666,69046,38666,30380,0,0
4468406,780,1,3027999,3221579,4468406,1246827,1440407,1246827,193580,12,0
4492621,917,4,4442540,4443293,4492621,49328,50081,49328,753,0,0
4496482,882,4,3873093,4031007,4496482,465475,623389,465475,157914,0,0
4496782,928,4,4491981,4492011,4496782,4771,4801,4771,30,0,0
4501294,931,4,4491995,4492621,4501294,8673,9299,8673,626,0,0
4505905,927,4,4491980,4496482,4505905,9423,13925,9423,4502,0,0
4506450,913,4,4387854,4387854,4506450,118596,118596,118596,0,0,0
4518028,914,4,4387864,4433867,4518028,84161,130164,84161,46003,0,0
4522324,918,4,4442544,4459164,4522324,63160,79780,63160,16620,0,0
4537356,850,4,3721489,4032075,4537356,505281,815867,505281,310586,0,0
4537373,944,4,4496513,4496782,4537373,40591,40860,40591,269,0,0
4544265,954,4,4524626,4537356,4544265,6909,19639,6909,12730,0,0
4545545,950,4,4524588,4537373,4545545,8172,20957,8172,12785,0,0
4552937,951,4,4524591,4544265,4552937,8672,28346,8672,19674,0,0
4555092,647,1,3027523,3260043,4555092,1295049,1527569,1295049,232520,12,0
4565552,935,4,4492021,4496497,4565552,69055,73531,69055,4476,0,0
4566886,943,4,4496509,4501294,4566886,65592,70377,65592,4785,0,0
4570122,949,4,4524584,4545545,4570122,24577,45538,24577,20961,0,0
4593010,910,4,4348460,4348460,4593010,244550,244550,244550,0,0,0
4598125,96,2,960944,960944,4598125,3637181,3637181,2251842,1385339,113,0
4608859,37,4,291287,291287,4608859,4317572,4317572,2411821,1905751,2,0
4609933,719,1,3027854,3272565,4609933,1337368,1582079,1337368,244711,13,0
4621248,734,1,3027883,3276051,4621248,1345197,1593365,1342363,251002,12,0
4648761,932,4,4492004,4505905,4648761,142856,156757,142856,13901,0,0
4659508,851,4,3721493,4042385,4659508,617123,938015,617123,320892,0,0
4680776,652,1,3027573,3294692,4680776,1386084,1653203,1373932,279271,9,0
4691298,933,4,4492011,4506450,4691298,184848,199287,184848,14439,0,0
4715389,833,1,3028116,3317407,4715389,1397982,1687273,1397982,289291,7,0
4731436,804,1,3028055,3326410,4731436,1405026,1703381,1404159,299222,6,0
4732654,936,4,4496481,4518028,4732654,214626,236173,214626,21547,0,0
4777892,877,4,3873005,4065826,4777892,712066,904887,712066,192821,0,0
4788965,959,4,4760871,4777892,4788965,11073,28094,11073,17021,0,0
4790790,733,1,3027881,3350527,4790790,1440263,1762909,1440263,322646,6,0
4796366,79,4,810521,810521,4796366,3985845,3985845,1912884,2072961,2,0
4830455,956,4,4760845,4788965,4830455,41490,69610,41490,28120,0,0
4837728,651,1,3027565,3364927,4837728,1472801,1810163,1472801,337362,8,0
4842737,960,4,4760876,4796366,4842737,46371,81861,46371,35490,0,0
4844688,938,4,4496489,4522324,4844688,322364,348199,322364,25835,0,0
4856797,737,1,3027891,3370198,4856797,1486599,1828906,1486599,342307,10,0
4883440,981,4,4871827,4871827,4883440,11613,11613,11613,0,0,0
4901354,721,1,3027858,3382031,4901354,1519323,1873496,1519323,354173,22,0
4902546,973,4,4869973,4883440,4902546,19106,32573,19106,13467,0,0
4918346,601,1,3027118,3027118,4918346,1891228,1891228,1521787,369441,36,0
4922431,962,4,4869521,4902546,4922431,19885,52910,19885,33025,0,0
4936883,940,4,4496497,4552937,4936883,383946,440386,383946,56440,0,0
4938593,228,2,1743049,1743049,4938593,3195544,3195544,1612723,1582821,95,0
4950794,982,4,4925426,4936883,4950794,13911,25368,13911,11457,0,0
4953242,977,4,4869989,4918346,4953242,34896,83253,34896,48357,0,0
4955040,615,1,3027207,3421272,4955040,1533768,1927833,1533768,394065,51,0
4967019,786,1,3028015,3427944,4967019,1539075,1939004,1539075,399929,63,0
4975756,908,4,4343676,4343676,4975756,632080,632080,632080,0,0,0
4978874,966,4,4869540,4922431,4978874,56443,109334,56443,52891,0,0
4979844,896,4,3916165,4098786,4979844,881058,1063679,881058,182621,0,0
4998956,969,4,4869959,4938593,4998956,60363,128997,60363,68634,0,0
5012360,920,4,4442557,4565552,5012360,446808,569803,446808,122995,0,0
5060703,852,4,3721496,4145555,5060703,915148,1339207,915148,424059,0,0
5064122,957,4,4760855,4830455,5064122,233667,303267,233667,69600,0,0
5076490,970,4,4869963,4950794,5076490,125696,206527,125696,80831,0,0
5076559,866,4,3721552,4147908,5076559,928651,1355007,928651,426356,0,0
5094544,344,1,1838543,2058866,5094544,3035678,3256001,2000840,1255161,229,0
5115684,614,1,3027195,3548564,5115684,1567120,2088489,1567120,521369,79,0
5119475,899,4,3916188,4152814,5119475,966661,1203287,966661,236626,0,0
5121895,941,4,4496501,4566886,5121895,555009,625394,555009,70385,0,0
5129420,925,4,4443293,4570122,5129420,559298,686127,559298,126829,0,0
5131371,978,4,4869992,4953242,5131371,178129,261379,178129,83250,0,0
5144717,895,4,3916158,4167317,5144717,977400,1228559,977400,251159,0,0
5149191,121,2,961036,961036,5149191,4188155,4188155,2298583,1889572,122,0
5170412,798,1,3028041,3583731,5170412,1586681,2142371,1586681,555690,88,0
5180934,974,4,4869978,4975756,5180934,205178,310956,205178,105778,0,0
5186229,573,8,2778479,4436024,5186229,750205,2407750,750205,1657545,0,0
5201191,961,4,4760908,4842737,5201191,358454,440283,358454,81829,0,0
5219858,980,4,4871823,4978874,5219858,240984,348035,240984,107051,0,0
5242519,965,4,4869535,4979844,5242519,262675,372984,262675,110309,0,0
5296893,953,4,4524620,4593010,5296893,703883,772273,703883,68390,0,0
5320945,698,1,3027716,3593966,5320945,1726979,2293229,1662951,630278,98,0
5325206,975,4,4869981,4998956,5325206,326250,455225,326250,128975,0,0
5345394,921,4,4442561,4608859,5345394,736535,902833,736535,166298,0,0
5377573,988,4,5212918,5212922,5377573,164651,164655,164651,4,0,0
5392450,148,2,961132,1121471,5392450,4270979,4431318,2354580,2076738,121,0
5399790,634,1,3027351,3679872,5399790,1719918,2372439,1719918,652521,102,0
5423216,469,4,2230201,3581975,5423216,1841241,3193015,1377293,1815722,1,0
5428376,699,1,3027717,3683832,5428376,1744544,2400659,1744544,656115,109,0
5436845,919,4,4442549,4648761,5436845,788084,994296,788084,206212,0,0
5461376,730,1,3027876,3697259,5461376,1764117,2433500,1764117,669383,116,0
5474569,990,4,5451075,5451075,5474569,23494,23494,23494,0,0,0
5562266,629,1,3027317,3779602,5562266,1782664,2534949,1782664,752285,109,0
5563068,996,2,5560659,5560659,5563068,2409,2409,2409,0,0,0
5582698,995,2,5560655,5560655,5582698,22043,22043,22043,0,0,0
5611097,992,2,5560635,5560635,5611097,50462,50462,50462,0,0,0
5639681,653,1,3027576,3794221,5639681,1845460,2612105,1795342,816763,114,0
5648384,1006,4,5564836,5564836,5648384,83548,83548,83548,0,0,0
5676915,889,4,3890317,4224579,5676915,1452336,1786598,1289325,497273,1,0
5683663,993,2,5560636,5560636,5683663,123027,123027,123027,0,0,0
5686324,379,1,1838910,2181135,5686324,3505189,3847414,2004790,1842624,190,0
5692262,989,4,5212922,5219858,5692262,472404,479340,472404,6936,0,0
5717133,1022,4,5641116,5641116,5717133,76017,76017,76017,0,0,0
5722766,979,4,4869996,5012360,5722766,710406,852770,710406,142364,0,0
5722842,1011,4,5640888,5641064,5722842,81778,81954,81778,176,0,0
5726984,947,4,4496532,4691298,5726984,1035686,1230452,1035686,194766,0,0
5752754,592,1,3027046,3815022,5752754,1937732,2725708,1830686,895022,118,0
5753673,1026,4,5654163,5676915,5753673,76758,99510,76758,22752,0,0
5783258,1015,4,5640945,5641071,5783258,142187,142313,142187,126,0,0
5791222,1014,4,5640943,5648384,5791222,142838,150279,142838,7441,0,0
5862087,859,4,3721522,4272621,5862087,1589466,2140565,1348823,791742,1,0
5946353,987,4,5212903,5242519,5946353,703834,733450,703834,29616,0,0
5958104,104,2,960974,960974,5958104,4997130,4997130,2401851,2595279,120,0
5999132,991,2,5560622,5560636,5999132,438496,438510,438496,14,0,0
6024489,738,1,3027892,3860206,6024489,2164283,2996597,1936442,1060155,109,0
6098210,999,4,5564813,5692262,6098210,405948,533397,405948,127449,0,0
6133649,1010,4,5640886,5717133,6133649,416516,492763,416516,76247,0,0
6141013,1034,1,6032624,6032624,6141013,108389,108389,108389,0,0,0
6141250,994,2,5560640,5560640,6141250,580610,580610,580610,0,0,0
6153371,572,8,2778466,5186229,6153371,967142,3374905,967142,2407763,0,0
6163406,1039,1,6032659,6032659,6163406,130747,130747,130747,0,0,0
6164767,1037,1,6032640,6032640,6164767,132127,132127,132127,0,0,0
6227115,983,4,4925447,5060703,6227115,1166412,1301668,1166412,135256,0,0
6244688,986,4,5212828,5296893,6244688,947795,1031860,947795,84065,0,0
6250745,1068,4,6243609,6243609,6250745,7136,7136,7136,0,0,0
6251385,1044,4,6243278,6243404,6251385,7981,8107,7981,126,0,0
6253311,1069,4,6243620,6243632,6253311,9679,9691,9679,12,0,0
6257840,1084,4,6243823,6243915,6257840,13925,14017,13925,92,0,0
6259681,1078,4,6243744,6243744,6259681,15937,15937,15937,0,0,0
6261174,607,1,3027153,3955072,6261174,2306102,3234021,1986952,1247069,97,0
6262399,1067,4,6243598,6243734,6262399,18665,18801,18665,136,0,0
6262690,984,4,4925477,5064122,6262690,1198568,1337213,1198568,138645,0,0
6267634,1091,4,6243915,6243996,6267634,23638,23719,23638,81,0,0
6268359,1079,4,6243756,6243767,6268359,24592,24603,24592,11,0,0
6278899,1061,4,6243525,6243545,6278899,35354,35374,35354,20,0,0
6280538,1120,4,6244319,6244328,6280538,36210,36219,36210,9,0,0
6287012,1081,4,6243778,6244006,6287012,43006,43234,43006,228,0,0
6288359,1102,4,6244057,6244190,6288359,44169,44302,44169,133,0,0
6290386,467,4,2230194,4303330,6290386,1987056,4060192,1378838,2681354,3,0
6293434,1077,4,6243734,6244037,6293434,49397,49700,49397,303,0,0
6293689,102,2,960968,960968,6293689,5332721,5332721,2462520,2870201,116,0
6293921,1048,4,6243329,6243446,6293921,50475,50592,50475,117,0,0
6299509,1098,4,6244006,6244298,6299509,55211,55503,55211,292,0,0
6305410,1053,4,6243404,6243469,6305410,61941,62006,61941,65,0,0
6319347,1097,4,6243996,6244347,6319347,75000,75351,75000,351,0,0
6323100,1099,4,6244017,6244357,6323100,78743,79083,78743,340,0,0
6331297,1072,4,6243657,6244688,6331297,86609,87640,86609,1031,0,0
6353934,1029,4,5654178,5722766,6353934,631168,699756,631168,68588,0,0
6355566,1065,4,6243576,6250745,6355566,104821,111990,104821,7169,0,0
6369835,1076,4,6243723,6251385,6369835,118450,126112,118450,7662,0,0
6380684,1017,4,5641071,5722842,6380684,657842,739613,657842,81771,0,0
6403167,1117,4,6244249,6253311,6403167,149856,158918,149856,9062,0,0
6430067,1028,4,5654174,5726984,6430067,703083,775893,703083,72810,0,0
6445706,1040,1,6032665,6032665,6445706,413041,413041,413041,0,0,0
6445990,857,4,3721514,4312918,6445990,2133072,2724476,1416759,1307717,2,0
6465058,359,1,1838688,2753904,6465058,3711154,4626370,2041589,2584781,120,0
6508556,1082,4,6243789,6257840,6508556,250716,264767,250716,14051,0,0
6510794,1119,4,6244298,6259681,6510794,251113,266496,251113,15383,0,0
6522756,1113,4,6244190,6262399,6522756,260357,278566,260357,18209,0,0
6524899,1070,4,6243632,6262690,6524899,262209,281267,262209,19058,0,0
6526283,892,4,3890331,4331483,6526283,2194800,2635952,1419005,1216947,1,0
6528884,633,1,3027348,4468406,6528884,2060478,3501536,2060478,1441058,113,0
6530585,1124,2,6511338,6511344,6530585,19241,19247,19241,6,0,0
6545456,1050,4,6243360,6243502,6545456,301954,302096,301954,142,0,0
6551475,1096,4,6243986,6267634,6551475,283841,307489,283841,23648,0,0
6551967,937,4,4496485,5121895,6551967,1430072,2055482,1430072,625410,0,0
6581839,1121,4,6244328,6268359,6581839,313480,337511,313480,24031,0,0
6592204,74,2,769106,769106,6592204,5823098,5823098,2688813,3134285,94,0
6595209,1059,4,6243502,6243545,6595209,351664,351707,317122,34585,1,0
6617952,31,1,225000,225000,6617952,6392952,6392952,3533495,2859457,197,0
6641902,1093,4,6243936,6280538,6641902,361364,397966,361364,36602,0,0
6655830,1110,4,6244139,6287012,6655830,368818,411691,368818,42873,0,0
6665167,1089,4,6243883,6288359,6665167,376808,421284,376808,44476,0,0
6676771,423,4,2058848,4337627,6676771,2339144,4617923,1507312,3110611,3,0
6682828,752,1,3027926,4609933,6682828,2072895,3654902,2072895,1582007,94,0
6696964,1126,4,6665528,6676771,6696964,20193,31436,20193,11243,0,0
6706024,1101,4,6244037,6293434,6706024,412590,461987,412590,49397,0,0
6719342,630,1,3027324,4621248,6719342,2098094,3692018,2098094,1593924,108,0
6731165,478,4,2230234,5131371,6731165,1599794,4500931,1550063,2950868,1,0
6758574,1086,4,6243849,6299509,6758574,459065,514725,459065,55660,0,0
6760551,1129,4,6691730,6696964,6760551,63587,68821,63587,5234,0,0
6770352,922,4,4442565,5144717,6770352,1625635,2327787,1564262,763525,1,0
6815691,429,4,2058878,5149191,6815691,1666500,4756813,1591159,3165654,1,0
6820506,294,1,1837996,4680776,6820506,2139730,4982510,2139730,2842780,120,0
6859646,1100,4,6244027,6323100,6859646,536546,615619,536546,79073,0,0
6883144,763,1,3027961,4715389,6883144,2167755,3855183,2167755,1687428,134,0
6894946,434,4,2058920,5180934,6894946,1714012,4836026,1626711,3209315,1,0
6919219,1080,4,6243767,6353934,6919219,565285,675452,565285,110167,0,0
6933527,680,1,3027652,4731436,6933527,2202091,3905875,2185644,1720231,144,0
6950175,1020,4,5641096,5753673,6950175,1196502,1309079,1084851,224228,1,0
6993987,1131,4,6691799,6706024,6993987,287963,302188,287963,14225,0,0
6995030,1063,4,6243545,6369835,6995030,625195,751485,625195,126290,0,0
7021725,598,1,3027094,4790790,7021725,2230935,3994631,2202509,1792122,152,0
7031219,1046,4,6243298,6380684,7031219,650535,787921,650535,137386,0,0
7081115,1083,4,6243812,6403167,7081115,677948,837303,677948,159355,0,0
7129144,1056,4,6243436,6430067,7129144,699077,885708,699077,186631,0,0
7143668,1125,2,6511344,6511344,7143668,632324,632324,632324,0,0,0
7154800,1111,4,6244148,6445706,7154800,709094,910652,709094,201558,0,0
7209025,1114,4,6244210,6445990,7209025,763035,964815,763035,201780,0,0
7225326,1036,1,6032634,6032634,7225326,1192692,1192692,1192692,0,79,0
7233630,1135,2,7184875,7184875,7233630,48755,48755,48755,0,0,0
7264202,1136,2,7184879,7184879,7264202,79323,79323,79323,0,0,0
7272195,1013,4,5640921,5783258,7272195,1488937,1631274,1224148,407126,1,0
7320112,1016,4,5641064,5791222,7320112,1528890,1679048,1250428,428620,2,0
7338916,1134,2,7184871,7184871,7338916,154045,154045,154045,0,0,0
7347194,1094,4,6243946,6524899,7347194,822295,1103248,822295,280953,0,0
7352038,1156,8,7351029,7351029,7352038,1009,1009,1009,0,0,0
7352138,1152,8,7351008,7351019,7352138,1119,1130,1119,11,0,0
7352319,1147,8,7350898,7350909,7352319,1410,1421,1410,11,0,0
7352605,1155,8,7351023,7351034,7352605,1571,1582,1571,11,0,0
7352930,1153,8,7351013,7351039,7352930,1891,1917,1891,26,0,0
7353034,1158,8,7351039,7351039,7353034,1995,1995,1995,0,0,0
7355362,1164,8,7351071,7351071,7355362,4291,4291,4291,0,0,0
7355458,1143,8,7350869,7350875,7355458,4583,4589,4583,6,0,0
7355719,1145,8,7350880,7350891,7355719,4828,4839,4828,11,0,0
7356157,1159,8,7351045,7351045,7356157,5112,5112,5112,0,0,0
7357149,1149,8,7350914,7350914,7357149,6235,6235,6235,0,0,0
7358516,1168,8,7351091,7351091,7358516,7425,7425,7425,0,0,0
7359748,1163,8,7351065,7351065,7359748,8683,8683,8683,0,0,0
7364602,674,1,3027641,4837728,7364602,2526874,4336961,2207872,2129089,158,0
7376692,1161,8,7351055,7351055,7376692,25637,25637,25637,0,0,0
7379835,1150,8,7350920,7351003,7379835,28832,28915,28832,83,0,0
7381889,1166,8,7351081,7352038,7381889,29851,30808,29851,957,0,0
7385769,1148,8,7350909,7352138,7385769,33631,34860,33631,1229,0,0
7389657,1167,8,7351086,7352319,7389657,37338,38571,37338,1233,0,0
7394533,1146,8,7350891,7352605,7394533,41928,43642,41928,1714,0,0
7397181,1176,1,7363821,7363821,7397181,33360,33360,33360,0,0,0
7402052,1116,4,6244240,6526283,7402052,875769,1157812,875769,282043,3,0
7465263,976,4,4869985,5201191,7465263,2264072,2595278,1627256,968022,4,0
7538539,1169,8,7351095,7353034,7538539,185505,187444,185505,1939,0,0
7543894,1170,8,7351101,7355362,7543894,188532,192793,188532,4261,0,0
7548025,1128,4,6691705,6731165,7548025,816860,856320,815021,41299,2,0
7579525,1151,8,7351003,7355458,7579525,224067,228522,224067,4455,0,0
7581359,1160,8,7351050,7355719,7581359,225640,230309,225640,4669,0,0
7600707,1180,1,7363956,7363956,7600707,236751,236751,236751,0,0,0
7615267,1071,4,6243644,6551475,7615267,1063792,1371623,1058706,312917,1,0
7656613,985,4,5020124,5345394,7656613,2311219,2636489,1692516,943973,3,0
7685427,1157,8,7351034,7357149,7685427,328278,334393,328278,6115,0,0
7700296,811,1,3028068,5320945,7700296,2379351,4672228,2210896,2461332,152,0
7727811,1109,4,6244129,6581839,7727811,1145972,1483682,1138521,345161,2,0
7742531,1141,4,7350124,7350124,7742531,392407,392407,384946,7461,1,0
7771988,1142,8,7350492,7359748,7771988,412240,421496,412240,9256,0,0
7804750,1075,4,6243713,6595209,7804750,1209541,1561037,1183904,377133,2,0
7853498,1154,8,7351019,7379835,7853498,473663,502479,473663,28816,0,0
7854318,1107,4,6244107,6641902,7854318,1212416,1610211,1186769,423442,1,0
7879544,1087,4,6243861,6655830,7879544,1223714,1635683,1192870,442813,1,0
7888306,739,1,3027896,5461376,7888306,2426930,4860410,2243204,2617206,174,0
7889644,1165,8,7351076,7385769,7889644,503875,538568,503875,34693,0,0
7900980,1057,4,6243446,6665167,7900980,1235813,1657534,1204963,452571,2,0
7906400,1162,8,7351060,7389657,7906400,516743,555340,516743,38597,0,0
8036991,926,4,4443298,5377573,8036991,2659418,3593693,1742891,1850802,3,0
8044681,1074,4,6243703,6760551,8044681,1284130,1800978,1240636,560342,1,0
8060997,72,2,769093,769093,8060997,7291904,7291904,2748946,4542958,173,0
8162227,1118,4,6244268,6770352,8162227,1391875,1917959,1277651,640308,2,0
8178666,818,1,3028081,5611097,8178666,2567569,5150585,2247952,2902633,176,0
8215101,1178,1,7363838,7402052,8215101,813049,851263,813049,38214,0,0
8251673,1173,1,7363786,7402052,8251673,849621,887887,849621,38266,1,0
8364104,1088,4,6243872,6815691,8364104,1548413,2120232,1360908,759324,1,0
8421098,1138,2,7184887,7184887,8421098,1236211,1236211,1048737,187474,8,0
8498829,735,1,3027885,5639681,8498829,2859148,5470944,2298019,3172925,146,0
8502875,849,4,3721485,5392450,8502875,3110425,4781390,1765633,3015757,6,0
8614844,945,4,4496519,5423216,8614844,3191628,4118325,1774267,2344058,4,0
8668545,1175,1,7363816,7538539,8668545,1130006,1304729,1130006,174723,1,0
8726122,1144,8,7350875,7579525,8726122,1146597,1375247,1146597,228650,0,0
8786936,693,1,3027701,5686324,8786936,3100612,5759235,2356754,3402481,128,0
8837029,580,8,2831121,6153371,8837029,2683658,6005908,1487822,4518086,2,0
8908347,890,4,3890323,5436845,8908347,3471502,5018024,1841466,3176558,8,0
8914219,105,2,960978,960978,8914219,7953241,7953241,2686488,5266753,68,0
9053963,1112,4,6244159,6950175,9053963,2103788,2809804,1798089,1011715,1,0
9085108,675,1,3027641,5752754,9085108,3332354,6057467,2466052,3591415,57,0
9145411,1172,1,7363782,7600707,9145411,1544704,1781629,1544704,236925,2,0
9180453,85,4,810588,810588,9180453,8369865,8369865,2210569,6159296,3,0
9202966,863,4,3721537,6995030,9202966,2207936,5481429,1873418,3608011,1,0
9292176,1019,4,5641080,7031219,9292176,2260957,3651096,1884055,1767041,2,0
9357607,1095,4,6243966,7081115,9357607,2276492,3113641,1884852,1228789,1,0
9523479,1092,4,6243924,7129144,9523479,2394335,3279555,1918061,1361494,6,0
9528718,1041,1,6032670,6164767,9528718,3363951,3496048,2284164,1211884,51,0
9583617,972,4,4869970,7154800,9583617,2428817,4713647,1920384,2793263,2,0
9638650,586,8,2944809,7853498,9638650,1785152,6693841,1785152,4908689,0,0
9696406,418,4,2058806,7320112,9696406,2376294,7637600,1922419,5715181,5,0
9801860,435,4,2058929,7347194,9801860,2454666,7742931,1950472,5792459,1,0
9813119,584,8,2867843,7889644,9813119,1923475,6945276,1923475,5021801,0,0
9839466,500,4,2230319,7879544,9839466,1959922,7609147,1959922,5649225,1,0
9861439,1062,4,6243535,7900980,9861439,1960459,3617904,1960459,1657445,0,0
9888214,1051,4,6243370,7906400,9888214,1981814,3644844,1981814,1663030,0,0
9903833,224,4,1730223,7906400,9903833,1997433,8173610,1997433,6176177,0,0
10072705,495,4,2230301,8036991,10072705,2035714,7842404,2035714,5806690,0,0
10155843,1024,4,5654154,8044681,10155843,2111162,4501689,2111162,2390527,0,0
10173619,1140,2,7184900,7233630,10173619,2939989,2988719,2155307,833412,18,0
10216463,1179,1,7363938,7888306,10216463,2328157,2852525,2328157,524368,6,0
10283952,1007,4,5564838,8162227,10283952,2121725,4719114,2121725,2597389,0,0
10491999,453,4,2059068,8364104,10491999,2127895,8432931,2127895,6305036,0,0
10516609,284,1,1837896,1837896,10516609,8678713,8678713,2509266,6169447,20,0
10535795,248,2,1743133,5958104,10535795,4577691,8792662,2366357,6426305,6,0
10633913,1090,4,6243906,8502875,10633913,2131038,4390007,2131038,2258969,0,0
10752717,964,4,4869530,8614844,10752717,2137873,5883187,2137873,3745314,0,0
10838478,1049,4,6243350,8668545,10838478,2169933,4595128,2169933,2425195,0,0
10899214,948,4,4497410,8726122,10899214,2173092,6401804,2173092,4228712,0,0
10959591,485,4,2230258,8726122,10959591,2233469,8729333,2233469,6495864,0,0
11097735,872,4,3721578,8837029,11097735,2260706,7376157,2260706,5115451,0,0
11113278,858,4,3721518,8837029,11113278,2276249,7391760,2276249,5115511,0,0
11185612,681,1,3027658,8215101,11185612,2970511,8157954,2604964,5552990,5,0
11209896,1137,2,7184883,8421098,11209896,2788798,4025013,2548996,1476017,4,0
11385972,1023,4,5654150,9053963,11385972,2332009,5731822,2332009,3399813,0,0
11471155,71,2,769074,769074,11471155,10702081,10702081,3049319,7652762,16,0
11491158,270,2,1829663,8914219,11491158,2576939,9661495,2576939,7084556,2,0
11515761,219,4,1730194,9180453,11515761,2335308,9785567,2335308,7450259,0,0
11574267,1052,4,6243393,9202966,11574267,2371301,5330874,2371301,2959573,0,0
11681292,1132,4,6691803,9292176,11681292,2389116,4989489,2389116,2600373,0,0
11711423,776,1,3027988,9085108,11711423,2626315,8683435,2626315,6057120,4,0
11748279,416,4,2058789,9357607,11748279,2390672,9689490,2390672,7298818,0,0
11783283,679,1,3027651,9145411,11783283,2637872,8755632,2637872,6117760,4,0
11919681,442,4,2058959,9523479,11919681,2396202,9860722,2396202,7464520,0,0
11989350,955,4,4738023,9583617,11989350,2405733,7251327,2405733,4845594,0,0
12044884,930,4,4491994,9638650,12044884,2406234,7552890,2406234,5146656,0,0
12045386,952,4,4524606,9638650,12045386,2406736,7520780,2406736,5114044,0,0
12129583,939,4,4496493,9696406,12129583,2433177,7633090,2433177,5199913,0,0
12167099,718,1,3027852,9528718,12167099,2638381,9139247,2638381,6500866,3,0
12254654,1108,4,6244118,9801860,12254654,2452794,6010536,2452794,3557742,0,0
12269136,544,4,2394778,9813119,12269136,2456017,9874358,2456017,7418341,0,0
12317913,888,4,3890313,9813119,12317913,2504794,8427600,2504794,5922806,0,0
12351490,1106,4,6244096,9839466,12351490,2512024,6107394,2512024,3595370,0,0
12379216,502,4,2230333,9861439,12379216,2517777,10148883,2517777,7631106,0,0
12420180,1085,4,6243835,9888214,12420180,2531966,6176345,2531966,3644379,0,0
12480188,441,4,2058955,9903833,12480188,2576355,10421233,2576355,7844878,0,0
12657566,70,2,769060,769060,12657566,11888506,11888506,3049368,8839138,12,0
12787518,365,1,1838741,10072705,12787518,2714813,10948777,2714813,8233964,0,0
12799799,499,4,2230315,10155843,12799799,2643956,10569484,2643956,7925528,0,0
12829364,381,1,1838934,10072705,12829364,2756659,10990430,2756659,8233771,1,0
12895933,138,2,961095,1491022,12895933,11404911,11934838,2974364,8960474,12,0
12944548,924,4,4442572,10283952,12944548,2660596,8501976,2660596,5841380,0,0
13057804,765,1,3027965,10216463,13057804,2841341,10029839,2841341,7188498,1,0
13160348,509,4,2230364,10491999,13160348,2668349,10929984,2668349,8261635,0,0
13270269,261,2,1743209,10535795,13270269,2734474,11527060,2734474,8792586,0,0
13313219,39,4,291300,291300,13313219,13021919,13021919,3349075,9672844,1,0
13408803,327,1,1838348,10516609,13408803,2892194,11570455,2892194,8678261,2,0
13457724,942,4,4496505,10752717,13457724,2705007,8961219,2705007,6256212,0,0
13602124,516,4,2230395,10838478,13602124,2763646,11371729,2763646,8608083,0,0
13666223,506,4,2230350,10899214,13666223,2767009,11435873,2767009,8668864,0,0
13738008,1060,4,6243513,10959591,13738008,2778417,7494495,2778417,4716078,0,0
13898938,240,2,1743103,11097735,13898938,2801203,12155835,2801203,9354632,0,0
13927195,1000,4,5564814,11113278,13927195,2813917,8362381,2813917,5548464,0,0
13957701,120,2,961033,961033,13957701,12996668,12996668,3089300,9907368,13,0
14160865,388,1,1839003,11185612,14160865,2975253,12321862,2975253,9346609,1,0
14198229,691,1,3027692,11209896,14198229,2988333,11170537,2988333,8182204,0,0
14224072,1105,4,6244087,11385972,14224072,2838100,7979985,2838100,5141885,0,0
14253703,658,1,3027598,11209896,14253703,3043807,11226105,3043807,8182298,1,0
14389621,545,4,2394782,11515761,14389621,2873860,11994839,2873860,9120979,0,0
14505721,1001,4,5564815,11574267,14505721,2931454,8940906,2931454,6009452,0,0
14511782,145,2,961121,1574674,14511782,12937108,13550661,3209002,10341659,12,0
14565600,720,1,3027856,11491158,14565600,3074442,11537744,3074442,8463302,1,0
14577061,792,1,3028029,11491158,14577061,3085903,11549032,3085903,8463129,2,0
14690417,870,4,3721566,11681292,14690417,3009125,10968851,3009125,7959726,0,0
14762364,473,4,2230215,11748279,14762364,3014085,12532149,3014085,9518064,0,0
14953653,214,4,1730146,11919681,14953653,3033972,13223507,3033972,10189535,0,0
14992155,1031,1,6032585,11711423,14992155,3280732,8959570,3280732,5678838,3,0
15024155,1122,4,6244347,11989350,15024155,3034805,8779808,3034805,5745003,0,0
15066357,361,1,1838705,11783283,15066357,3283074,13227652,3283074,9944578,2,0
15145470,503,4,2230336,12044884,15145470,3100586,12915134,3100586,9814548,0,0
15153455,1018,4,5641074,12045386,15153455,3108069,9512381,3108069,6404312,0,0
15285887,452,4,2059065,12129583,15285887,3156304,13226822,3156304,10070518,0,0
15411977,1103,4,6244067,12254654,15411977,3157323,9167910,3157323,6010587,0,0
15460670,342,1,1838525,12167099,15460670,3293571,13622145,3293571,10328574,1,0
15461855,182,2,961249,1631892,15461855,13829963,14500606,3303871,11196735,14,0
15511760,929,4,4491989,12317913,15511760,3193847,11019771,3193847,7825924,0,0
15536400,143,2,961114,1635696,15536400,13900704,14575286,3374608,11200678,15,0
15630512,243,2,1743115,12351490,15630512,3279022,13887397,3279022,10608375,0,0
15643119,278,2,1829707,12351490,15643119,3291629,13813412,3291629,10521783,0,0
15702965,604,1,3027141,12379216,15702965,3323749,12675824,3323749,9352075,0,0
15732111,723,1,3027862,12379216,15732111,3352895,12704249,3352895,9351354,0,0
15769790,152,2,961147,1657823,15769790,14111967,14808643,3475787,11332856,12,0
15867261,1025,4,5654159,12420180,15867261,3447081,10213102,3447081,6766021,0,0
15940039,548,4,2394792,12480188,15940039,3459851,13545247,3459851,10085396,0,0
16159457,456,2,2059091,12657566,16159457,3501891,14100366,3501891,10598475,0,0
16331209,306,1,1838115,12787518,16331209,3543691,14493094,3543691,10949403,0,0
16376722,648,1,3027529,12799799,16376722,3576923,13349193,3576923,9772270,0,0
16391540,1032,1,6032613,12799799,16391540,3591741,10358927,3591741,6767186,0,0
16435648,264,2,1829625,12799799,16435648,3635849,14606023,3635849,10970174,0,0
16509982,712,1,3027753,12829364,16509982,3680618,13482229,3680618,9801611,0,0
16558824,267,2,1829645,12895933,16558824,3662891,14729179,3662891,11066288,0,0
16604274,448,4,2059015,12944548,16604274,3659726,14545259,3659726,10885533,0,0
16773308,308,1,1838132,13057804,16773308,3715504,14935176,3715504,11219672,0,0
16830217,192,2,961283,13160348,16830217,3669869,15868934,3669869,12199065,0,0
16879651,292,1,1837978,13160348,16879651,3719303,15041673,3719303,11322370,0,0
16902431,1174,1,7363790,13160348,16902431,3742083,9538641,3742083,5796558,0,0
17010778,1027,4,5654167,13313219,17010778,3697559,11356611,3697559,7659052,0,0
17018095,106,2,960981,960981,17018095,16057114,16057114,3747881,12309233,2,0
17172264,803,1,3028053,13408803,17172264,3763461,14144211,3763461,10380750,0,0
17223948,971,4,4869966,13457724,17223948,3766224,12353982,3766224,8587758,0,0
17396231,623,1,3027274,13602124,17396231,3794107,14368957,3794107,10574850,0,0
17469727,518,4,2230401,13666223,17469727,3803504,15239326,3803504,11435822,0,0
17476995,661,1,3027603,13602124,17476995,3874871,14449392,3874871,10574521,0,0
17588132,147,2,961129,13602124,17588132,3986008,16627003,3986008,12640995,1,0
17726192,293,1,1837987,13738008,17726192,3988184,15888205,3988184,11900021,0,0
17746273,605,1,3027145,13738008,17746273,4008265,14719128,4008265,10710863,0,0
17810974,599,1,3027101,13738008,17810974,4072966,14783873,4072966,10710907,0,0
17843947,817,1,3028079,13738008,17843947,4105939,14815868,4105939,10709929,0,0
17951312,546,4,2394785,13927195,17951312,4024117,15556527,4024117,11532410,0,0
17996323,61,2,719742,719742,17996323,17276581,17276581,4338676,12937905,2,0
18074378,180,2,961242,13957701,18074378,4116677,17113136,4116677,12996459,0,0
18277955,1003,4,5564821,14224072,18277955,4053883,12713134,4053883,8659251,0,0
18356328,368,1,1838789,14160865,18356328,4195463,16517539,4195463,12322076,1,0
18417960,802,1,3028049,14198229,18417960,4219731,15389911,4219731,11170180,2,0
18509996,335,1,1838434,14253703,18509996,4256293,16671562,4256293,12415269,0,0
18528495,997,4,5564794,14389621,18528495,4138874,12963701,4138874,8824827,0,0
18712559,963,4,4869525,14505721,18712559,4206838,13843034,4206838,9636196,0,0
18755133,281,2,1829724,14511782,18755133,4243351,16925409,4243351,12682058,0,0
18915087,600,1,3027113,14565600,18915087,4349487,15887974,4349487,11538487,1,0
18926335,82,4,810548,960964,18926335,17965371,18115787,4235980,13879807,1,0
18976041,659,1,3027599,14577061,18976041,4398980,15948442,4398980,11549462,1,0
19124496,108,2,960989,960989,19124496,18163507,18163507,4362170,13801337,2,0
19127422,101,2,960964,960964,19127422,18166458,18166458,4365113,13801345,1,0
19375897,934,4,4492019,14953653,19375897,4422244,14883878,4422244,10461634,0,0
19423429,602,1,3027122,14992155,19423429,4431274,16396307,4431274,11965033,0,0
19462842,163,2,961185,15024155,19462842,4438687,18501657,4438687,14062970,0,0
19535707,172,2,961215,15024155,19535707,4511552,18574492,4511552,14062940,0,0
19631553,493,4,2230287,15145470,19631553,4486083,17401266,4486083,12915183,0,0
19639647,87,4,810619,960978,19639647,18678669,18829028,4486215,14342813,1,0
19659571,311,1,1838162,15066357,19659571,4593214,17821409,4593214,13228195,2,0
19778643,216,4,1730161,15285887,19778643,4492756,18048482,4492756,13555726,0,0
19967415,864,4,3721545,15411977,19967415,4555438,16245870,4555438,11690432,0,0
20131130,526,4,2230439,15511760,20131130,4619370,17900691,4619370,13281321,0,0
20203693,773,1,3027984,15460670,20203693,4743023,17175709,4743023,12432686,2,0
20216480,536,4,2394749,15536400,20216480,4680080,17821731,4680080,13141651,0,0
20334591,900,4,3916193,15643119,20334591,4691472,16418398,4691472,11726926,0,0
20501384,93,2,960932,960932,20501384,19540452,19540452,4856485,14683967,5,0
20621299,824,1,3028094,15702965,20621299,4918334,17593205,4880655,12712550,1,0
20753823,282,2,1829727,15867261,20753823,4886562,18924096,4886562,14037534,0,0
20780918,770,1,3027973,15769790,20780918,5011128,17752945,5011128,12741817,1,0
20831223,1042,4,6077631,15940039,20831223,4891184,14753592,4891184,9862408,0,0
20889351,362,1,1838714,15867261,20889351,5022090,19050637,5022090,14028547,0,0
20908442,319,1,1838258,15867261,20908442,5041181,19070184,5041181,14029003,1,0
21169103,234,2,1743075,16159457,21169103,5009646,19426028,5009646,14416382,0,0
21402311,862,4,3721533,16435648,21402311,4966663,17680778,4966663,12714115,0,0
21410264,813,1,3028071,16331209,21410264,5079055,18382193,5079055,13303138,1,0
21538335,249,2,1743137,16391540,21538335,5146795,19795198,5023619,14771579,1,0
21592672,387,1,1838994,16376722,21592672,5215950,19753678,5097508,14656170,2,0
21633827,430,4,2058882,16604274,21633827,5029553,19574945,5029553,14545392,0,0
21892480,1035,1,6032629,16773308,21892480,5119172,15859851,5119172,10740679,0,0
21970817,350,1,1838603,16830217,21970817,5140600,20132214,5140600,14991614,1,0
21995075,789,1,3028019,16830217,21995075,5164858,18967056,5164858,13802198,2,0
22052966,791,1,3028025,16879651,22052966,5173315,19024941,5173315,13851626,1,0
22082586,1045,4,6243288,17010778,22082586,5071808,15839298,5071808,10767490,0,0
22108853,764,1,3027961,16902431,22108853,5206422,19080892,5206422,13874470,2,0
22240216,686,1,3027677,17018095,22240216,5222121,19212539,5222121,13990418,0,0
22306382,412,4,1911159,17223948,22306382,5082434,20395223,5082434,15312789,0,0
22335764,316,1,1838230,17018095,22335764,5317669,20497534,5317669,15179865,1,0
22576956,624,1,3027278,17172264,22576956,5404692,19549678,5404692,14144986,1,0
22707935,958,4,4760861,17469727,22707935,5238208,17947074,5238208,12708866,0,0
22763574,178,2,961236,17476995,22763574,5286579,21802338,5286579,16515759,0,0
22939315,68,2,769058,769058,22939315,22170257,22170257,5543106,16627151,1,0
23098414,257,2,1743187,17746273,23098414,5352141,21355227,5352141,16003086,1,0
23220667,465,4,2230187,17951312,23220667,5269355,20990480,5269355,15721125,0,0
23223860,241,2,1743106,17843947,23223860,5379913,21480754,5379913,16100841,1,0
23438738,184,2,961256,17996323,23438738,5442415,22477482,5442415,17035067,0,0
23517615,657,1,3027595,17396231,23517615,6121384,20490020,5577055,14912965,4,0
23655380,458,4,2059105,18277955,23655380,5377425,21596275,5377425,16218850,0,0
23709428,705,1,3027728,18074378,23709428,5635050,20681700,5635050,15046650,1,0
24025668,107,2,960985,18417960,24025668,5607708,23064683,5607708,17456975,0,0
24060622,449,4,2059019,18528495,24060622,5532127,22001603,5532127,16469476,0,0
24299309,528,4,2394716,18712559,24299309,5586750,21904593,5586750,16317843,0,0
24326843,593,1,3027057,18356328,24326843,5970515,21299786,5878479,15421307,3,0
24473060,188,2,961270,18755133,24473060,5717927,23511790,5717927,17793863,0,0
24692467,432,4,2058893,18926335,24692467,5766132,22633574,5766132,16867442,0,0
24944639,1171,1,7363777,18915087,24944639,6029552,17580862,6029552,11551310,2,0
25005304,869,4,3721563,19127422,25005304,5877882,21283741,5877882,15405859,0,0
25201351,673,1,3027637,18976041,25201351,6225310,22173714,6225310,15948404,2,0
25359587,443,4,2058968,19375897,25359587,5983690,23300619,5983690,17316929,0,0
25680640,570,8,2778450,19631553,25680640,6049087,22902190,6049087,16853103,0,0
25728982,806,1,3028059,19124496,25728982,6604486,22700923,6308479,16392444,2,0
25780542,427,4,2058870,19535707,25780542,6244835,23721672,6236741,17484931,1,0
26001231,329,1,1838366,19124496,26001231,6876735,24162865,6344586,17818279,1,0
26024213,436,4,2058934,19778643,26024213,6245570,23965279,6245570,17719709,0,0
26216105,161,2,961178,19462842,26216105,6753263,25254927,6321555,18933372,1,0
26318362,655,1,3027588,19967415,26318362,6350947,23290774,6350947,16939827,0,0
26427071,391,1,1839029,19967415,26427071,6459656,24588042,6459656,18128386,0,0
26708039,213,2,961366,20131130,26708039,6576909,25746673,6576909,19169764,0,0
26909685,1009,4,5640885,20216480,26909685,6693205,21268800,6693205,14575595,0,0
26978293,707,1,3027731,20131130,26978293,6847163,23950562,6847163,17103399,1,0
27063600,543,4,2394774,20334591,27063600,6729009,24668826,6729009,17939817,0,0
27075969,330,1,1838379,20131130,27075969,6944839,25237590,6944839,18292751,2,0
27219914,369,1,1838798,20203693,27219914,7016221,25381116,7016221,18364895,2,0
27575846,799,1,3028044,20501384,27575846,7074462,24547802,7074462,17473340,0,0
27738851,867,4,3721556,20831223,27738851,6907628,24017295,6907628,17109667,0,0
27762967,245,2,1743121,20621299,27762967,7141668,26019846,7141668,18878178,1,0
27902359,352,1,1838619,20501384,27902359,7400975,26063740,7268451,18795289,1,0
28081058,189,2,961273,20889351,28081058,7191707,27119785,7191707,19928078,0,0
28193509,358,1,1838680,20753823,28193509,7439686,26354829,7439686,18915143,4,0
28261447,644,1,3027492,20780918,28261447,7480529,25233955,7461438,17772517,2,0
28574500,183,2,961253,21169103,28574500,7405397,27613247,7405397,20207850,0,0
28581240,462,4,2230177,21402311,28581240,7178929,26351063,7178929,19172134,0,0
28897472,550,4,2394800,21633827,28897472,7263645,26502672,7263645,19239027,0,0
28903475,373,1,1838843,21410264,28903475,7493211,27064632,7493211,19571421,1,0
29076231,639,1,3027388,21538335,29076231,7537896,26048843,7537896,18510947,2,0
29118762,1177,1,7363825,21538335,29118762,7580427,21754937,7580427,14174510,2,0
29287153,640,1,3027400,21592672,29287153,7694481,26259753,7694481,18565272,2,0
29393920,514,4,2230385,22082586,29393920,7311334,27163535,7311334,19852201,0,0
29595169,595,1,3027069,21892480,29595169,7702689,26568100,7702689,18865411,4,0
29654700,1066,4,6243588,22306382,29654700,7348318,23411112,7348318,16062794,0,0
29682625,274,2,1829691,22052966,29682625,7629659,27852934,7629659,20223275,2,0
29689042,727,1,3027870,21970817,29689042,7718225,26661172,7718225,18942947,5,0
29821298,772,1,3027981,21995075,29821298,7826223,26793317,7770336,19022981,3,0
30058989,326,1,1838339,22240216,30058989,7818773,28220650,7818773,20401877,2,0
30074042,468,4,2230198,22707935,30074042,7366107,27843844,7366107,20477737,0,0
30156802,795,1,3028033,22335764,30156802,7821038,27128769,7821038,19307731,1,0
30419440,201,2,961315,22763574,30419440,7655866,29458125,7655866,21802259,0,0
30482898,689,1,3027688,22576956,30482898,7905942,27455210,7905942,19549268,2,0
30603480,206,2,961336,22939315,30603480,7664165,29642144,7664165,21977979,0,0
30844477,471,4,2230208,23220667,30844477,7623810,28614269,7623810,20990459,0,0
30911421,549,4,2394796,23223860,30911421,7687561,28516625,7687561,20829064,0,0
31333825,271,2,1829671,23098414,31333825,8235411,29504154,8020533,21483621,2,0
31566933,769,1,3027972,23517615,31566933,8049318,28538961,8049318,20489643,0,0
31751968,537,4,2394752,23655380,31751968,8096588,29357216,8096588,21260628,0,0
32136285,666,1,3027624,23709428,32136285,8426857,29108661,8426857,20681804,0,0
32208362,1047,4,6243319,24060622,32208362,8147740,25965043,8147740,17817303,0,0
32416438,1139,2,7184896,24025668,32416438,8390770,25231542,8390770,16840772,1,0
32488828,487,4,2230265,24299309,32488828,8189519,30258563,8189519,22069044,0,0
32976553,459,4,2059109,24692467,32976553,8284086,30917444,8284086,22633358,0,0
33022109,355,1,1838653,24326843,33022109,8695266,31183456,8695266,22488190,1,0
33177567,714,1,3027797,24473060,33177567,8704507,30149770,8704507,21445263,1,0
33331110,1130,4,6691785,25005304,33331110,8325806,26639325,8325806,18313519,0,0
33504485,324,1,1838312,24473060,33504485,9031425,31666173,9031425,22634748,2,0
33791188,150,2,961140,25201351,33791188,8589837,32830048,8589837,24240211,0,0
33896656,77,4,810498,810498,33896656,33086158,33086158,8687549,24398609,1,0
34247569,78,4,810513,810528,34247569,33437041,33437056,8717369,24719687,1,0
34276407,52,4,510176,510176,34276407,33766231,33766231,9046555,24719676,1,0
34405648,40,4,291309,291309,34405648,34114339,34114339,9294745,24819594,1,0
34708294,345,1,1838551,24944639,34708294,9763655,32869743,9236024,23633719,3,0
34762087,481,4,2230245,26024213,34762087,8737874,32531842,8737874,23793968,0,0
35204202,123,2,961045,26216105,35204202,8988097,34243157,8988097,25255060,0,0
35446968,357,1,1838671,26001231,35446968,9445737,33608297,9445737,24162560,2,0
35707683,187,2,961267,26427071,35707683,9280612,34746416,9280612,25465804,0,0
36010198,73,2,769100,769100,36010198,35241098,35241098,9494037,25747061,12,0
36163260,865,4,3721548,26909685,36163260,9253575,32441712,9253575,23188137,0,0
36322828,1030,4,5654182,27063600,36322828,9259228,30668646,9259228,21409418,0,0
36554589,683,1,3027666,26318362,36554589,10236227,33526923,9685005,23841918,3,0
36632851,400,2,1900669,27219914,36632851,9412937,34732182,9412937,25319245,0,0
37093363,437,4,2058938,27738851,37093363,9354512,35034425,9354512,25679913,0,0
37332218,754,1,3027930,27075969,37332218,10256249,34304288,9900317,24403971,3,0
37753321,678,1,3027647,27762967,37753321,9990354,34725674,9990354,24735320,1,0
37779606,967,4,4869543,28261447,37779606,9518159,32910063,9518159,23391904,0,0
37843770,175,2,961225,27902359,37843770,9941411,36882545,9941411,26941134,1,0
38350037,36,4,291278,291278,38350037,38058759,38058759,10288513,27770246,7,0
38480961,694,1,3027709,27762967,38480961,10717994,35453252,10226242,25227010,4,0
38749349,853,4,3721500,28897472,38749349,9851877,35027849,9851877,25175972,0,0
39016301,176,2,961229,28193509,39016301,10822792,38055072,10180764,27874308,2,0
39196967,590,1,3027031,28081058,39196967,11115909,36169936,10562162,25607774,5,0
39277550,222,4,1730215,29393920,39277550,9883630,37547335,9883630,27663705,0,0
39777743,1073,4,6243683,29654700,39777743,10123043,33534060,10123043,23411017,0,0
40072468,209,2,961346,29682625,40072468,10389843,39111122,10389843,28721279,0,0
40133719,250,2,1743140,29689042,40133719,10444677,38390579,10444677,27945902,0,0
40256638,784,1,3028008,29118762,40256638,11137876,37228630,11137876,26090754,6,0
40443313,203,2,961325,29821298,40443313,10622015,39481988,10622015,28859973,0,0
40583059,90,4,810916,30074042,40583059,10509017,39772143,10509017,29263126,0,0
40780067,370,1,1838817,29287153,40780067,11492914,38941250,11255223,27686027,8,0
41066031,236,2,1743083,30419440,41066031,10646591,39322948,10646591,28676357,0,0
41420598,325,1,1838320,29595169,41420598,11825429,39582278,11357669,28224609,5,0
41546641,94,2,960936,960936,41546641,40585705,40585705,10943195,29642510,9,0
41686009,915,4,4390097,30844477,41686009,10841532,37295912,10841532,26454380,0,0
41858491,742,1,3027900,30482898,41858491,11375593,38830591,11375593,27454998,3,0
41880493,486,4,2230262,30911421,41880493,10969072,39650231,10969072,28681159,1,0
42308567,211,2,961356,31333825,42308567,10974742,41347211,10974742,30372469,1,0
42973181,744,1,3027906,31566933,42973181,11406248,39945275,11406248,28539027,1,0
42990537,173,2,961218,31751968,42990537,11238569,42029319,11238569,30790750,0,0
43058100,103,2,960971,31751968,43058100,11306132,42097129,11306132,30790997,1,0
43634878,431,4,2058890,32208362,43634878,11426516,41575988,11426516,30149472,0,0
43797924,743,1,3027903,32136285,43797924,11661639,40770021,11661639,29108382,2,0
44026509,946,4,4496524,32488828,44026509,11537681,39529985,11537681,27992304,0,0
44251671,767,1,3027969,32416438,44251671,11835233,41223702,11835233,29388469,1,0
44286742,778,1,3027993,32416438,44286742,11870304,41258749,11870304,29388445,2,0
44571155,230,2,1743056,32976553,44571155,11594602,42828099,11594602,31233497,0,0
44746957,566,8,2764771,34276407,44746957,10470550,41982186,10470550,31511636,0,0
44792458,239,2,1743099,32976553,44792458,11815905,43049359,11815905,31233454,1,0
45058766,717,1,3027850,33022109,45058766,12036657,42030916,12036657,29994259,1,0
45195503,48,4,343968,343968,45195503,44851535,44851535,12331341,32520194,1,0
45792235,99,2,960956,960956,45792235,44831279,44831279,12001051,32830228,1,0
45793845,662,1,3027607,33177567,45793845,12616278,42766238,12616278,30149960,3,0
45926040,231,2,1743063,33896656,45926040,12029384,44182977,12029384,32153593,0,0
46376966,136,2,961089,33896656,46376966,12480310,45415877,12480310,32935567,0,0
46757999,998,4,5564802,34247569,46757999,12510430,41193197,12381189,28812008,1,0
46806741,751,1,3027923,33504485,46806741,13302256,43778818,13302256,30476562,5,0
47276624,428,4,2058874,34762087,47276624,12514537,45217750,12514537,32703213,0,0
48118706,340,1,1838492,34708294,48118706,13410412,46280214,13410412,32869802,2,0
48162835,403,2,1900746,35204202,48162835,12958633,46262089,12958633,33303456,1,0
48949157,331,1,1838389,35446968,48949157,13502189,47110768,13502189,33608579,1,0
49121265,968,4,4869549,36163260,49121265,12958005,44251716,12958005,31293711,0,0
49291767,710,1,3027739,35707683,49291767,13584084,46264028,13584084,32679944,2,0
49303164,88,4,810624,36322828,49303164,12980336,48492540,12980336,35512204,0,0
49707716,164,2,961188,36010198,49707716,13697518,48746528,13697518,35049010,3,0
50108571,645,1,3027511,35707683,50108571,14400888,47081060,14400888,32680172,5,0
50209522,221,4,1730202,37093363,50209522,13116159,48479320,13116159,35363161,0,0
50396341,244,2,1743118,36632851,50396341,13763490,48653223,13763490,34889733,1,0
50496810,904,8,4216605,38350037,50496810,12146773,46280205,12146773,34133432,0,0
51049607,519,4,2230405,37779606,51049607,13270001,48819202,13270001,35549201,0,0
51243935,663,1,3027610,36554589,51243935,14689346,48216325,14689346,33526979,5,0
51860992,488,4,2230269,37843770,51860992,14017222,49630723,13617910,36012813,1,0
52735167,158,2,961168,37753321,52735167,14981846,51773999,13809315,37964684,2,0
53096976,618,1,3027241,37332218,53096976,15764758,50069735,15037118,35032617,3,0
53282295,277,2,1829702,39277550,53282295,14004745,51452593,14004745,37447848,0,0
53304753,185,2,961259,39277550,53304753,14027203,52343494,14027203,38316291,0,0
53914850,190,2,961277,39777743,53914850,14137107,52953573,14137107,38816466,0,0
54367408,374,1,1838858,39196967,54367408,15170441,52528550,15170441,37358109,2,0
54410159,204,2,961329,39777743,54410159,14632416,53448830,14632416,38816414,0,0
54955926,1055,4,6243426,40133719,54955926,14822207,48712500,14822207,33890293,0,0
55385760,1133,2,7184850,40072468,55385760,15313292,48200910,15003698,33197212,1,0
55460326,687,1,3027680,40256638,55460326,15203688,52432646,15203688,37228958,1,0
55503292,51,4,343999,343999,55503292,55159293,55159293,15386853,39772440,1,0
55985819,690,1,3027690,40780067,55985819,15205752,52958129,15205752,37752377,0,0
56318006,750,1,3027923,41066031,56318006,15251975,53290083,15251975,38038108,0,0
56883773,390,1,1839020,41066031,56883773,15817742,55044753,15817742,39227011,1,0
56995267,207,2,961339,41546641,56995267,15448626,56033928,15448626,40585302,0,0
57309182,538,4,2394756,41686009,57309182,15623173,54914426,15623173,39291253,0,0
57427527,591,1,3027043,41420598,57427527,16006929,54400484,16006929,38393555,2,0
58146463,127,2,961058,41880493,58146463,16265970,57185405,16265970,40919435,0,0
58281020,731,1,3027877,41858491,58281020,16422529,55253143,16422529,38830614,1,0
58352644,631,1,3027329,41880493,58352644,16472151,55325315,16472151,38853164,0,0
58431671,626,1,3027290,41880493,58431671,16551178,55404381,16551178,38853203,0,0
59074916,747,1,3027915,42308567,59074916,16766349,56047001,16766349,39280652,0,0
59340815,454,4,2059076,43058100,59340815,16282715,57281739,16282715,40999024,0,0
59774673,114,2,961011,42973181,59774673,16801492,58813662,16801492,42012170,2,0
59976126,1064,4,6243565,43634878,59976126,16341248,53732561,16341248,37391313,0,0
60383824,1127,4,6691429,44026509,60383824,16357315,53692395,16357315,37335080,0,0
60692458,612,1,3027177,42308567,60692458,18383891,57665281,17559148,40106133,2,0
61208709,873,4,3721582,44746957,61208709,16461752,57487127,16461752,41025375,0,0
61317061,115,2,961015,42990537,61317061,18326524,60356046,16813469,43542577,1,0
61581573,1004,4,5564821,44746957,61581573,16834616,56016752,16834616,39182136,0,0
62065521,109,2,960993,44792458,62065521,17273063,61104528,17273063,43831465,0,0
62254653,1058,4,6243469,45195503,62254653,17059150,56011184,17059150,38952034,0,0
63273535,95,2,960939,960939,63273535,62312596,62312596,18214782,44097814,5,0
63802761,696,1,3027713,44251671,63802761,19551090,60775048,19551090,41223958,9,0
63920676,1123,4,6244357,46757999,63920676,17162677,57676319,17162677,40513642,0,0
64505977,554,4,2676502,47276624,64505977,17229353,61829475,17229353,44600122,0,0
64892679,166,2,961194,45793845,64892679,19098834,63931485,19098834,44832651,3,0
65422651,682,1,3027662,44286742,65422651,21135909,62394989,20402440,41992549,10,0
66595685,706,1,3027731,45792235,66595685,20803450,63567954,20671255,42896699,7,0
66627355,129,2,961065,46376966,66627355,20250389,65666290,20250389,45415901,5,0
66797356,440,4,2058951,49121265,66797356,17676091,64738405,17676091,47062314,0,0
67309590,1021,4,5641113,49303164,67309590,18006426,61668477,18006426,43662051,0,0
67432618,668,1,3027628,45926040,67432618,21506578,64404990,21506578,42898412,8,0
67760705,533,4,2394735,49707716,67760705,18052989,65365970,18052989,47312981,0,0
68301116,84,4,810573,50209522,68301116,18091594,67490543,18091594,49398949,0,0
68413222,654,1,3027580,46806741,68413222,21606481,65385642,21606481,43779161,7,0
68805848,492,4,2230283,50496810,68805848,18309038,66575565,18309038,48266527,0,0
69405344,923,4,4442568,50496810,69405344,18908534,64962776,18908534,46054242,0,0
69703182,179,2,961239,48162835,69703182,21540347,68741943,20851722,47890221,5,0
69850217,619,1,3027259,48118706,69850217,21731511,66822958,21731511,45091447,8,0
70712196,217,4,1730177,51049607,70712196,19662589,68982019,19662589,49319430,0,0
71829631,688,1,3027681,48949157,71829631,22880474,68801950,22880474,45921476,9,0
71989807,50,4,343996,343996,71989807,71645811,71645811,20595407,51050404,1,0
72902637,596,1,3027073,49291767,72902637,23610870,69875564,23610870,46264694,8,0
73869096,785,1,3028012,50108571,73869096,23760525,70841084,23760525,47080559,6,0
73893982,494,4,2230294,53304753,73893982,20589229,71663688,20589229,51074459,0,0
75114715,670,1,3027631,51243935,75114715,23870780,72087084,23870780,48216304,4,0
75883955,80,4,810528,810542,75883955,75073413,75073427,21473827,53599600,1,0
76204017,191,2,961280,53096976,76204017,23107041,75242737,23107041,52135696,3,0
76513324,521,4,2230417,54955926,76513324,21557398,74282907,21557398,52725509,0,0
76678464,610,1,3027164,52735167,76678464,23943297,73651300,23943297,49708003,4,0
77498883,728,1,3027872,52735167,77498883,24763716,74471011,23968300,50502711,5,0
78155271,460,4,2059129,55503292,78155271,22651979,76096142,22651979,53444163,0,0
79124673,98,2,960951,54367408,79124673,24757265,78163722,23781664,54382058,3,0
79766766,611,1,3027172,53282295,79766766,26484471,76739594,24781456,51958138,4,0
80200056,1012,4,5640904,57309182,80200056,22890874,74559152,22890874,51668278,0,0
81183411,1008,4,5564840,57427527,81183411,23755884,75618571,23755884,51862687,0,0
81742972,762,1,3027957,55985819,81742972,25757153,78715015,25757153,52957862,2,0
82229701,758,1,3027939,56318006,82229701,25911695,79201762,25911695,53290067,2,0
83285848,1043,4,6077643,58431671,83285848,24854177,77208205,24854177,52354028,0,0
84323342,1115,4,6244220,59340815,84323342,24982527,78079122,24982527,53096595,0,0
84549467,760,1,3027949,56883773,84549467,27665694,81521518,26946758,54574760,7,0
85427013,632,1,3027344,56995267,85427013,28431746,82399669,27069565,55330104,7,0
85610265,1054,4,6243415,59976126,85610265,25634139,79366850,25634139,53732711,0,0
86108544,81,4,810542,60383824,86108544,25724720,85298002,25724720,59573282,0,0
86288408,635,1,3027354,56995267,86288408,29293141,83261054,27096646,56164408,5,0
86867050,383,1,1838952,58352644,86867050,28514406,85028098,27171404,57856694,3,0
87533043,220,4,1730199,61208709,87533043,26324334,85802844,26324334,59478510,0,0
88441232,67,2,769021,769021,88441232,87672211,87672211,27316089,60356122,15,0
88563645,1033,1,6032619,60692458,88563645,27871187,82531026,27871187,54659839,2,0
89471871,197,2,961301,61581573,89471871,27890298,88510570,27890298,60620272,0,0
89927763,110,2,960997,61581573,89927763,28346190,88966766,28346190,60620576,0,0
90585123,677,1,3027645,62065521,90585123,28519602,87557478,28519602,59037876,0,0
91138329,405,2,1900788,62254653,91138329,28883676,89237541,28883676,60353865,0,0
91380630,588,1,3027017,62065521,91380630,29315109,88353613,29315109,59038504,1,0
91477604,155,2,961157,62254653,91477604,29222951,90516447,29222951,61293496,0,0
93157815,508,4,2230360,63920676,93157815,29237139,90927455,29237139,61690316,0,0
93795981,43,4,291317,291317,93795981,93504664,93504664,29809229,63695435,1,0
93843730,748,1,3027919,63273535,93843730,30570195,90815811,30570195,60245616,3,0
94571654,254,2,1743163,63802761,94571654,30768893,92828491,30768893,62059598,3,0
96109472,497,4,2230308,66797356,96109472,29312116,93879164,29312116,64567048,0,0
98464840,1104,4,6244077,67309590,98464840,31155250,92220763,31155250,61065513,0,0
100289352,1038,1,6032653,63273535,100289352,37015817,94256699,35925899,58330800,4,0
101136972,149,2,961136,65422651,101136972,35714321,100175836,35714321,64461515,3,0
101399245,1005,4,5564833,67760705,101399245,33638540,95834412,33638540,62195872,0,0
102133228,527,4,2230442,68301116,102133228,33832112,99902786,33832112,66070674,0,0
103154620,745,1,3027908,64892679,103154620,38261941,100126712,37088907,63037805,6,0
103506396,44,4,343915,343915,103506396,103162481,103162481,35167161,67995320,3,0
103601952,75,2,769128,769128,103601952,102832824,102832824,37166405,65666419,23,0
104467679,907,4,4343650,69405344,104467679,35062335,100124029,35062335,65061694,0,0
105796648,637,1,3027365,67432618,105796648,38364030,102769283,38364030,64405253,5,0
106527092,1002,4,5564816,70712196,106527092,35814896,100962276,35814896,65147380,0,0
107431651,134,2,961082,69703182,107431651,37728469,106470569,37728469,68742100,1,0
107872513,594,1,3027065,68413222,107872513,39459291,104845448,39459291,65386157,5,0
108501137,547,4,2394789,71989807,108501137,36511330,106106348,36511330,69595018,0,0
111187781,444,4,2058983,73893982,111187781,37293799,109128798,37293799,71834999,0,0
111770615,69,2,769060,769060,111770615,111001555,111001555,40079335,70922220,7,0
113476235,218,4,1730179,75883955,113476235,37592280,111746056,37592280,74153776,0,0
113883744,642,1,3027407,69850217,113883744,44033527,110856337,42960521,67895816,4,0
116843690,625,1,3027282,73869096,116843690,42974594,113816408,42974594,70841814,2,0
117569506,420,4,2058826,76513324,117569506,41056182,115510680,41056182,74454498,0,0
118576296,167,2,961197,76204017,118576296,42372279,117615099,42372279,75242820,2,0
119501733,498,4,2230311,78155271,119501733,41346462,117271422,41346462,75924960,0,0
120621269,262,2,1743212,76678464,120621269,43942805,118878057,43942805,74935252,2,0
121748656,450,4,2059028,80200056,121748656,41548600,119689628,41548600,78141028,0,0
122327886,616,1,3027214,75114715,122327886,47213171,119300672,46392752,72907920,6,0
126061479,46,4,343923,343923,126061479,125717556,125717556,45344643,80372913,29,0
126406737,667,1,3027625,79124673,126406737,47282064,123379112,47282064,76097048,1,0
128525989,609,1,3027159,79124673,128525989,49401316,125498830,49401316,76097514,2,0
130893993,704,1,3027727,79766766,130893993,51127227,127866266,51127227,76739039,3,0
131247855,419,4,2058810,83285848,131247855,47962007,129189045,47962007,81227038,0,0
133908565,606,1,3027148,81742972,133908565,52165593,130881417,52165593,78715824,1,0
136217119,608,1,3027156,82229701,136217119,53987418,133189963,53987418,79202545,1,0
141932477,641,1,3027403,84323342,141932477,57609135,138905074,57609135,81295939,0,0
143824594,276,2,1829698,84323342,143824594,59501252,141994896,59501252,82493644,0,0
144547233,628,1,3027310,84323342,144547233,60223891,141519923,60223891,81296032,0,0
144787564,684,1,3027667,84549467,144787564,60238097,141759897,60238097,81521800,0,0
148185073,139,2,961099,85610265,148185073,62574808,147223974,62574808,84649166,0,0
149409831,646,1,3027514,85427013,149409831,63982818,146382317,63982818,82399499,1,0
157234425,522,4,2230420,86108544,157234425,71125881,155004005,71125881,83878124,0,0
159250140,501,4,2230326,87533043,159250140,71717097,157019814,71717097,85302717,0,0
169484160,461,4,2059136,91380630,169484160,78103530,167425024,78103530,89321494,0,0
171581127,589,1,3027020,85610265,171581127,85970862,168554107,85970862,82583245,5,0
171913678,664,1,3027613,85610265,171913678,86303413,168886065,86303413,82582652,6,0
173849835,585,8,2877694,93795981,173849835,80053854,170972141,80053854,90918287,0,0
177000804,229,2,1743052,88441232,177000804,88559572,175257752,88559572,86698180,2,0
179636449,447,4,2059011,91477604,179636449,88158845,177577438,88158845,89418593,0,0
204694979,242,2,1743111,88563645,204694979,116131334,202951868,116131334,86820534,6,0
220917842,113,2,961008,89471871,220917842,131445971,219956834,131445971,88510863,7,0
