time,job_id,num_gpu,submit_time,start_time,end_time,executed_time,JCT,duration,pending_time,preempt,preemption_overhead,promote
10026,1,1,6,6,10026,10020,10020,10000,0,0,0,0
27854,2,1,6,6,27854,27848,27848,27788,0,0,0,0
47492,4,1,10,10,47492,47482,47482,47442,0,0,0,0
51012,24,1,44506,44506,51012,6506,6506,6426,0,0,0,0
71748,8,1,17,17,71748,71731,71731,71711,0,0,0,0
88063,18,1,44488,44488,88063,43575,43575,43515,0,0,0,0
95161,0,1,0,0,95161,95161,95161,95121,0,0,0,0
96525,7,1,14,14,96525,96511,96511,96431,0,0,0,0
138619,11,1,22,22,138619,138597,138597,138497,0,0,0,0
164480,13,1,26,26,164480,164454,164454,164354,0,0,0,0
205886,27,1,44508,44508,205886,161378,161378,161278,0,0,0,0
214611,9,1,18,18,214611,214593,214593,214573,0,0,0,0
227518,32,1,225010,225010,227518,2508,2508,2488,0,0,0,0
233279,30,1,224999,224999,233279,8280,8280,8160,0,0,0,0
249977,22,1,44500,44500,249977,205477,205477,205417,0,0,0,0
283042,15,1,30,30,283042,283012,283012,282992,0,0,0,0
329619,33,1,225012,225012,329619,104607,104607,104567,0,0,0,0
365916,41,4,291313,291313,365916,74603,74603,74483,0,0,0,0
398504,28,1,224994,224994,398504,173510,173510,173390,0,0,0,0
399106,25,1,44507,44507,399106,354599,354599,354579,0,0,0,0
399437,21,1,44498,44498,399437,354939,354939,354879,0,0,0,0
603166,53,4,510191,510191,603166,92975,92975,92915,0,0,0,0
621501,38,4,291295,291295,621501,330206,330206,330086,0,0,0,0
687598,58,4,632338,632338,687598,55260,55260,55260,0,0,0,0
696956,57,4,632336,632336,696956,64620,64620,64520,0,0,0,0
712520,55,4,632320,632320,712520,80200,80200,80100,0,0,0,0
864122,63,2,719754,719754,864122,144368,144368,144288,0,0,0,0
867220,86,4,810604,810619,867220,56601,56616,56461,15,0,0,0
970540,16,1,44477,44477,970540,926063,926063,926043,0,0,0,0
984776,117,2,961023,961023,984776,23753,23753,23673,0,0,0,0
991731,174,2,961222,961222,991731,30509,30509,30389,0,0,0,0
999469,124,2,961048,961048,999469,38421,38421,38311,0,0,0,0
1002536,151,2,961143,961150,1002536,41386,41393,41336,7,0,0,0
1006449,195,2,961295,961295,1006449,45154,45154,44984,0,0,0,0
1012316,181,2,961246,961246,1012316,51070,51070,51020,0,0,0,0
1013544,47,4,343925,343925,1013544,669619,669619,669539,0,0,0,0
1015466,177,2,961233,961298,1015466,54168,54233,54078,65,0,0,0
1016944,126,2,961055,961055,1016944,55889,55889,55829,0,0,0,0
1018821,202,2,961318,961318,1018821,57503,57503,57433,0,0,0,0
1019156,170,2,961208,961208,1019156,57948,57948,57838,0,0,0,0
1022216,199,2,961308,961308,1022216,60908,60908,60778,0,0,0,0
1027100,64,2,719767,719767,1027100,307333,307333,307293,0,0,0,0
1030894,122,2,961041,961041,1030894,69853,69853,69713,0,0,0,0
1033327,212,2,961361,961361,1033327,71966,71966,71896,0,0,0,0
1044254,141,2,961106,961106,1044254,83148,83148,83048,0,0,0,0
1048858,62,2,719748,719748,1048858,329110,329110,329010,0,0,0,0
1049921,65,2,719816,719816,1049921,330105,330105,330045,0,0,0,0
1065104,66,2,719849,719849,1065104,345255,345255,345135,0,0,0,0
1066353,133,2,961078,961078,1066353,105275,105275,105235,0,0,0,0
1073051,156,2,961160,961164,1073051,111887,111891,111787,4,0,0,0
1084671,159,2,961171,961174,1084671,123497,123500,123337,3,0,0,0
1091019,111,2,961001,961001,1091019,130018,130018,129898,0,0,0,0
1103578,23,1,44500,44500,1103578,1059078,1059078,1058998,0,0,0,0
1104721,3,1,6,6,1104721,1104715,1104715,1104675,0,0,0,0
1121580,142,2,961109,961118,1121580,160462,160471,160362,9,0,0,0
1140868,34,1,225015,225015,1140868,915853,915853,915833,0,0,0,0
1194162,168,2,961201,961201,1194162,232961,232961,232861,0,0,0,0
1197859,12,1,25,25,1197859,1197834,1197834,1197774,0,0,0,0
1241979,54,4,510211,510211,1241979,731768,731768,731668,0,0,0,0
1249647,135,2,961086,961086,1249647,288561,288561,288511,0,0,0,0
1270283,17,1,44477,44477,1270283,1225806,1225806,1225706,0,0,0,0
1321697,56,4,632320,632320,1321697,689377,689377,689277,0,0,0,0
1354781,35,1,225016,225016,1354781,1129765,1129765,1129705,0,0,0,0
1370505,116,2,961019,961019,1370505,409486,409486,409436,0,0,0,0
1413706,140,2,961102,961102,1413706,452604,452604,452474,0,0,0,0
1419884,49,4,343982,343982,1419884,1075902,1075902,1075842,0,0,0,0
1448652,171,2,961211,961222,1448652,487430,487441,487330,11,0,0,0
1470710,157,2,961164,961181,1470710,509529,509546,509379,17,0,0,0
1491102,165,2,961191,961201,1491102,529901,529911,529821,10,0,0,0
1513829,144,2,961118,961118,1513829,552711,552711,552591,0,0,0,0
1535275,92,4,810997,867220,1535275,668055,724278,668015,56223,0,0,0
1574734,205,2,961332,961332,1574734,613402,613402,613342,0,0,0,0
1632035,130,2,961069,961072,1632035,670963,670966,670823,3,0,0,0
1635836,118,2,961026,961026,1635836,674810,674810,674670,0,0,0,0
1657988,169,2,961204,961305,1657988,696683,696784,696533,101,0,0,0
1763070,112,2,961004,961004,1763070,802066,802066,801886,0,0,0,0
1786227,247,2,1743130,1743130,1786227,43097,43097,43017,0,0,0,0
1796766,128,2,961062,961062,1796766,835704,835704,835654,0,0,0,0
1799509,193,2,961287,961308,1799509,838201,838222,838071,21,0,0,0
1807667,154,2,961153,961153,1807667,846514,846514,846364,0,0,0,0
1809412,233,2,1743072,1743072,1809412,66340,66340,66210,0,0,0,0
1816333,251,2,1743145,1743145,1816333,73188,73188,73108,0,0,0,0
1820480,238,2,1743092,1743092,1820480,77388,77388,77328,0,0,0,0
1820705,232,2,1743067,1743067,1820705,77638,77638,77588,0,0,0,0
1820801,259,2,1743194,1743194,1820801,77607,77607,77457,0,0,0,0
1854181,291,1,1837969,1837969,1854181,16212,16212,16092,0,0,0,0
1855511,301,1,1838064,1838064,1855511,17447,17447,17387,0,0,0,0
1855996,283,1,1837887,1837887,1855996,18109,18109,18039,0,0,0,0
1860774,382,1,1838943,1838943,1860774,21831,21831,21701,0,0,0,0
1861007,384,1,1838962,1838962,1861007,22045,22045,21965,0,0,0,0
1864065,305,1,1838105,1838105,1864065,25960,25960,25910,0,0,0,0
1867263,296,1,1838014,1838014,1867263,29249,29249,29189,0,0,0,0
1868984,304,1,1838090,1838090,1868984,30894,30894,30814,0,0,0,0
1870597,347,1,1838569,1838569,1870597,32028,32028,31928,0,0,0,0
1871432,286,1,1837922,1837922,1871432,33510,33510,33380,0,0,0,0
1872358,275,2,1829695,1829695,1872358,42663,42663,42593,0,0,0,0
1874002,314,1,1838201,1838201,1874002,35801,35801,35651,0,0,0,0
1874348,315,1,1838219,1838219,1874348,36129,36129,36029,0,0,0,0
1875113,363,1,1838723,1838723,1875113,36390,36390,36300,0,0,0,0
1875773,289,1,1837949,1837949,1875773,37824,37824,37684,0,0,0,0
1876126,321,1,1838276,1838276,1876126,37850,37850,37730,0,0,0,0
1876314,353,1,1838628,1838628,1876314,37686,37686,37566,0,0,0,0
1876374,310,1,1838151,1838151,1876374,38223,38223,38043,0,0,0,0
1878380,328,1,1838357,1838357,1878380,40023,40023,39983,0,0,0,0
1879178,341,1,1838500,1838500,1879178,40678,40678,40548,0,0,0,0
1883297,60,2,719728,719728,1883297,1163569,1163569,1163489,0,0,0,0
1883776,252,2,1743149,1743149,1883776,140627,140627,140567,0,0,0,0
1890721,256,2,1743175,1743175,1890721,147546,147546,147416,0,0,0,0
1892695,356,1,1838662,1838662,1892695,54033,54033,53933,0,0,0,0
1894356,394,1,1892950,1892950,1894356,1406,1406,1256,0,0,0,0
1896100,76,4,810492,810492,1896100,1085608,1085608,1085508,0,0,0,0
1901922,395,1,1893036,1893036,1901922,8886,8886,8796,0,0,0,0
1905226,385,1,1838970,1838970,1905226,66256,66256,66136,0,0,0,0
1905465,354,1,1838637,1838637,1905465,66828,66828,66738,0,0,0,0
1909101,407,2,1900833,1900934,1909101,8167,8268,8007,101,0,0,0
1909266,343,1,1838535,1838535,1909266,70731,70731,70601,0,0,0,0
1911259,313,1,1838185,1838185,1911259,73074,73074,72944,0,0,0,0
1916163,19,1,44488,44488,1916163,1871675,1871675,1871555,0,0,0,0
1916395,307,1,1838123,1838123,1916395,78272,78272,78212,0,0,0,0
1918976,372,1,1838835,1838835,1918976,80141,80141,80051,0,0,0,0
1919307,223,4,1730216,1743219,1919307,176088,189091,175928,13003,0,0,0
1919389,406,2,1900806,1900806,1919389,18583,18583,18493,0,0,0,0
1925912,290,1,1837957,1837957,1925912,87955,87955,87845,0,0,0,0
1927012,198,2,961305,961332,1927012,965680,965707,965540,27,0,0,0
1927689,409,2,1901098,1901098,1927689,26591,26591,26421,0,0,0,0
1939382,398,2,1900661,1900676,1939382,38706,38721,38626,15,0,0,0
1940272,367,1,1838759,1838759,1940272,101513,101513,101483,0,0,0,0
1946761,401,2,1900676,1900719,1946761,46042,46085,45972,43,0,0,0
1948415,266,2,1829632,1829632,1948415,118783,118783,118643,0,0,0,0
1950471,338,1,1838474,1838474,1950471,111997,111997,111827,0,0,0,0
1958797,404,2,1900755,1909101,1958797,49696,58042,49616,8346,0,0,0
1970081,402,2,1900719,1919307,1970081,50774,69362,50674,18588,0,0,0
1974063,210,2,961349,961349,1974063,1012714,1012714,1012564,0,0,0,0
1974525,312,1,1838174,1838174,1974525,136351,136351,136261,0,0,0,0
2016838,246,2,1743125,1743125,2016838,273713,273713,273633,0,0,0,0
2022061,235,2,1743079,1743079,2022061,278982,278982,278922,0,0,0,0
2023564,413,1,1986341,1986341,2023564,37223,37223,37163,0,0,0,0
2027247,380,1,1838925,1838925,2027247,188322,188322,188292,0,0,0,0
2033479,348,1,1838585,1838585,2033479,194894,194894,194804,0,0,0,0
2042575,89,4,810916,810916,2042575,1231659,1231659,1231559,0,0,0,0
2044079,272,2,1829675,1829675,2044079,214404,214404,214364,0,0,0,0
2057025,263,2,1743219,1743219,2057025,313806,313806,313736,0,0,0,0
2066039,392,1,1892825,1892825,2066039,173214,173214,173134,0,0,0,0
2081846,451,4,2059042,2059105,2081846,22741,22804,22561,63,0,0,0
2082055,300,1,1838055,1838055,2082055,244000,244000,243900,0,0,0,0
2090984,269,2,1829653,1829653,2090984,261331,261331,261181,0,0,0,0
2104735,200,2,961312,970540,2104735,1134195,1143423,1134145,9228,0,0,0
2115463,303,1,1838081,1838081,2115463,277382,277382,277312,0,0,0,0
2119942,299,1,1838046,1838046,2119942,281896,281896,281846,0,0,0,0
2122003,426,4,2058866,2081846,2122003,40157,63137,40137,22980,0,0,0
2123248,208,2,961343,984776,2123248,1138472,1161905,1138352,23433,0,0,0
2124066,410,4,1911117,2022061,2124066,102005,212949,101885,110944,0,0,0
2135289,309,1,1838141,1838141,2135289,297148,297148,297078,0,0,0,0
2139771,320,1,1838268,1838268,2139771,301503,301503,301443,0,0,0,0
2154682,83,4,810564,810588,2154682,1344094,1344118,1344014,24,0,0,0
2167641,445,4,2058992,2122003,2167641,45638,108649,45518,63011,0,0,0
2176446,288,1,1837940,1837940,2176446,338506,338506,338446,0,0,0,0
2180294,336,1,1838448,1838448,2180294,341846,341846,341776,0,0,0,0
2181235,393,1,1892933,1892933,2181235,288302,288302,288202,0,0,0,0
2190344,125,2,961051,961062,2190344,1229282,1229293,1229192,11,0,0,0
2207660,265,2,1829629,1829629,2207660,378031,378031,377871,0,0,0,0
2208470,399,2,1900666,1919307,2208470,289163,307804,289043,18641,0,0,0
2216693,457,4,2059102,2124066,2216693,92627,157591,92507,64964,0,0,0
2236367,162,2,961181,961185,2236367,1275182,1275186,1244502,30374,1,290,0
2245553,480,4,2230241,2230395,2245553,15158,15312,15098,154,0,0,0
2245558,484,4,2230255,2230391,2245558,15167,15303,15007,136,0,0,0
2248493,160,2,961174,961185,2248493,1287308,1287319,1248878,38131,1,290,0
2248738,375,1,1838866,1838866,2248738,409872,409872,409752,0,0,0,0
2256124,470,4,2230205,2230219,2256124,25905,25919,25775,14,0,0,0
2266581,477,4,2230229,2245553,2266581,21028,36352,20928,15324,0,0,0
2272525,91,4,810994,810994,2272525,1461531,1461531,1409109,52212,1,280,0
2272851,513,4,2230381,2245558,2272851,27293,42470,27173,15177,0,0,0
2277244,476,4,2230226,2248738,2277244,28506,47018,28386,18512,0,0,0
2279240,302,1,1838073,1838073,2279240,441167,441167,441027,0,0,0,0
2295737,100,2,960960,960960,2295737,1334777,1334777,1293269,41218,1,290,0
2302643,415,4,2058785,2154682,2302643,147961,243858,147841,95897,0,0,0
2311645,366,1,1838750,1838750,2311645,472895,472895,472865,0,0,0,0
2326372,389,1,1839011,1839011,2326372,487361,487361,487231,0,0,0,0
2326905,421,4,2058830,2167641,2326905,159264,268075,159184,108811,0,0,0
2330187,505,4,2230346,2256124,2330187,74063,99841,74023,25778,0,0,0
2338128,137,2,961092,961092,2338128,1377036,1377036,1331392,45144,2,580,0
2344380,472,4,2230212,2266581,2344380,77799,114168,77779,36369,0,0,0
2345425,411,4,1911136,2042575,2345425,302850,434289,302770,131439,0,0,0
2363171,490,4,2230277,2272525,2363171,90646,132894,90586,42248,0,0,0
2374490,295,1,1838005,1838005,2374490,536485,536485,536435,0,0,0,0
2381092,525,4,2230435,2272851,2381092,108241,150657,108121,42416,0,0,0
2385848,334,1,1838416,1838416,2385848,547432,547432,547332,0,0,0,0
2389750,323,1,1838303,1838303,2389750,551447,551447,551267,0,0,0,0
2391330,5,1,11,11,2391330,2391319,2391319,2388099,0,26,5070,0
2392707,337,1,1838466,1838466,2392707,554241,554241,554171,0,0,0,0
2401629,455,4,2059079,2216693,2401629,184936,342550,184896,157614,0,0,0
2408517,146,2,961125,1012316,2408517,1396201,1447392,1396021,51191,2,400,0
2424675,532,4,2394731,2401629,2424675,23046,29944,23026,6898,0,0,0
2431427,520,4,2230413,2277244,2431427,154183,201014,154143,46831,0,0,0
2450083,504,4,2230343,2295737,2450083,154346,219740,154216,65394,0,0,0
2452290,14,1,29,29,2452290,2452261,2452261,2403295,44926,20,1360,0
2460967,297,1,1838022,1838022,2460967,622945,622945,622765,0,0,0,0
2461530,318,1,1838250,1838250,2461530,623280,623280,623150,0,0,0,0
2462784,551,4,2394804,2424675,2462784,38109,67980,37989,29871,0,0,0
2467508,29,1,224997,224997,2467508,2242511,2242511,2187333,54168,5,1390,0
2472051,226,2,1743040,1743040,2472051,729011,729011,728941,0,0,0,0
2497281,364,1,1838732,1838732,2497281,658549,658549,658429,0,0,0,0
2497775,351,1,1838611,1838611,2497775,659164,659164,659034,0,0,0,0
2509531,511,4,2230371,2302643,2509531,206888,279160,206808,72272,0,0,0
2512230,346,1,1838560,1838560,2512230,673670,673670,673540,0,0,0,0
2516500,97,2,960948,960948,2516500,1555552,1555552,1499754,55698,2,380,0
2533617,227,2,1743044,1743044,2533617,790573,790573,790443,0,0,0,0
2537025,237,2,1743086,1743086,2537025,793939,793939,793899,0,0,0,0
2545213,215,4,1730160,1896100,2545213,649113,815053,649033,165940,0,0,0
2550402,287,1,1837931,1837931,2550402,712471,712471,712381,0,0,0,0
2550821,483,4,2230252,2326905,2550821,223916,320569,223796,96653,0,0,0
2555460,464,4,2230184,2330187,2555460,225273,325276,225193,100003,0,0,0
2558723,552,4,2394808,2431427,2558723,127296,163915,127216,36619,0,0,0
2569686,414,4,2058781,2344380,2569686,225306,510905,225266,285599,0,0,0
2582264,280,2,1829720,1829720,2582264,752544,752544,730120,22114,3,330,0
2590913,510,4,2230367,2345425,2590913,245488,360546,245368,115058,0,0,0
2601555,186,2,961263,1018821,2601555,1582734,1640292,1552369,87783,2,140,0
2612445,491,4,2230280,2363171,2612445,249274,382165,249194,132891,0,0,0
2624647,298,1,1838038,1838038,2624647,786609,786609,784679,0,43,3820,0
2634410,273,2,1829683,1829683,2634410,804727,804727,770751,33626,1,150,0
2637201,153,2,961150,1019156,2637201,1618045,1676051,1581579,93692,3,750,0
2637312,496,4,2230304,2381092,2637312,256220,407008,256120,150788,0,0,0
2646116,529,4,2394720,2450083,2646116,196033,251396,195973,55363,0,0,0
2646893,408,2,1900934,1919389,2646893,727504,745959,727404,18455,0,0,0
2648944,482,4,2230248,2385848,2648944,263096,418696,263046,155600,0,0,0
2664545,349,1,1838594,1838594,2664545,825951,825951,807911,15270,35,3010,0
2667823,360,1,1838697,1855511,2667823,812312,829126,810392,16814,8,1140,0
2668552,424,4,2058855,2392707,2668552,275845,609697,275745,333852,0,0,0
2690137,530,4,2394724,2460967,2690137,229170,295413,229070,66243,0,0,0
2713518,225,2,1743036,1743036,2713518,970482,970482,906959,63093,2,880,0
2719241,540,4,2394763,2462784,2719241,256457,324478,256417,68021,0,0,0
2720062,333,1,1838407,1838407,2720062,881655,881655,860427,17368,30,7380,0
2727763,258,2,1743190,1743190,2727763,984573,984573,919463,64560,2,900,0
2765226,560,8,2762368,2764717,2765226,509,2858,479,2349,0,0,0
2765544,194,2,961290,1022216,2765544,1743328,1804254,1659740,144264,4,1030,0
2766035,556,8,2762351,2764786,2766035,1249,3684,1079,2435,0,0,0
2767357,561,8,2764715,2765226,2767357,2131,2642,2011,511,0,0,0
2768866,568,8,2764803,2766035,2768866,2831,4063,2751,1232,0,0,0
2780074,378,1,1838892,1860774,2780074,919300,941182,910742,24940,28,10820,0
2792103,565,8,2764735,2767357,2792103,24746,27368,24646,2622,0,0,0
2794727,557,8,2762365,2768866,2794727,25861,32362,25761,6501,0,0,0
2808576,577,8,2788528,2792103,2808576,16473,20048,16393,3575,0,0,0
2832821,569,8,2764860,2794727,2832821,38094,67961,37974,29867,0,0,0
2838363,285,1,1837914,1837914,2838363,1000449,1000449,955811,30318,73,59360,0
2839875,332,1,1838397,1838397,2839875,1001478,1001478,960583,32985,65,5430,0
2848283,119,2,961030,961030,2848283,1887253,1887253,1726919,157244,26,7140,0
2850735,571,8,2778451,2808576,2850735,42159,72284,42079,30125,0,0,0
2852420,582,8,2842990,2850735,2852420,1685,9430,1685,7745,0,0,0
2854315,26,1,44508,44508,2854315,2809807,2809807,2690105,110072,114,22080,0
2860922,268,2,1829649,1829649,2860922,1031273,1031273,928709,100044,30,11430,0
2869550,579,8,2831118,2832821,2869550,36729,38432,36629,1703,0,0,0
2877331,583,8,2866521,2869550,2877331,7781,10810,7781,3029,0,0,0
2884687,523,4,2230424,2509531,2884687,375156,654263,375096,279107,0,0,0
2901754,574,8,2787624,2852420,2901754,49334,114130,49314,64796,0,0,0
2903242,517,4,2230398,2512230,2903242,391012,672844,390892,281832,0,0,0
2911636,575,8,2787660,2860922,2911636,50714,123976,50604,73262,0,0,0
2928155,10,1,21,21,2928155,2928134,2928134,2788612,121012,117,38220,0
2928592,438,4,2058942,2516500,2928592,412092,869650,411912,457558,0,0,0
2938012,59,2,719719,719719,2938012,2218293,2218293,2016359,190084,51,14700,0
2945341,279,2,1829716,1829716,2945341,1115625,1115625,981202,131813,53,7820,0
2949424,539,4,2394759,2537025,2949424,412399,554665,412289,142266,0,0,0
2951710,578,8,2831097,2877331,2951710,74379,120613,74319,46234,0,0,0
2963633,541,4,2394767,2545213,2963633,418420,568866,418320,150446,0,0,0
2963752,6,1,12,12,2963752,2963740,2963740,2799809,136341,140,52000,0
2988061,581,8,2831155,2901754,2988061,86307,156906,86207,70599,0,0,0
2995827,433,4,2058897,2550402,2995827,445425,936930,445265,491505,0,0,0
2998611,417,4,2058800,2550821,2998611,447790,939811,447670,492021,0,0,0
3007253,489,4,2230273,2555460,3007253,451793,776980,451773,325187,0,0,0
3021955,515,4,2230391,2558723,3021955,463232,791564,463112,328332,0,0,0
3030351,837,1,3028125,3028125,3030351,2226,2226,2126,0,0,0,0
3033640,507,4,2230353,2569686,3033640,463954,803287,463854,339333,0,0,0
3043401,826,1,3028099,3028099,3043401,15302,15302,15202,0,0,0,0
3044134,845,1,3028204,3028204,3044134,15930,15930,15890,0,0,0,0
3049653,846,1,3028215,3028215,3049653,21438,21438,21318,0,0,0,0
3053224,386,1,1838980,1905465,3053224,1147759,1214244,1118769,66485,123,73890,0
3059061,816,1,3028078,3028078,3059061,30983,30983,30943,0,0,0,0
3059868,847,1,3028440,3028440,3059868,31428,31428,31268,0,0,0,0
3063851,809,1,3028064,3028064,3063851,35787,35787,35647,0,0,0,0
3063885,808,1,3028063,3028063,3063885,35822,35822,35702,0,0,0,0
3065004,842,1,3028136,3028136,3065004,36868,36868,36738,0,0,0,0
3072108,812,1,3028070,3028070,3072108,44038,44038,43938,0,0,0,0
3074188,810,1,3028066,3028066,3074188,46122,46122,46022,0,0,0,0
3082408,794,1,3028033,3028033,3082408,54375,54375,54335,0,0,0,0
3082638,741,1,3027899,3027899,3082638,54739,54739,54639,0,0,0,0
3087554,697,1,3027713,3027713,3087554,59841,59841,59701,0,0,0,0
3089175,711,1,3027739,3027739,3089175,61436,61436,61296,0,0,0,0
3089463,692,1,3027697,3027697,3089463,61766,61766,61676,0,0,0,0
3091552,756,1,3027935,3027935,3091552,63617,63617,63517,0,0,0,0
3094955,787,1,3028016,3028016,3094955,66939,66939,66879,0,0,0,0
3100322,782,1,3028004,3028004,3100322,72318,72318,72198,0,0,0,0
3105198,827,1,3028099,3028099,3105198,77099,77099,76969,0,0,0,0
3107451,838,1,3028126,3028126,3107451,79325,79325,79205,0,0,0,0
3111137,834,1,3028117,3028117,3111137,83020,83020,82880,0,0,0,0
3113670,835,1,3028120,3028120,3113670,85550,85550,85410,0,0,0,0
3115572,749,1,3027919,3027919,3115572,87653,87653,87573,0,0,0,0
3121261,848,1,3028452,3028452,3121261,92809,92809,92649,0,0,0,0
3121354,775,1,3027988,3027988,3121354,93366,93366,93306,0,0,0,0
3122970,777,1,3027992,3027992,3122970,94978,94978,94878,0,0,0,0
3124303,713,1,3027778,3027778,3124303,96525,96525,96485,0,0,0,0
3124899,844,1,3028157,3028157,3124899,96742,96742,96682,0,0,0,0
3126652,716,1,3027848,3027848,3126652,98804,98804,98724,0,0,0,0
3129372,759,1,3027943,3027943,3129372,101429,101429,101349,0,0,0,0
3130419,558,8,2762366,2911636,3130419,218783,368053,218763,149270,0,0,0
3131493,703,1,3027724,3027724,3131493,103769,103769,103729,0,0,0,0
3134572,702,1,3027724,3027724,3134572,106848,106848,106818,0,0,0,0
3135379,260,2,1743198,1743198,3135379,1392181,1392181,1239296,135935,140,54720,0
3138627,831,1,3028112,3028112,3138627,110515,110515,110395,0,0,0,0
3138756,724,1,3027864,3027864,3138756,110892,110892,110742,0,0,0,0
3139118,839,1,3028130,3028130,3139118,110988,110988,110848,0,0,0,0
3140375,736,1,3027887,3027887,3140375,112488,112488,112378,0,0,0,0
3143260,755,1,3027931,3027931,3143260,115329,115329,115229,0,0,0,0
3143512,832,1,3028113,3028113,3143512,115399,115399,115259,0,0,0,0
3143571,475,4,2230222,2582264,3143571,561307,913349,561237,352042,0,0,0
3145435,685,1,3027673,3027673,3145435,117762,117762,117652,0,0,0,0
3145902,757,1,3027937,3027937,3145902,117965,117965,117825,0,0,0,0
3151205,725,1,3027866,3027866,3151205,123339,123339,123289,0,0,0,0
3154716,534,4,2394738,2590913,3154716,563803,759978,563703,196175,0,0,0
3155366,371,1,1838825,1909266,3155366,1246100,1316541,1220270,70441,161,18680,0
3158977,843,1,3028139,3028139,3158977,130838,130838,130728,0,0,0,0
3160522,656,1,3027595,3027595,3160522,132927,132927,132807,0,0,0,0
3162065,603,1,3027133,3027133,3162065,134932,134932,134772,0,0,0,0
3164158,715,1,3027819,3027819,3164158,136339,136339,136209,0,0,0,0
3164259,339,1,1838483,1911259,3164259,1253000,1325776,1239110,72776,169,19370,0
3170954,466,4,2230191,2601555,3170954,569399,940763,569259,371364,0,0,0
3176679,564,8,2764726,2928592,3176679,248087,411953,247967,163866,0,0,0
3181140,317,1,1838242,1916163,3181140,1264977,1342898,1257037,77921,182,17720,0
3183074,463,4,2230181,2612445,3183074,570629,952893,570569,382264,0,0,0
3183600,669,1,3027629,3027629,3183600,155971,155971,155841,0,0,0,0
3190086,613,1,3027181,3027181,3190086,162905,162905,162825,0,0,0,0
3193459,708,1,3027735,3027735,3193459,165724,165724,165634,0,0,0,0
3195290,576,8,2788525,2945341,3195290,249949,406765,249899,156816,0,0,0
3201012,597,1,3027091,3027091,3201012,173921,173921,173801,0,0,0,0
3206747,695,1,3027709,3027709,3206747,179038,179038,178988,0,0,0,0
3208485,542,4,2394771,2634410,3208485,574075,813714,573985,239639,0,0,0
3210442,671,1,3027633,3027633,3210442,182809,182809,182679,0,0,0,0
3215721,425,4,2058862,2637312,3215721,578409,1156859,578329,578450,0,0,0
3221639,830,1,3028108,3028108,3221639,193531,193531,193471,0,0,0,0
3231111,474,4,2230219,2646116,3231111,584995,1000892,584875,415897,0,0,0
3233899,253,2,1743159,1743159,3233899,1490740,1490740,1318556,136444,179,19840,0
3246857,567,8,2764786,2951710,3246857,295147,482071,295127,186924,0,0,0
3260203,617,1,3027237,3027237,3260203,232966,232966,232806,0,0,0,0
3272705,636,1,3027362,3027362,3272705,245343,245343,245203,0,0,0,0
3276091,783,1,3028008,3028008,3276091,248083,248083,248043,0,0,0,0
3287852,781,1,3028003,3028003,3287852,259849,259849,257730,1899,1,1240,0
3292278,622,1,3027271,3027271,3292278,265007,265007,259497,5200,1,60,0
3294371,376,1,1838875,1916395,3294371,1377976,1455496,1340461,82945,203,16820,0
3294467,672,1,3027637,3027637,3294467,266830,266830,261234,5436,1,20,0
3302402,825,1,3028095,3028095,3302402,274307,274307,268564,5483,1,40,0
3312762,819,1,3028082,3028082,3312762,284680,284680,269228,15262,1,30,0
3314999,774,1,3027984,3027984,3314999,287015,287015,270847,15998,1,30,0
3323129,771,1,3027980,3027980,3323129,295149,295149,273283,21526,3,120,0
3330862,649,1,3027552,3027552,3330862,303310,303310,277455,25105,3,360,0
3339242,766,1,3027966,3027966,3339242,311276,311276,279548,30948,3,600,0
3339959,620,1,3027263,3027263,3339959,312696,312696,280430,31756,3,390,0
3351144,768,1,3027969,3027969,3351144,323175,323175,286963,35752,2,430,0
3365602,788,1,3028019,3028019,3365602,337583,337583,301247,35786,2,480,0
3370883,761,1,3027957,3027957,3370883,342926,342926,305467,36909,2,300,0
3382441,841,1,3028134,3072108,3382441,310333,354307,310023,43974,1,320,0
3397063,638,1,3027369,3027369,3397063,369694,369694,323198,46106,2,200,0
3403655,439,4,2058946,2648944,3403655,754711,1344709,651892,692297,3,2760,0
3421512,822,1,3028090,3082408,3421512,339104,393422,338904,54318,2,340,0
3430323,660,1,3027602,3027602,3430323,402721,402721,345862,54579,28,2960,0
3438320,397,2,1900657,2016838,3438320,1421482,1537663,1267837,221266,205,29820,0
3459489,322,1,1838284,1918976,3459489,1540513,1621205,1457937,140248,285,23520,0
3469977,20,1,44497,44497,3469977,3425480,3425480,3165582,232008,346,19730,0
3472803,196,2,961298,1048858,3472803,2423945,2511505,2092351,399104,246,27090,0
3511358,555,8,2762344,2988061,3511358,523297,749014,374522,374392,1,290,0
3532783,828,1,3028104,3089463,3532783,443320,504679,442860,61359,5,490,0
3540516,559,8,2762367,2998611,3540516,541905,778149,374522,403577,1,280,0
3551951,840,1,3028131,3091552,3551951,460399,523820,459529,63421,7,1320,0
3564487,531,4,2394727,2668552,3564487,895935,1169760,684768,483642,7,2120,0
3571504,132,2,961075,961075,3571504,2610429,2610429,2163411,436838,238,13630,0
3587099,746,1,3027911,3027966,3587099,559133,559188,491005,67033,14,1750,0
3598573,377,1,1838883,1940272,3598573,1658301,1759690,1505580,229920,300,13770,0
3607482,800,1,3028045,3105198,3607482,502284,579437,499102,79055,9,810,0
3678800,45,4,343918,343918,3678800,3334882,3334882,1934260,1399742,20,3500,0
3679022,815,1,3028075,3107451,3679022,571571,650947,560867,89500,8,1040,0
3698196,131,2,961072,1065104,3698196,2633092,2737124,2202747,523897,239,9650,0
3699015,650,1,3027558,3027558,3699015,671457,671457,569118,95029,32,6060,0
3707393,665,1,3027622,3124899,3707393,582494,679771,581854,97277,6,510,0
3762159,563,8,2764723,3021955,3762159,740204,997436,520970,476416,1,250,0
3769926,856,4,3721511,3721511,3769926,48415,48415,48265,0,0,0,0
3773233,524,4,2230431,2719241,3773233,1053992,1542802,730674,811668,10,2590,0
3779051,861,4,3721529,3721529,3779051,57522,57522,57432,0,0,0,0
3785437,627,1,3027298,3027298,3785437,758139,758139,657192,99277,21,3480,0
3799779,676,1,3027644,3129372,3799779,670407,772135,669987,101728,9,840,0
3803956,621,1,3027267,3027267,3803956,776689,776689,671478,104131,23,2210,0
3822306,868,4,3721559,3721586,3822306,100720,100747,100560,27,0,0,0
3868244,875,1,3867133,3867133,3868244,1111,1111,1011,0,0,0,0
3869996,836,1,3028121,3134572,3869996,735424,841875,733634,106451,8,1530,0
3881510,874,4,3721586,3762159,3881510,119351,159924,119331,40573,0,0,0
3884311,885,4,3873106,3881510,3884311,2801,11205,2801,8404,0,0,0
3887368,779,1,3027995,3138627,3887368,748741,859373,747261,110632,8,1970,0
3887475,880,4,3873036,3884311,3887475,3164,14439,3104,11275,0,0,0
3891829,396,1,1893136,1950471,3891829,1941358,1998693,1570685,354938,311,28440,0
3896371,876,1,3867169,3867169,3896371,29202,29202,29082,0,0,0,0
3901524,860,4,3721525,3721525,3901524,179999,179999,179939,0,0,0,0
3902910,878,4,3873009,3887475,3902910,15435,29901,15335,14466,0,0,0
3912524,894,4,3890341,3901524,3912524,11000,22183,10900,11183,0,0,0
3928162,479,4,2230238,2762368,3928162,1165794,1697924,792011,904643,8,3410,0
3932815,893,4,3890336,3902910,3932815,29905,42479,29785,12574,0,0,0
3939431,814,1,3028074,3139118,3939431,800313,911357,798203,111044,12,1740,0
3942492,821,1,3028086,3140375,3942492,802117,914406,800507,112289,12,1170,0
3944119,883,4,3873097,3912524,3944119,31595,71022,31555,39427,0,0,0
3954229,807,1,3028060,3143260,3954229,810969,926169,808229,115200,12,1500,0
3964710,805,1,3028056,3143512,3964710,821198,936654,814807,119617,10,1310,0
3976116,820,1,3028085,3145435,3976116,830681,948031,821169,125122,7,420,0
3977582,701,1,3027720,3145902,3977582,831680,949862,821383,127499,5,200,0
3980652,871,4,3721571,3762159,3980652,218493,259081,218423,40588,0,0,0
3985607,732,1,3027879,3162065,3985607,823542,957728,822972,134186,4,720,0
3992582,801,1,3028049,3164158,3992582,828424,964533,828064,136109,4,530,0
4008156,884,4,3873101,3928162,4008156,79994,135055,79934,55061,0,0,0
4017387,726,1,3027868,3164259,4017387,853128,989519,852768,136391,4,560,0
4021450,422,4,2058837,3183074,4021450,838376,1962613,838076,1124237,1,620,0
4022196,891,4,3890327,3932815,4022196,89381,131869,89361,42488,0,0,0
4045629,96,2,960944,960944,4045629,3084685,3084685,2251842,789153,223,18230,0
4045676,881,4,3873089,3944119,4045676,101557,172587,101497,71030,0,0,0
4066590,796,1,3028037,3170954,4066590,895636,1038553,895346,142917,6,600,0
4067608,797,1,3028040,3170954,4067608,896654,1039568,895174,142914,7,950,0
4080543,855,4,3721507,3769926,4080543,310617,359036,310537,48419,0,0,0
4090750,562,8,2764717,3511358,4090750,579392,1326033,579352,746641,0,0,0
4114783,879,4,3873028,3980652,4114783,134131,241755,134031,107624,0,0,0
4117295,829,1,3028108,3181140,4117295,936155,1089187,935385,153032,6,600,0
4121795,902,1,4098906,4098906,4121795,22889,22889,22829,0,0,0,0
4149022,587,8,3011382,3540516,4149022,608506,1137640,608466,529134,0,0,0
4153543,753,1,3027927,3183600,4153543,969943,1125616,968723,155673,5,750,0
4172411,886,4,3890306,4008156,4172411,164255,282105,164215,117850,0,0,0
4175119,793,1,3028029,3190086,4175119,985033,1147090,984253,162057,5,630,0
4177750,854,4,3721503,3773233,4177750,404517,456247,404457,51730,0,0,0
4201935,790,1,3028025,3193459,4201935,1008476,1173910,1008086,165434,4,80,0
4203047,887,4,3890310,4021450,4203047,181597,312737,181577,131140,0,0,0
4230856,700,1,3027720,3201012,4230856,1029844,1203136,1029324,173292,3,660,0
4234280,903,8,4131053,4149022,4234280,85258,103227,85178,17969,0,0,0
4237874,512,4,2230378,3215721,4237874,1022153,2007496,1022053,985343,0,0,0
4241517,905,8,4217249,4234280,4241517,7237,24268,7177,17031,0,0,0
4250802,722,1,3027860,3206747,4250802,1044055,1222942,1043335,178887,4,1120,0
4251405,901,8,4047477,4090750,4251405,160655,203928,160535,43273,0,0,0
4284392,850,4,3721489,3779051,4284392,505341,562903,505281,57562,0,0,0
4284533,42,4,291315,291315,4284533,3993218,3993218,2239303,1753435,2,750,0
4304492,898,4,3916185,4022196,4304492,282296,388307,282256,106011,0,0,0
4325661,255,2,1743167,1743167,4325661,2582494,2582494,1591897,973317,140,6420,0
4345631,553,4,2394811,3272705,4345631,1072926,1950820,1072856,877894,0,0,0
4346537,897,4,3916170,4045676,4346537,300861,430367,300821,129506,0,0,0
4353878,909,4,4343680,4345631,4353878,8247,10198,8167,1951,0,0,0
4359639,740,1,3027896,3208485,4359639,1151154,1331743,1150794,180589,8,1760,0
4421393,643,1,3027432,3208485,4421393,1212908,1393961,1210358,181053,11,2280,0
4422083,823,1,3028090,3210442,4422083,1211641,1393993,1210561,182352,11,730,0
4424709,911,4,4348474,4353878,4424709,70831,76235,70811,5404,0,0,0
4439529,851,4,3721493,3822306,4439529,617223,718036,617123,100813,0,0,0
4450866,709,1,3027735,3221639,4450866,1229227,1423131,1227487,193904,11,1910,0
4463475,916,4,4390118,4424709,4463475,38766,73357,38666,34591,0,0,0
4484845,729,1,3027873,3233899,4484845,1250946,1456972,1246710,209412,9,930,0
4494010,446,4,2059007,3403655,4494010,1090355,2435003,1090335,1344648,0,0,0
4496862,928,4,4491981,4491981,4496862,4881,4881,4771,0,0,0,0
4497583,780,1,3027999,3233899,4497583,1263684,1469584,1246827,221047,9,1200,0
4499456,912,8,4349687,4496519,4499456,2937,149769,2887,146832,0,0,0
4500818,931,4,4491995,4491995,4500818,8823,8823,8673,0,0,0,0
4501543,927,4,4491980,4491980,4501543,9563,9563,9423,0,0,0,0
4512843,917,4,4442540,4463475,4512843,49368,70303,49328,20935,0,0,0
4523750,914,4,4387864,4439529,4523750,84221,135886,84161,51665,0,0,0
4533163,882,4,3873093,4067608,4533163,465555,660070,465475,194515,0,0,0
4537244,944,4,4496513,4496513,4537244,40731,40731,40591,0,0,0,0
4540192,954,4,4524626,4533163,4540192,7029,15566,6909,8537,0,0,0
4545516,950,4,4524588,4537244,4545516,8272,20928,8172,12656,0,0,0
4548095,918,4,4442544,4484845,4548095,63250,105551,63160,42301,0,0,0
4548964,951,4,4524591,4540192,4548964,8772,24373,8672,15601,0,0,0
4562474,943,4,4496509,4496862,4562474,65612,65965,65592,353,0,0,0
4563085,935,4,4492021,4494010,4563085,69075,71064,69055,1989,0,0,0
4570193,949,4,4524584,4545516,4570193,24677,45609,24577,20932,0,0,0
4576085,647,1,3027523,3260203,4576085,1315882,1548562,1295049,252253,7,940,0
4580232,906,8,4301307,4499456,4580232,80776,278925,80716,198149,0,0,0
4601785,535,4,2394741,3472803,4601785,1128982,2207044,1128932,1078062,0,0,0
4610720,913,4,4387854,4492004,4610720,118716,222866,118596,104150,0,0,0
4632989,719,1,3027854,3294371,4632989,1338618,1605135,1337368,266517,6,1020,0
4634977,932,4,4492004,4492011,4634977,142966,142973,142856,7,0,0,0
4637710,734,1,3027883,3294467,4637710,1343243,1609827,1342363,266584,6,930,0
4661614,344,1,1838543,2033479,4661614,2628135,2823071,2000840,754101,287,24420,0
4681525,933,4,4492011,4496497,4681525,185028,189514,184848,4486,0,0,0
4687534,652,1,3027573,3312762,4687534,1374772,1659961,1373932,285189,7,950,0
4713661,833,1,3028116,3314999,4713661,1398662,1685545,1397982,286883,8,2080,0
4715544,936,4,4496481,4500818,4715544,214726,219063,214626,4337,0,0,0
4729088,804,1,3028055,3323129,4729088,1405959,1701033,1404159,295074,8,1440,0
4746113,910,4,4348460,4501543,4746113,244570,397653,244550,153083,0,0,0
4773105,733,1,3027881,3330862,4773105,1442243,1745224,1440263,302981,8,1440,0
4785254,852,4,3721496,3869996,4785254,915258,1063758,915148,148500,0,0,0
4787294,228,2,1743049,1743049,4787294,3044245,3044245,1612723,1412382,96,7260,0
4792729,877,4,3873005,4080543,4792729,712186,919724,712066,207538,0,0,0
4796427,959,4,4760871,4785254,4796427,11173,35556,11073,24383,0,0,0
4826808,651,1,3027565,3339242,4826808,1487566,1799243,1472801,322862,15,10890,0
4828884,956,4,4760845,4787294,4828884,41590,68039,41490,26449,0,0,0
4835327,938,4,4496489,4512843,4835327,322484,338838,322364,16354,0,0,0
4839200,960,4,4760876,4792729,4839200,46471,78324,46371,31853,0,0,0
4857901,737,1,3027891,3365602,4857901,1492299,1830010,1486599,337711,28,18980,0
4883440,981,4,4871827,4871827,4883440,11613,11613,11613,0,0,0,0
4889174,973,4,4869973,4869978,4889174,19196,19201,19106,5,0,0,0
4889968,962,4,4869521,4869963,4889968,20005,20447,19885,442,0,0,0
4894116,721,1,3027858,3370883,4894116,1523233,1866258,1519323,343025,46,19370,0
4905015,977,4,4869989,4869989,4905015,35026,35026,34896,0,0,0,0
4907796,940,4,4496497,4523750,4907796,384046,411299,383946,27253,0,0,0
4908643,601,1,3027118,3027118,4908643,1881525,1881525,1521787,355308,52,6080,0
4926495,966,4,4869540,4869992,4926495,56503,56955,56443,452,0,0,0
4940406,982,4,4925426,4926495,4940406,13911,14980,13911,1069,0,0,0
4943853,969,4,4869959,4883440,4943853,60413,73894,60363,13481,0,0,0
4944791,615,1,3027207,3397063,4944791,1547728,1917584,1533768,369856,60,14010,0
4971747,786,1,3028015,3421512,4971747,1550235,1943732,1539075,393497,68,11180,0
4978717,908,4,4343676,4346537,4978717,632180,635041,632080,2861,0,0,0
4991802,573,8,2778479,4241517,4991802,750285,2213323,750205,1463038,0,0,0
4995003,920,4,4442557,4548095,4995003,446908,552446,446808,105538,0,0,0
4995921,896,4,3916165,4114783,4995921,881138,1079756,881058,198618,0,0,0
5008783,614,1,3027195,3430323,5008783,1578460,1981588,1567120,403128,71,5780,0
5009216,970,4,4869963,4883440,5009216,125776,139253,125696,13477,0,0,0
5021144,121,2,961036,961036,5021144,4060108,4060108,2298583,1740205,107,10960,0
5030154,957,4,4760855,4796427,5030154,233727,269299,233667,35572,0,0,0
5061629,978,4,4869992,4883440,5061629,178189,191637,178129,13448,0,0,0
5082274,866,4,3721552,4153543,5082274,928731,1360722,928651,431991,0,0,0
5094412,974,4,4869978,4889174,5094412,205238,224434,205178,19196,0,0,0
5104073,941,4,4496501,4548964,5104073,555109,607572,555009,52463,0,0,0
5113170,798,1,3028041,3459489,5113170,1653681,2085129,1586681,491428,85,7640,0
5121832,925,4,4443293,4562474,5121832,559358,678539,559298,119181,0,0,0
5130972,980,4,4871823,4889968,5130972,241004,259149,240984,18145,0,0,0
5139132,899,4,3916188,4172411,5139132,966721,1222944,966661,256223,0,0,0
5155190,895,4,3916158,4177750,5155190,977440,1239032,977400,261592,0,0,0
5160313,379,1,1838910,2135289,5160313,3025024,3321403,2004790,1289013,227,11730,0
5167790,965,4,4869535,4905015,5167790,262775,298255,262675,35480,0,0,0
5187358,961,4,4760908,4828884,5187358,358474,426450,358454,67976,0,0,0
5234086,975,4,4869981,4907796,5234086,326290,364105,326250,37815,0,0,0
5250265,698,1,3027716,3571504,5250265,1678761,2222549,1662951,543788,100,15400,0
5267088,953,4,4524620,4563085,5267088,704003,742468,703883,38465,0,0,0
5302310,572,8,2778466,4251405,5302310,1050905,2523844,967142,1556652,1,10,0
5306768,921,4,4442561,4570193,5306768,736575,864207,736535,127632,0,0,0
5332938,634,1,3027351,3571504,5332938,1761434,2305587,1719918,572999,105,15720,0
5374779,148,2,961132,1084671,5374779,4290108,4413647,2354580,2051147,95,13990,0
5377739,988,4,5212918,5212918,5377739,164821,164821,164651,0,0,0,0
5389909,919,4,4442549,4601785,5389909,788124,947360,788084,159236,0,0,0
5484780,37,4,291287,291287,5484780,5193493,5193493,2411821,2780832,4,2910,0
5493692,699,1,3027717,3607482,5493692,1886210,2465975,1744544,714531,85,14030,0
5508394,990,4,5451075,5484780,5508394,23614,57319,23494,33705,0,0,0
5563068,996,2,5560659,5560659,5563068,2409,2409,2409,0,0,0,0
5582798,995,2,5560655,5560655,5582798,22143,22143,22043,0,0,0,0
5611277,992,2,5560635,5560635,5611277,50642,50642,50462,0,0,0,0
5650872,979,4,4869996,4940406,5650872,710466,780876,710406,70410,0,0,0
5666446,1006,4,5564836,5582798,5666446,83648,101610,83548,17962,0,0,0
5670315,889,4,3890317,4237874,5670315,1432441,1779998,1289325,490523,1,1020,0
5672062,730,1,3027876,3679022,5672062,1993040,2644186,1764117,872109,98,16450,0
5683773,993,2,5560636,5560636,5683773,123137,123137,123027,0,0,0,0
5685426,989,4,5212922,5212922,5685426,472504,472504,472404,0,0,0,0
5714344,104,2,960974,960974,5714344,4753370,4753370,2401851,2338459,108,8790,0
5722829,1011,4,5640888,5640921,5722829,81908,81941,81778,33,0,0,0
5727009,1022,4,5641116,5650872,5727009,76137,85893,76017,9756,0,0,0
5731022,1026,4,5654163,5654174,5731022,76848,76859,76758,11,0,0,0
5738073,629,1,3027317,3699015,5738073,2039058,2710756,1782664,915822,101,9810,0
5777924,947,4,4496532,4681525,5777924,1096399,1281392,1035686,245406,1,60,0
5783311,1015,4,5640945,5641064,5783311,142247,142366,142187,119,0,0,0
5784656,653,1,3027576,3707393,5784656,2077263,2757080,1795342,935888,110,16710,0
5797082,1014,4,5640943,5654174,5797082,142908,156139,142838,13231,0,0,0
5836448,592,1,3027046,3027046,5836448,2809402,2809402,1830686,959586,119,17150,0
5938000,987,4,5212903,5234086,5938000,703914,725097,703834,21183,0,0,0
5951665,469,4,2230201,3678800,5951665,2272865,3721464,1377293,2343731,3,2370,0
5969967,359,1,1838688,2139771,5969967,3830196,4131279,2041589,2058140,197,23240,0
5999218,991,2,5560622,5560622,5999218,438596,438596,438496,0,0,0,0
6009527,859,4,3721522,4284533,6009527,1724994,2288005,1348823,938942,2,1770,0
6072434,999,4,5564813,5666446,6072434,405988,507621,405948,101633,0,0,0
6086951,1010,4,5640886,5670315,6086951,416636,446065,416516,29429,0,0,0
6141083,1034,1,6032624,6032624,6141083,108459,108459,108389,0,0,0,0
6141350,994,2,5560640,5560640,6141350,580710,580710,580610,0,0,0,0
6148630,467,4,2230194,4304492,6148630,1844138,3918436,1378838,2539468,2,620,0
6161455,983,4,4925447,4995003,6161455,1166452,1236008,1166412,69556,0,0,0
6163486,1039,1,6032659,6032659,6163486,130827,130827,130747,0,0,0,0
6164907,1037,1,6032640,6032640,6164907,132267,132267,132127,0,0,0,0
6194529,984,4,4925477,4995921,6194529,1198608,1269052,1198568,70444,0,0,0
6205039,738,1,3027892,4017387,6205039,2187652,3177147,1936442,1217955,115,12620,0
6214963,986,4,5212828,5267088,6214963,947875,1002135,947795,54260,0,0,0
6250835,1068,4,6243609,6243609,6250835,7226,7226,7136,0,0,0,0
6251411,1044,4,6243278,6243360,6251411,8051,8133,7981,82,0,0,0
6253391,1069,4,6243620,6243632,6253391,9759,9771,9679,12,0,0,0
6257978,1084,4,6243823,6243883,6257978,14095,14155,13925,60,0,0,0
6259773,1078,4,6243744,6243756,6259773,16017,16029,15937,12,0,0,0
6262469,1067,4,6243598,6243644,6262469,18825,18871,18665,46,0,0,0
6267744,1091,4,6243915,6243986,6267744,23758,23829,23638,71,0,0,0
6268469,1079,4,6243756,6243767,6268469,24702,24713,24592,11,0,0,0
6278989,1061,4,6243525,6243525,6278989,35464,35464,35354,0,0,0,0
6280668,1120,4,6244319,6244328,6280668,36340,36349,36210,9,0,0,0
6286915,1081,4,6243778,6243789,6286915,43126,43137,43006,11,0,0,0
6288306,1102,4,6244057,6244057,6288306,44249,44249,44169,0,0,0,0
6293269,1077,4,6243734,6243812,6293269,49457,49535,49397,78,0,0,0
6293991,1048,4,6243329,6243436,6293991,50555,50662,50475,107,0,0,0
6299337,1098,4,6244006,6244006,6299337,55331,55331,55211,0,0,0,0
6305566,1053,4,6243404,6243535,6305566,62031,62162,61941,131,0,0,0
6316634,1029,4,5654178,5685426,6316634,631208,662456,631168,31248,0,0,0
6319106,1097,4,6243996,6243996,6319106,75110,75110,75000,0,0,0,0
6322940,1099,4,6244017,6244037,6322940,78903,78923,78743,20,0,0,0
6330336,1072,4,6243657,6243657,6330336,86679,86679,86609,0,0,0,0
6348437,1065,4,6243576,6243576,6348437,104861,104861,104821,0,0,0,0
6362283,1076,4,6243723,6243723,6362283,118560,118560,118450,0,0,0,0
6380791,1017,4,5641071,5722829,6380791,657962,739720,657842,81758,0,0,0
6395312,857,4,3721514,4839200,6395312,1556112,2673798,1416759,1256939,1,470,0
6400791,1117,4,6244249,6250835,6400791,149956,156542,149856,6586,0,0,0
6430212,1028,4,5654174,5727009,6430212,703203,776038,703083,72835,0,0,0
6431633,102,2,960968,960968,6431633,5470665,5470665,2462520,3000405,91,8630,0
6445766,1040,1,6032665,6032665,6445766,413101,413101,413041,0,0,0,0
6449179,892,4,3890331,5030154,6449179,1419025,2558848,1419005,1139823,0,0,0
6491761,937,4,4496485,5061629,6491761,1430132,1995276,1430072,565144,0,0,0
6494976,1082,4,6243789,6244190,6494976,250786,251187,250716,401,0,0,0
6502624,1119,4,6244298,6251411,6502624,251213,258326,251113,7113,0,0,0
6505992,1070,4,6243632,6243723,6505992,262269,262360,262209,91,0,0,0
6513828,1113,4,6244190,6253391,6513828,260437,269638,260357,9201,0,0,0
6525782,607,1,3027153,4066590,6525782,2459192,3498629,1986952,1485877,110,11040,0
6530665,1124,2,6511338,6511344,6530665,19321,19327,19241,6,0,0,0
6541859,1096,4,6243986,6257978,6541859,283881,297873,283841,13992,0,0,0
6561767,1050,4,6243360,6259773,6561767,301994,318407,301954,16413,0,0,0
6575989,1121,4,6244328,6262469,6575989,313520,331661,313480,18141,0,0,0
6584906,1059,4,6243502,6267744,6584906,317162,341404,317122,24242,0,0,0
6613977,423,4,2058848,5082274,6613977,1531703,4555129,1507312,3047567,1,980,0
6640393,1093,4,6243936,6278989,6640393,361404,396457,361364,35053,0,0,0
6649566,1110,4,6244139,6280668,6649566,368898,405427,368818,36529,0,0,0
6663823,1089,4,6243883,6286915,6663823,376908,419940,376808,43032,0,0,0
6685721,1126,4,6665528,6665528,6685721,20193,20193,20193,0,0,0,0
6688841,478,4,2230234,5094412,6688841,1594429,4458607,1550063,2908294,1,980,0
6705959,1101,4,6244037,6293269,6705959,412690,461922,412590,49232,0,0,0
6709000,79,4,810521,810528,6709000,5898472,5898479,1912884,3984885,3,1530,0
6741694,922,4,4442565,5121832,6741694,1619862,2299129,1564262,734567,1,990,0
6764671,1086,4,6243849,6305566,6764671,459105,520822,459065,61717,0,0,0
6769666,1129,4,6691730,6705959,6769666,63707,77936,63587,14229,0,0,0
6794959,429,4,2058878,5130972,6794959,1663987,4736081,1591159,3144722,1,970,0
6804884,31,1,225000,225000,6804884,6579884,6579884,3533495,3010389,302,52470,0
6841203,434,4,2058920,5139132,6841203,1702071,4782283,1626711,3155322,1,980,0
6859586,1100,4,6244027,6322940,6859586,536646,615559,536546,78913,0,0,0
6868896,976,4,4869985,5155190,6868896,1713706,1998911,1627256,371555,1,950,0
6913802,1080,4,6243767,6348437,6913802,565365,670035,565285,104670,0,0,0
6934523,1020,4,5641096,5731022,6934523,1203501,1293427,1084851,208326,1,890,0
6991348,633,1,3027348,4422083,6991348,2569265,3964000,2060478,1888302,126,30600,0
6997063,1131,4,6691799,6709000,6997063,288063,305264,287963,17201,0,0,0
7006086,1063,4,6243545,6380791,7006086,625295,762541,625195,137246,0,0,0
7023426,74,2,769106,769106,7023426,6254320,6254320,2688813,3541897,148,11110,0
7045867,1046,4,6243298,6395312,7045867,650555,802569,650535,152014,0,0,0
7078839,1083,4,6243812,6400791,7078839,678048,835027,677948,156979,0,0,0
7129409,1056,4,6243436,6430212,7129409,699197,885973,699077,186776,0,0,0
7143728,1125,2,6511344,6511344,7143728,632384,632384,632324,0,0,0,0
7154940,1111,4,6244148,6445766,7154940,709174,910792,709094,201618,0,0,0
7160507,752,1,3027926,4450866,7160507,2709641,4132581,2072895,2039626,125,12440,0
7207662,1013,4,5640921,5777924,7207662,1429738,1566741,1224148,342393,1,1180,0
7233780,1135,2,7184875,7184875,7233780,48905,48905,48755,0,0,0,0
7244856,1036,1,6032634,6032634,7244856,1212222,1212222,1192692,0,81,11280,0
7254856,1114,4,6244210,6491761,7254856,763095,1010646,763035,247551,0,0,0
7264362,1136,2,7184879,7184879,7264362,79483,79483,79323,0,0,0,0
7285198,1016,4,5641064,5783311,7285198,1501887,1644134,1250428,393456,1,1070,0
7324939,1094,4,6243946,6502624,7324939,822315,1080993,822295,258678,0,0,0
7339036,1134,2,7184871,7184871,7339036,154165,154165,154045,0,0,0,0
7352208,1156,8,7351029,7351029,7352208,1179,1179,1009,0,0,0,0
7352242,1152,8,7351008,7351013,7352242,1229,1234,1119,5,0,0,0
7352459,1147,8,7350898,7350909,7352459,1550,1561,1410,11,0,0,0
7352714,1155,8,7351023,7351023,7352714,1691,1691,1571,0,0,0,0
7353080,1158,8,7351039,7351045,7353080,2035,2041,1995,6,0,0,0
7353100,1153,8,7351013,7351039,7353100,2061,2087,1891,26,0,0,0
7355502,1164,8,7351071,7351071,7355502,4431,4431,4291,0,0,0,0
7355726,1143,8,7350869,7351003,7355726,4723,4857,4583,134,0,0,0
7355998,1145,8,7350880,7351050,7355998,4948,5118,4828,170,0,0,0
7356262,1159,8,7351045,7351050,7356262,5212,5217,5112,5,0,0,0
7357440,1149,8,7350914,7351055,7357440,6385,6526,6235,141,0,0,0
7359733,1168,8,7351091,7352208,7359733,7525,8642,7425,1117,0,0,0
7359828,1163,8,7351065,7351065,7359828,8763,8763,8683,0,0,0,0
7375450,985,4,5020124,5167790,7375450,2207660,2355326,1692516,662250,4,2350,0
7376817,1161,8,7351055,7351060,7376817,25757,25762,25637,5,0,0,0
7379992,1150,8,7350920,7351060,7379992,28932,29072,28832,140,0,0,0
7381117,1166,8,7351081,7351086,7381117,30031,30036,29851,5,0,0,0
7385983,1148,8,7350909,7352242,7385983,33741,35074,33631,1333,0,0,0
7389817,1167,8,7351086,7352459,7389817,37358,38731,37338,1373,0,0,0
7394682,1146,8,7350891,7352714,7394682,41968,43791,41928,1823,0,0,0
7397281,1176,1,7363821,7363821,7397281,33460,33460,33360,0,0,0,0
7419118,1116,4,6244240,6541859,7419118,877259,1174878,875769,297619,7,1910,0
7471328,630,1,3027324,5160313,7471328,2311015,4444004,2098094,2315490,153,18090,0
7538645,1169,8,7351095,7353100,7538645,185545,187550,185505,2005,0,0,0
7544114,1170,8,7351101,7355502,7544114,188612,193013,188532,4401,0,0,0
7558939,1128,4,6691705,6741694,7558939,817245,867234,815021,51983,2,400,0
7579873,1151,8,7351003,7355726,7579873,224147,228870,224067,4723,0,0,0
7581678,1160,8,7351050,7355998,7581678,225680,230628,225640,4948,0,0,0
7600827,1180,1,7363956,7363956,7600827,236871,236871,236751,0,0,0,0
7625964,1071,4,6243644,6561767,7625964,1064197,1382320,1058706,323314,1,360,0
7685738,1157,8,7351034,7357440,7685738,328298,334704,328278,6406,0,0,0
7720111,1109,4,6244129,6575989,7720111,1144122,1475982,1138521,337051,2,500,0
7742766,926,4,4443298,5187358,7742766,2555408,3299468,1742891,1555877,4,1010,0
7744749,1141,4,7350124,7350875,7744749,393874,394625,384946,9419,1,40,0
7772168,1142,8,7350492,7359828,7772168,412340,421676,412240,9336,0,0,0
7822321,1075,4,6243713,6613977,7822321,1208344,1578608,1183904,394654,1,310,0
7826448,294,1,1837996,2180294,7826448,5646154,5988452,2139730,3806432,178,18690,0
7850600,1154,8,7351019,7376817,7850600,473783,499581,473663,25798,0,0,0
7856294,1107,4,6244107,6640393,7856294,1215901,1612187,1186769,425218,1,40,0
7871508,1087,4,6243861,6649566,7871508,1221942,1627647,1192870,434637,2,470,0
7885072,1165,8,7351076,7381117,7885072,503955,533996,503875,30041,0,0,0
7902766,1162,8,7351060,7385983,7902766,516783,551706,516743,34923,0,0,0
7920841,72,2,769093,769093,7920841,7151748,7151748,2748946,4390362,79,11740,0
7928191,1057,4,6243446,6663823,7928191,1264368,1684745,1204963,479332,2,220,0
8049089,1074,4,6243703,6764671,8049089,1284418,1805386,1240636,564600,1,720,0
8091309,1118,4,6244268,6769666,8091309,1321643,1847041,1277651,569030,1,60,0
8166607,849,4,3721485,5389909,8166607,2776698,4445122,1765633,2678829,3,1470,0
8203198,1178,1,7363838,7363838,8203198,839360,839360,813049,25861,3,720,0
8240421,1173,1,7363786,7363821,8240421,876600,876635,849621,26014,4,720,0
8389906,1088,4,6243872,6841203,8389906,1548703,2146034,1360908,784926,1,40,0
8421529,1138,2,7184887,7184887,8421529,1236642,1236642,1048737,187585,4,730,0
8460816,763,1,3027961,5683773,8460816,2777043,5432855,2167755,3255480,60,14460,0
8509203,580,8,2831121,5302310,8509203,3206893,5678082,1487822,4189840,2,1750,0
8531242,945,4,4496519,5493692,8531242,3037550,4034723,1774267,2259626,4,2450,0
8585906,680,1,3027652,5714344,8585906,2871562,5558254,2185644,3360680,61,6590,0
8661140,598,1,3027094,5714344,8661140,2946796,5634046,2202509,3428747,56,3530,0
8667876,890,4,3890323,5508394,8667876,3159482,4777553,1841466,2935647,6,1560,0
8669261,1175,1,7363816,7538645,8669261,1130616,1305445,1130006,174829,3,660,0
8728295,1144,8,7350875,7581678,8728295,1146617,1377420,1146597,230803,0,0,0
8760851,674,1,3027641,5738073,8760851,3022778,5733210,2207872,3513268,52,5910,0
8916491,811,1,3028068,5784656,8916491,3131835,5888423,2210896,3675477,43,3610,0
8988356,863,4,3721537,6148630,8988356,2839726,5266819,1873418,3393011,3,90,0
9125017,1172,1,7363782,7579873,9125017,1545144,1761235,1544704,216091,3,960,0
9130067,1112,4,6244159,6997063,9130067,2133004,2885908,1798089,1087619,1,1060,0
9151325,739,1,3027896,5836448,9151325,3314877,6123429,2243204,3869765,53,8860,0
9176679,1019,4,5641080,6194529,9176679,2982150,3535599,1884055,1650814,3,1830,0
9299967,1095,4,6243966,7045867,9299967,2254100,3056001,1884852,1170999,1,900,0
9303676,818,1,3028081,5969967,9303676,3333709,6275595,2247952,4025603,44,2810,0
9363179,972,4,4869970,6214963,9363179,3148216,4493209,1920384,2572225,3,1590,0
9436933,105,2,960978,960978,9436933,8475955,8475955,2686488,5784737,58,3380,0
9468885,1092,4,6243924,7129409,9468885,2339476,3224961,1918061,1306650,1,860,0
9522307,418,4,2058806,7154940,9522307,2367367,7463501,1922419,5540082,4,1650,0
9635772,586,8,2944809,7850600,9635772,1785172,6690963,1785152,4905791,0,0,0
9644120,1041,1,6032670,6205039,9644120,3439081,3611450,2284164,1313896,57,12240,0
9677040,435,4,2058929,7254856,9677040,2422184,7618111,1950472,5667339,1,840,0
9723020,735,1,3027885,7023426,9723020,2699594,6695135,2298019,4389256,40,4790,0
9751045,500,4,2230319,7285198,9751045,2465847,7520726,1959922,5560264,2,1080,0
9806081,1062,4,6243535,7324939,9806081,2481142,3562546,1960459,1602037,1,610,0
9808647,584,8,2867843,7885072,9808647,1923575,6940804,1923475,5017229,0,0,0
9884620,1051,4,6243370,7902766,9884620,1981854,3641250,1981814,1659396,0,0,0
9900299,224,4,1730223,7902766,9900299,1997533,8170076,1997433,6172543,0,0,0
9917407,693,1,3027701,7023426,9917407,2893981,6889706,2356754,4531112,38,890,0
9963544,1140,2,7184900,7233780,9963544,2729764,2778644,2155307,618687,23,2050,0
9963965,495,4,2230301,7928191,9963965,2035774,7733664,2035714,5697890,0,0,0
10160311,1024,4,5654154,8049089,10160311,2111222,4506157,2111162,2394935,0,0,0
10213134,1007,4,5564838,8091309,10213134,2121825,4648296,2121725,2526471,0,0,0
10294582,453,4,2059068,8166607,10294582,2127975,8235514,2127895,6107539,0,0,0
10521024,1090,4,6243906,8389906,10521024,2131118,4277118,2131038,2146000,0,0,0
10531895,1179,1,7363938,8203198,10531895,2328697,3167957,2328157,839260,2,660,0
10647096,964,4,4869530,8509203,10647096,2137893,5777566,2137873,3639673,0,0,0
10664926,248,2,1743133,7143728,10664926,3521198,8921793,2366357,6550586,24,1470,0
10673134,675,1,3027641,7160507,10673134,3512627,7645493,2466052,5176411,24,960,0
10679256,1049,4,6243350,8509203,10679256,2170053,4435906,2169933,2265853,0,0,0
10704454,948,4,4497410,8531242,10704454,2173212,6207044,2173092,4033832,0,0,0
10878641,85,4,810588,960964,10878641,9917677,10068053,2210569,7857134,1,210,0
10919905,284,1,1837896,1837896,10919905,9082009,9082009,2509266,6571023,39,630,0
10961784,485,4,2230258,8728295,10961784,2233489,8731526,2233469,6498037,0,0,0
10989091,872,4,3721578,8728295,10989091,2260796,7267513,2260706,5006717,0,0,0
11155036,71,2,769074,769074,11155036,10385962,10385962,3049319,7335593,22,1990,0
11191720,681,1,3027658,8585906,11191720,2605814,8164062,2604964,5558248,5,740,0
11264705,858,4,3721518,8988356,11264705,2276349,7543187,2276249,5266838,0,0,0
11379595,776,1,3027988,8661140,11379595,2718455,8351607,2626315,5724742,4,390,0
11462116,1023,4,5654150,9130067,11462116,2332049,5807966,2332009,3475917,0,0,0
11512007,219,4,1730194,9176679,11512007,2335328,9781813,2335308,7446485,0,0,0
11554993,679,1,3027651,8916491,11554993,2638502,8527342,2637872,5888840,5,840,0
11671288,1052,4,6243393,9299967,11671288,2371321,5427895,2371301,3056574,0,0,0
11681996,70,2,769060,769060,11681996,10912936,10912936,3049368,7860898,18,2880,0
11752415,1132,4,6691803,9363179,11752415,2389236,5060612,2389116,2671376,0,0,0
11859637,416,4,2058789,9468885,11859637,2390752,9800848,2390672,7410096,0,0,0
11916379,718,1,3027852,9125017,11916379,2791362,8888527,2638381,6249516,5,750,0
11918589,442,4,2058959,9522307,11918589,2396282,9859630,2396202,7463348,0,0,0
12041605,955,4,4738023,9635772,12041605,2405833,7303582,2405733,4897749,0,0,0
12042096,930,4,4491994,9635772,12042096,2406324,7550102,2406234,5143778,0,0,0
12083856,952,4,4524606,9677040,12083856,2406816,7559250,2406736,5152434,0,0,0
12152846,365,1,1838741,9436933,12152846,2715913,10314105,2714813,7598192,5,1630,0
12184242,939,4,4496493,9751045,12184242,2433197,7687749,2433177,5254552,0,0,0
12195062,381,1,1838934,9436933,12195062,2758129,10356128,2756659,7597999,6,600,0
12258995,1108,4,6244118,9806081,12258995,2452914,6014877,2452794,3561963,0,0,0
12264784,544,4,2394778,9808647,12264784,2456137,9870006,2456017,7413869,0,0,0
12313521,888,4,3890313,9808647,12313521,2504874,8423208,2504794,5918334,0,0,0
12396724,1106,4,6244096,9884620,12396724,2512104,6152628,2512024,3640524,0,0,0
12418176,502,4,2230333,9900299,12418176,2517877,10187843,2517777,7669966,0,0,0
12466463,1137,2,7184883,9917407,12466463,2549056,5281580,2548996,2732524,0,0,0
12486261,765,1,3027965,9644120,12486261,2842141,9458296,2841341,6616155,8,1120,0
12495951,1085,4,6243835,9963965,12495951,2531986,6252116,2531966,3720130,0,0,0
12540543,270,2,1829663,9963544,12540543,2576999,10710880,2576939,8133881,1,280,0
12736786,441,4,2058955,10160311,12736786,2576475,10677831,2576355,8101356,0,0,0
12857190,499,4,2230315,10213134,12857190,2644056,10626875,2643956,7982819,0,0,0
12955258,924,4,4442572,10294582,12955258,2660676,8512686,2660596,5852010,0,0,0
13189413,509,4,2230364,10521024,13189413,2668389,10959049,2668349,8290660,0,0,0
13230722,327,1,1838348,9723020,13230722,3507702,11392374,2892194,8499160,6,240,0
13326559,39,4,291300,291300,13326559,13035259,13035259,3349075,9686034,1,120,0
13345736,138,2,961095,1448652,13345736,11897084,12384641,2974364,9409397,15,1410,0
13384303,942,4,4496505,10679256,13384303,2705047,8887798,2705007,6182751,0,0,0
13439028,261,2,1743209,10704454,13439028,2734574,11695819,2734474,8961245,0,0,0
13505697,240,2,1743103,10704454,13505697,2801243,11762594,2801203,8961351,0,0,0
13642347,516,4,2230395,10878641,13642347,2763706,11411952,2763646,8648246,0,0,0
13648667,388,1,1839003,10673134,13648667,2975533,11809664,2975253,8834131,3,240,0
13728873,506,4,2230350,10961784,13728873,2767089,11498523,2767009,8731434,0,0,0
13767548,1060,4,6243513,10989091,13767548,2778457,7524035,2778417,4745578,0,0,0
13908738,691,1,3027692,10919905,13908738,2988833,10881046,2988333,7892213,2,520,0
13974184,120,2,961033,961033,13974184,13013151,13013151,3089300,9921631,15,1740,0
14078702,1000,4,5564814,11264705,14078702,2813997,8513888,2813917,5699891,0,0,0
14235627,658,1,3027598,11191720,14235627,3043907,11208029,3043807,8164122,2,80,0
14300236,1105,4,6244087,11462116,14300236,2838120,8056149,2838100,5218029,0,0,0
14385987,545,4,2394782,11512007,14385987,2873980,11991205,2873860,9117225,0,0,0
14454537,720,1,3027856,11379595,14454537,3074942,11426681,3074442,8351739,2,400,0
14602842,1001,4,5564815,11671288,14602842,2931554,9038027,2931454,6106473,0,0,0
14639768,145,2,961121,1491102,14639768,13148666,13678647,3209002,10468905,13,910,0
14640996,792,1,3028029,11554993,14640996,3086003,11612967,3085903,8526964,2,110,0
14761580,870,4,3721566,11752415,14761580,3009165,11040014,3009125,8030849,0,0,0
14873762,473,4,2230215,11859637,14873762,3014125,12643547,3014085,9629422,0,0,0
14952641,214,4,1730146,11918589,14952641,3034052,13222495,3033972,10188443,0,0,0
15076430,1122,4,6244347,12041605,15076430,3034825,8832083,3034805,5797258,0,0,0
15119569,182,2,961249,1513829,15119569,13605740,14158320,3303871,10851609,17,3980,0
15184502,503,4,2230336,12083856,15184502,3100646,12954166,3100586,9853520,0,0,0
15197891,1031,1,6032585,11916379,15197891,3281512,9165306,3280732,5883794,3,840,0
15292431,1018,4,5641074,12184242,15292431,3108189,9651357,3108069,6543168,0,0,0
15325470,361,1,1838705,12042096,15325470,3283374,13486765,3283074,10203391,2,420,0
15336027,342,1,1838525,12042096,15336027,3293931,13497502,3293571,10203571,2,60,0
15415379,452,4,2059065,12258995,15415379,3156384,13356314,3156304,10199930,0,0,0
15422187,1103,4,6244067,12264784,15422187,3157403,9178120,3157323,6020717,0,0,0
15476935,604,1,3027141,12152846,15476935,3324089,12449794,3323749,9125705,4,620,0
15507488,929,4,4491989,12313521,15507488,3193967,11015499,3193847,7821532,0,0,0
15548677,723,1,3027862,12195062,15548677,3353615,12520815,3352895,9167200,3,600,0
15606857,143,2,961114,1574734,15606857,14032123,14645743,3374608,11267295,16,3180,0
15675846,243,2,1743115,12396724,15675846,3279122,13932731,3279022,10653609,0,0,0
15709885,278,2,1829707,12418176,15709885,3291709,13880178,3291629,10588469,0,0,0
15785534,152,2,961147,1632035,15785534,14153499,14824387,3475787,11346020,16,1240,0
15943152,1025,4,5654159,12495951,15943152,3447201,10288993,3447081,6841792,0,0,0
15968654,456,2,2059091,12466463,15968654,3502191,13909563,3501891,10407372,2,420,0
16030492,306,1,1838115,12486261,16030492,3544231,14192377,3543691,10648146,2,480,0
16117526,648,1,3027529,12540543,16117526,3576983,13089997,3576923,9513014,0,0,0
16132444,1032,1,6032613,12540543,16132444,3591901,10099831,3591741,6507930,0,0,0
16196697,548,4,2394792,12736786,16196697,3459911,13801905,3459851,10341994,0,0,0
16422115,192,2,961283,1635836,16422115,14786279,15460832,3669869,11788703,14,560,0
16493059,264,2,1829625,12857190,16493059,3635869,14663434,3635849,11027565,0,0,0
16615044,448,4,2059015,12955258,16615044,3659786,14556029,3659726,10896243,0,0,0
16852384,267,2,1829645,13189413,16852384,3662971,15022739,3662891,11359768,0,0,0
16853314,106,2,960981,960981,16853314,15892333,15892333,3747881,12143332,13,260,0
16911380,712,1,3027753,13230722,16911380,3680658,13883627,3680618,10202969,0,0,0
17024198,1027,4,5654167,13326559,17024198,3697639,11370031,3697559,7672392,0,0,0
17061260,308,1,1838132,13345736,17061260,3715524,15223128,3715504,11507604,0,0,0
17065159,292,1,1837978,13345736,17065159,3719423,15227181,3719303,11507758,0,0,0
17126466,1174,1,7363790,13384303,17126466,3742163,9762676,3742083,6020513,0,0,0
17147844,803,1,3028053,13384303,17147844,3763541,14119791,3763461,10356250,0,0,0
17178490,623,1,3027274,13384303,17178490,3794187,14151216,3794107,10357029,0,0,0
17259354,661,1,3027603,13384303,17259354,3875051,14231751,3874871,10356700,1,120,0
17272011,971,4,4869966,13505697,17272011,3766314,12402045,3766224,8635731,0,0,0
17445971,518,4,2230401,13642347,17445971,3803624,15215570,3803504,11411946,0,0,0
17636951,293,1,1837987,13648667,17636951,3988284,15798964,3988184,11810680,0,0,0
17648262,147,2,961129,13439028,17648262,4209234,16687133,3986008,12701075,1,40,0
17737238,605,1,3027145,13728873,17737238,4008365,14710093,4008265,10701728,0,0,0
17791725,546,4,2394785,13767548,17791725,4024177,15396940,4024117,11372763,0,0,0
17802139,599,1,3027101,13728873,17802139,4073266,14775038,4072966,10701772,1,230,0
18014717,817,1,3028079,13908738,18014717,4105979,14986638,4105939,10880659,0,0,0
18071622,61,2,719742,719742,18071622,17351880,17351880,4338676,13013154,1,10,0
18132665,1003,4,5564821,14078702,18132665,4053963,12567844,4053883,8513881,0,0,0
18417033,180,2,961242,14300236,18417033,4116797,17455791,4116677,13338994,0,0,0
18431240,368,1,1838789,14235627,18431240,4195613,16592451,4195463,12396838,1,120,0
18520027,802,1,3028049,14300236,18520027,4219791,15491978,4219731,11272187,0,0,0
18524941,997,4,5564794,14385987,18524941,4138954,12960147,4138874,8821193,0,0,0
18556619,335,1,1838434,14300236,18556619,4256383,16718185,4256293,12461802,1,40,0
18804124,600,1,3027113,14454537,18804124,4349587,15777011,4349487,11427424,0,0,0
18809720,963,4,4869525,14602842,18809720,4206878,13940195,4206838,9733317,0,0,0
18883239,281,2,1829724,14639768,18883239,4243471,17053515,4243351,12810044,1,80,0
18997680,82,4,810548,14761580,18997680,4236100,18187132,4235980,13951032,0,0,0
19040156,659,1,3027599,14640996,19040156,4399160,16012557,4398980,11613397,1,270,0
19236245,108,2,960989,960989,19236245,18275256,18275256,4362170,13912736,2,200,0
19238996,101,2,960964,960964,19238996,18278032,18278032,4365113,13912739,2,50,0
19374925,934,4,4492019,14952641,19374925,4422284,14882906,4422244,10460622,0,0,0
19507804,602,1,3027122,15076430,19507804,4431374,16480682,4431274,12049308,0,0,0
19515217,163,2,961185,15076430,19515217,4438787,18554032,4438687,14115245,0,0,0
19631141,172,2,961215,15119569,19631141,4511572,18669926,4511552,14158354,0,0,0
19669824,311,1,1838162,15076430,19669824,4593394,17831662,4593214,13238268,1,120,0
19670665,493,4,2230287,15184502,19670665,4486163,17440378,4486083,12954215,0,0,0
19778746,87,4,810619,15292431,19778746,4486315,18968127,4486215,14481812,0,0,0
19908195,216,4,1730161,15415379,19908195,4492816,18178034,4492756,13685218,0,0,0
19941054,773,1,3027984,15197891,19941054,4743163,16913070,4743023,12169907,3,150,0
19977645,864,4,3721545,15422187,19977645,4555458,16256100,4555438,11700642,0,0,0
20126898,526,4,2230439,15507488,20126898,4619410,17896459,4619370,13277049,0,0,0
20206345,824,1,3028094,15325470,20206345,4880875,17178251,4880655,12297376,5,920,0
20348405,770,1,3027973,15336027,20348405,5012378,17320432,5011128,12308054,6,960,0
20356076,536,4,2394749,15675846,20356076,4680230,17961327,4680080,13281097,0,0,0
20407305,93,2,960932,960932,20407305,19446373,19446373,4856485,14587658,9,1950,0
20477076,900,4,3916193,15785534,20477076,4691542,16560883,4691472,11869341,0,0,0
20685316,282,2,1829727,15606857,20685316,5078459,18855589,4886562,13968787,2,300,0
20894000,362,1,1838714,15476935,20894000,5417065,19055286,5022090,14032696,2,100,0
20978400,234,2,1743075,15968654,20978400,5009746,19235325,5009646,14225579,0,0,0
20984603,319,1,1838258,15943152,20984603,5041451,19146345,5041181,14104894,2,240,0
21087981,1042,4,6077631,16196697,21087981,4891284,15010350,4891184,10119066,0,0,0
21109757,813,1,3028071,16030492,21109757,5079265,18081686,5079055,13002421,2,280,0
21215454,387,1,1838994,16117526,21215454,5097928,19376460,5097508,14278532,2,290,0
21251796,1035,1,6032629,16132444,21251796,5119352,15219167,5119172,10099815,1,30,0
21445854,249,2,1743137,16422115,21445854,5023739,19702717,5023619,14678978,0,0,0
21581807,862,4,3721533,16615044,21581807,4966763,17860274,4966663,12893511,0,0,0
21633779,350,1,1838603,16493059,21633779,5140720,19795176,5140600,14654456,0,0,0
21657977,789,1,3028019,16493059,21657977,5164918,18629958,5164858,13465040,1,40,0
21883007,430,4,2058882,16853314,21883007,5029693,19824125,5029553,14794432,0,0,0
22083965,791,1,3028025,16852384,22083965,5231581,19055940,5173315,13882425,1,190,0
22096026,1045,4,6243288,17024198,22096026,5071828,15852738,5071808,10780910,0,0,0
22266842,764,1,3027961,16852384,22266842,5414458,19238881,5206422,14032369,2,50,0
22287640,686,1,3027677,17065159,22287640,5222481,19259963,5222121,14037482,1,240,0
22354525,412,4,1911159,17272011,22354525,5082514,20443366,5082434,15360852,0,0,0
22434803,178,2,961236,17147844,22434803,5286959,21473567,5286579,16186608,1,300,0
22474961,316,1,1838230,17126466,22474961,5348495,20636731,5317669,15318882,2,100,0
22664106,624,1,3027278,17259354,22664106,5404752,19636828,5404692,14232076,1,40,0
22684239,958,4,4760861,17445971,22684239,5238268,17923378,5238208,12685110,0,0,0
22999842,68,2,769058,769058,22999842,22230784,22230784,5543106,16687258,5,460,0
23061160,465,4,2230187,17791725,23061160,5269435,20830973,5269355,15561538,0,0,0
23154400,257,2,1743187,17802139,23154400,5352261,21411213,5352141,16058952,0,0,0
23214366,657,1,3027595,17636951,23214366,5577415,20186771,5577055,14609356,4,620,0
23451615,241,2,1743106,18071622,23451615,5379993,21708509,5379913,16328516,0,0,0
23510170,458,4,2059105,18132665,23510170,5377505,21451065,5377425,16073560,0,0,0
23585566,705,1,3027728,17737238,23585566,5848328,20557838,5635050,14922088,4,400,0
23859488,184,2,961256,18417033,23859488,5442455,22898232,5442415,17455777,0,0,0
24057108,449,4,2059019,18524941,24057108,5532167,21998089,5532127,16465922,0,0,0
24128229,107,2,960985,960985,24128229,23167244,23167244,5607708,17559026,5,250,0
24346461,593,1,3027057,18431240,24346461,5915221,21319404,5878479,15440775,1,90,0
24396530,528,4,2394716,18809720,24396530,5586810,22001814,5586750,16415004,0,0,0
24601256,188,2,961270,18883239,24601256,5718017,23639986,5717927,17921969,0,0,0
24763892,432,4,2058893,18997680,24763892,5766212,22704999,5766132,16938787,0,0,0
24833806,1171,1,7363777,18804124,24833806,6029682,17470029,6029552,11440347,3,120,0
25252847,869,4,3721563,19374925,25252847,5877922,21531284,5877882,15653362,0,0,0
25265616,673,1,3027637,19040156,25265616,6225460,22237979,6225310,16012519,1,120,0
25545124,806,1,3028059,19236245,25545124,6308879,22517065,6308479,16208186,2,740,0
25561151,161,2,961178,19238996,25561151,6322155,24599973,6321555,18277818,2,420,0
25581541,329,1,1838366,19236245,25581541,6345296,23743175,6344586,17397879,4,340,0
25654415,443,4,2058968,19670665,25654415,5983750,23595447,5983690,17611697,0,0,0
25858891,655,1,3027588,19507804,25858891,6351087,22831303,6350947,16480216,1,20,0
25975013,391,1,1839029,19515217,25975013,6459796,24135984,6459656,17676188,3,1020,0
26015547,427,4,2058870,19778746,26015547,6236801,23956677,6236741,17719876,0,0,0
26153785,436,4,2058934,19908195,26153785,6245590,24094851,6245570,17849261,0,0,0
26208610,213,2,961366,19631141,26208610,6577469,25247244,6576909,18669775,3,540,0
26363660,707,1,3027731,19515217,26363660,6848443,23335929,6847163,16487486,5,600,0
26615403,330,1,1838379,19669824,26615403,6945579,24777024,6944839,17831445,4,280,0
26670890,1009,4,5640885,19977645,26670890,6693245,21030005,6693205,14336760,0,0,0
26855927,543,4,2394774,20126898,26855927,6729029,24461153,6729009,17732124,0,0,0
26957445,369,1,1838798,19941054,26957445,7016391,25118647,7016221,18102256,3,120,0
27263784,867,4,3721556,20356076,27263784,6907708,23542228,6907628,16634520,0,0,0
27281417,799,1,3028044,20206345,27281417,7075072,24253373,7074462,17178301,2,600,0
27549053,245,2,1743121,20407305,27549053,7141748,25805932,7141668,18664184,0,0,0
27617416,352,1,1838619,20348405,27617416,7269011,25778797,7268451,18509786,3,360,0
27656125,462,4,2230177,20477076,27656125,7179049,25425948,7178929,18246899,1,80,0
27877383,189,2,961273,20685316,27877383,7192067,26916110,7191707,19724043,1,240,0
28333866,358,1,1838680,20894000,28333866,7439866,26495186,7439686,19055320,2,490,0
28351726,550,4,2394800,21087981,28351726,7263745,25956926,7263645,18693181,0,0,0
28440338,644,1,3027492,20978400,28440338,7461938,25412846,7461438,17950908,2,580,0
28472411,373,1,1838843,20978400,28472411,7494011,26633568,7493211,19139557,3,510,0
28523009,639,1,3027388,20984603,28523009,7538406,25495621,7537896,17957215,2,100,0
28621251,183,2,961253,21215454,28621251,7405797,27659998,7405397,20254201,1,360,0
28726896,1177,1,7363825,21109757,28726896,7617139,21363071,7580427,13782274,2,200,0
28893181,514,4,2230385,21581807,28893181,7311374,26662796,7311334,19351422,0,0,0
29140475,640,1,3027400,21445854,29140475,7694621,26113075,7694481,18418454,3,420,0
29148973,595,1,3027069,21445854,29148973,7703119,26121904,7702689,18418785,3,90,0
29231405,1066,4,6243588,21883007,29231405,7348398,22987817,7348318,15639419,0,0,0
29352124,727,1,3027870,21633779,29352124,7718345,26324254,7718225,18605909,2,110,0
29428503,772,1,3027981,21657977,29428503,7770526,26400522,7770336,18629996,2,100,0
29462173,468,4,2230198,22096026,29462173,7366147,27231975,7366107,19865828,0,0,0
29903118,326,1,1838339,22083965,29903118,7819153,28064779,7818773,20245626,2,320,0
29978415,471,4,2230208,22354525,29978415,7623890,27748207,7623810,20124317,0,0,0
30064542,274,2,1829691,22434803,30064542,7629739,28234851,7629659,20605112,0,0,0
30088180,795,1,3028033,22266842,30088180,7821338,27060147,7821038,19238809,3,480,0
30194122,689,1,3027688,22287640,30194122,7906482,27166434,7905942,19259952,3,240,0
30340185,201,2,961315,22684239,30340185,7655946,29378870,7655866,21722924,0,0,0
30348444,206,2,961336,22684239,30348444,7664205,29387108,7664165,21722903,0,0,0
30524499,769,1,3027972,22474961,30524499,8049538,27496527,8049318,19446989,2,310,0
30748761,549,4,2394796,23061160,30748761,7687601,28353965,7687561,20666364,0,0,0
31020555,271,2,1829671,22999842,31020555,8020713,29190884,8020533,21170171,1,270,0
31091833,666,1,3027624,22664106,31091833,8427727,28064209,8426857,19636482,4,500,0
31606878,537,4,2394752,23510170,31606878,8096708,29212126,8096588,21115418,0,0,0
31842565,1139,2,7184896,23451615,31842565,8390950,24657669,8390770,16266719,1,450,0
31850386,355,1,1838653,23154400,31850386,8695986,30011733,8695266,21315747,4,1030,0
31859467,714,1,3027797,23154400,31859467,8705067,28831670,8704507,20126603,4,120,0
32204908,1047,4,6243319,24057108,32204908,8147800,25961589,8147740,17813789,0,0,0
32246461,324,1,1838312,23214366,32246461,9032095,30408149,9031425,21376054,4,460,0
32586129,487,4,2230265,24396530,32586129,8189599,30355864,8189519,22166265,0,0,0
32718426,150,2,961140,24128229,32718426,8590197,31757286,8589837,23167089,1,590,0
32822830,345,1,1838551,23585566,32822830,9237264,30984279,9236024,21747015,5,1620,0
33048058,459,4,2059109,24763892,33048058,8284166,30988949,8284086,22704783,0,0,0
33159782,1130,4,6691785,24833806,33159782,8325976,26467997,8325806,18142021,0,0,0
33305785,357,1,1838671,23859488,33305785,9446297,31467114,9445737,22020817,6,990,0
33546153,683,1,3027666,23859488,33546153,9686665,30518487,9685005,20831822,8,1000,0
34009044,123,2,961045,24601256,34009044,9407788,33047999,8988097,24059252,3,510,0
34098415,77,4,810498,810513,34098415,33287902,33287917,8687549,24600188,1,380,0
34221448,78,4,810513,810542,34221448,33410906,33410935,8717369,24693476,1,250,0
34611564,52,4,510176,510176,34611564,34101388,34101388,9046555,25054583,1,260,0
34667809,754,1,3027930,24346461,34667809,10321348,31639879,9900317,21737572,10,2150,0
34778991,40,4,291309,291309,34778991,34487682,34487682,9294745,25192837,1,350,0
35243941,678,1,3027647,25252847,35243941,9991094,32216294,9990354,22225200,8,910,0
35408824,481,4,2230245,26670890,35408824,8737934,33178579,8737874,24440645,0,0,0
35489282,187,2,961267,26208610,35489282,9280672,34528015,9280612,25247343,0,0,0
35513528,694,1,3027709,25265616,35513528,10247912,32485819,10226242,22258297,8,1040,0
36109582,865,4,3721548,26855927,36109582,9253655,32388034,9253575,23134379,0,0,0
36262203,73,2,769100,769100,36262203,35493103,35493103,9494037,25996456,17,3800,0
36405536,590,1,3027031,25545124,36405536,10860412,33378505,10562162,22815833,10,1750,0
36523092,1030,4,5654182,27263784,36523092,9259308,30868910,9259228,21609602,0,0,0
36962010,400,2,1900669,27549053,36962010,9412957,35061341,9412937,25648384,0,0,0
37010677,437,4,2058938,27656125,37010677,9354552,34951739,9354512,25597187,0,0,0
37115459,784,1,3028008,25975013,37115459,11140446,34087451,11137876,22947005,11,1590,0
37620103,370,1,1838817,26363660,37620103,11256443,35781286,11255223,24524843,9,600,0
37818834,175,2,961225,27877383,37818834,9941451,36857609,9941411,26916158,0,0,0
37869985,967,4,4869543,28351726,37869985,9518259,33000442,9518159,23482183,0,0,0
38297934,325,1,1838320,26615403,38297934,11682531,36459614,11357669,25101055,10,680,0
38622012,176,2,961229,28440338,38622012,10181674,37660783,10180764,27479109,4,1340,0
38662028,36,4,291278,291278,38662028,38370750,38370750,10288513,28082187,1,220,0
38913172,209,2,961346,28523009,38913172,10390163,37951826,10389843,27561663,3,360,0
38993469,742,1,3027900,27617416,38993469,11376053,35965569,11375593,24589516,10,100,0
39066288,250,2,1743140,28621251,39066288,10445037,37323148,10444677,26878111,4,440,0
39083342,853,4,3721500,29231405,39083342,9851937,35361842,9851877,25509905,0,0,0
39097165,570,8,2778450,33048058,39097165,6049107,36318715,6049087,30269608,0,0,0
39235974,222,4,1730215,29352124,39235974,9883850,37505759,9883630,27621909,1,240,0
39585336,1073,4,6243683,29462173,39585336,10123163,33341653,10123043,23218490,0,0,0
40062321,744,1,3027906,28333866,40062321,11728455,37034415,11406248,25626797,9,600,0
40389341,203,2,961325,29140475,40389341,11248866,39428016,10622015,28805441,3,360,0
40625496,236,2,1743083,29978415,40625496,10647081,38882413,10646591,28235332,2,690,0
41009738,94,2,960936,960936,41009738,40048802,40048802,10943195,29103557,16,1110,0
41033616,90,4,810916,30524499,41033616,10509117,40222700,10509017,29713583,0,0,0
41063462,211,2,961356,30088180,41063462,10975282,40102106,10974742,29126824,3,600,0
41579544,173,2,961218,30340185,41579544,11239359,40618326,11238569,29378967,3,720,0
41879632,103,2,960971,960971,41879632,40918661,40918661,11306132,29611729,4,470,0
41895341,743,1,3027903,29903118,41895341,11992223,38867438,11661639,27205419,7,220,0
42448450,915,4,4390097,31606878,42448450,10841572,38058353,10841532,27216781,0,0,0
42584464,767,1,3027969,30748761,42584464,11835703,39556495,11835233,27720792,3,630,0
42615837,230,2,1743056,31020555,42615837,11595282,40872781,11594602,29277499,3,360,0
42962507,778,1,3027993,31091833,42962507,11870674,39934514,11870304,28063840,4,440,0
43174020,486,4,2230262,32204908,43174020,10969112,40943758,10969072,29974646,0,0,0
43658940,239,2,1743099,31842565,43658940,11816375,41915841,11815905,30099466,3,390,0
43887323,717,1,3027850,31850386,43887323,12036937,40859473,12036657,28822536,3,270,0
44012685,431,4,2058890,32586129,44012685,11426556,41953795,11426516,30527239,0,0,0
44472335,946,4,4496524,32822830,44472335,11649505,39975811,11537681,28438030,1,160,0
44477415,662,1,3027607,31859467,44477415,12617948,41449808,12616278,28831860,8,1660,0
45905940,99,2,960956,960956,45905940,44944984,44944984,12001051,32943673,4,40,0
45962908,48,4,343968,343968,45962908,45618940,45618940,12331341,33287499,1,230,0
46032872,751,1,3027923,32246461,46032872,13786411,43004949,13302256,29701493,6,1200,0
46250952,231,2,1743063,34221448,46250952,12029504,44507889,12029384,32478385,0,0,0
46701798,136,2,961089,34221448,46701798,12480350,45740709,12480310,33260359,0,0,0
46957635,340,1,1838492,33546153,46957635,13411482,45119143,13410412,31707661,4,600,0
47160260,998,4,5564802,34778991,47160260,12381269,41595458,12381189,29214189,0,0,0
47570597,403,2,1900746,34611564,47570597,12959033,45669851,12958633,32710818,2,770,0
47923421,428,4,2058874,35408824,47923421,12514597,45864547,12514537,33349950,0,0,0
48114273,331,1,1838389,34611564,48114273,13502709,46275884,13502189,32773175,3,390,0
48196068,710,1,3027739,34611564,48196068,13584504,45168329,13584084,31583825,4,290,0
49067667,968,4,4869549,36109582,49067667,12958085,44198118,12958005,31240033,0,0,0
49069307,645,1,3027511,34667809,49069307,14401498,46041796,14400888,31640298,5,480,0
49211376,164,2,961188,35513528,49211376,13697848,48250188,13697518,34552340,1,290,0
49503548,88,4,810624,36523092,49503548,12980456,48692924,12980336,35712468,0,0,0
49567735,566,8,2764771,39097165,49567735,10470570,46802964,10470550,36332394,0,0,0
49933847,663,1,3027610,35243941,49933847,14689906,46906237,14689346,32216331,7,680,0
50126916,221,4,1730202,37010677,50126916,13116239,48396714,13116159,35280475,0,0,0
50169646,244,2,1743118,36405536,50169646,13764110,48426528,13763490,34662418,2,360,0
50526760,618,1,3027241,35489282,50526760,15037478,47499519,15037118,32462041,8,650,0
50771925,158,2,961168,36962010,50771925,13809915,49810757,13809315,36000842,2,120,0
51140086,519,4,2230405,37869985,51140086,13270101,48909681,13270001,35639580,0,0,0
51408778,374,1,1838858,35489282,51408778,15919496,49569920,15170441,34399099,8,440,0
51823639,277,2,1829702,37818834,51823639,14004805,49993937,14004745,35989132,1,250,0
52176434,687,1,3027680,36262203,52176434,15914231,49148754,15203688,33944446,5,360,0
52280058,488,4,2230269,38662028,52280058,13618030,50049789,13617910,36431759,0,0,0
52649575,185,2,961259,38622012,52649575,14027563,51688316,14027203,37660753,1,480,0
52826885,690,1,3027690,37620103,52826885,15206782,49799195,15205752,34592413,6,720,0
53050519,190,2,961277,38913172,53050519,14137347,52089242,14137107,37951895,1,280,0
53550829,750,1,3027923,38297934,53550829,15252895,50522906,15251975,35270011,5,440,0
53699004,204,2,961329,39066288,53699004,14632716,52737675,14632416,38104959,1,360,0
54058281,1055,4,6243426,39235974,54058281,14822307,47814855,14822207,32992548,0,0,0
54087340,1133,2,7184850,39083342,54087340,15003998,46902490,15003698,31898492,1,410,0
54505669,51,4,343999,343999,54505669,54161670,54161670,15386853,38774717,1,230,0
54532448,207,2,961339,39083342,54532448,15449106,53571109,15448626,38122003,3,570,0
54812251,390,1,1839020,38993469,54812251,15818782,52973231,15817742,37154449,6,360,0
56069410,591,1,3027043,40062321,56069410,16007089,53042367,16006929,37035278,1,80,0
56655361,127,2,961058,40389341,56655361,16266020,55694303,16265970,39428283,1,40,0
56656869,538,4,2394756,41033616,56656869,15623253,54262113,15623173,38638860,0,0,0
57048185,731,1,3027877,40625496,57048185,16422689,54020308,16422529,37597619,1,240,0
57097857,631,1,3027329,40625496,57097857,16472361,54070528,16472151,37598167,1,40,0
57561216,626,1,3027290,41009738,57561216,16551478,54533926,16551178,37982448,2,480,0
57776487,747,1,3027915,41009738,57776487,16766749,54748572,16766349,37981823,2,80,0
57865094,114,2,961011,41063462,57865094,16801632,56904083,16801492,40102451,1,80,0
58393573,115,2,961015,41579544,58393573,16814029,57432558,16813469,40618529,2,540,0
58731205,454,4,2059076,42448450,58731205,16282755,56672129,16282715,40389374,0,0,0
59153095,109,2,960993,41879632,59153095,17273463,58192102,17273063,40918639,4,650,0
59454999,612,1,3027177,41895341,59454999,17559658,56427822,17559148,38868164,4,330,0
59515348,1064,4,6243565,43174020,59515348,16341328,53271783,16341248,36930455,0,0,0
60016395,1127,4,6691429,43658940,60016395,16357455,53324966,16357315,36967511,0,0,0
60474477,873,4,3721582,44012685,60474477,16461792,56752895,16461752,40291103,0,0,0
61307031,1004,4,5564821,44472335,61307031,16834696,55742210,16834616,38907514,0,0,0
61649803,95,2,960939,960939,61649803,60688864,60688864,18214782,42473352,8,400,0
61714628,904,8,4216605,49567735,61714628,12146893,57498023,12146773,45351130,0,0,0
62136244,696,1,3027713,42584464,62136244,19551780,59108531,19551090,39556751,8,880,0
63022138,1058,4,6243469,45962908,63022138,17059230,56778669,17059150,39719439,0,0,0
63365337,682,1,3027662,42962507,63365337,20402830,60337675,20402440,39934845,9,570,0
63864525,1123,4,6244357,46701798,63864525,17162727,57620168,17162677,40457441,0,0,0
64389633,554,4,2676502,47160260,64389633,17229373,61713131,17229353,44483758,0,0,0
65005814,166,2,961194,45905940,65005814,19099874,64044620,19098834,44944746,6,1380,0
65599552,440,4,2058951,47923421,65599552,17676131,63540601,17676091,45864470,0,0,0
66115845,706,1,3027731,43887323,66115845,22228522,63088114,20671255,42415049,9,1050,0
67074153,1021,4,5641113,49067667,67074153,18006486,61433040,18006426,43426554,0,0,0
67370760,129,2,961065,46250952,67370760,21119808,66409695,20250389,46158686,5,960,0
67556617,533,4,2394735,49503548,67556617,18053069,65161882,18052989,47108813,0,0,0
68218590,84,4,810573,50126916,68218590,18091674,67408017,18091594,49316343,0,0,0
68464993,668,1,3027628,46957635,68464993,21507358,65437365,21506578,43930007,9,1170,0
69449204,492,4,2230283,51140086,69449204,18309118,67218921,18309038,48909803,0,0,0
69722124,654,1,3027580,48114273,69722124,21607851,66694544,21606481,45086693,7,1070,0
69928269,619,1,3027259,48196068,69928269,21732201,66901010,21731511,45168809,7,470,0
70063998,179,2,961239,49211376,70063998,20852622,69102759,20851722,48250137,5,470,0
71188632,923,4,4442568,52280058,71188632,18908574,66746064,18908534,47837490,0,0,0
71950181,688,1,3027681,49069307,71950181,22880874,68922500,22880474,46041626,9,1440,0
72312274,217,4,1730177,52649575,72312274,19662699,70582097,19662589,50919398,0,0,0
73277807,191,2,961280,50169646,73277807,23108161,72316527,23107041,49208366,4,720,0
73545887,596,1,3027073,49933847,73545887,23612040,70518814,23610870,46906774,7,730,0
74187396,50,4,343996,343996,74187396,73843400,73843400,20595407,53247693,1,270,0
74288575,785,1,3028012,50526760,74288575,23761815,71260563,23760525,47498748,6,1500,0
74553984,98,2,960951,960951,74553984,73593033,73593033,23781664,49810969,8,710,0
75094918,494,4,2230294,54505669,75094918,20589249,72864624,20589229,52275375,0,0,0
75280858,670,1,3027631,51408778,75280858,23872080,72253227,23870780,48381147,6,780,0
75767456,610,1,3027164,51823639,75767456,23943817,72740292,23943297,48796475,6,510,0
75970379,728,1,3027872,51823639,75970379,24146740,72942507,23968300,48973077,6,750,0
76006395,80,4,810528,54532448,76006395,21473947,75195867,21473827,53721920,0,0,0
77359824,611,1,3027172,52176434,77359824,25183390,74332652,24781456,49550206,6,1560,0
78214387,521,4,2230417,56656869,78214387,21557518,75983970,21557398,54426452,0,0,0
78808252,762,1,3027957,53050519,78808252,25757733,75780295,25757153,50022562,6,1260,0
79463524,758,1,3027939,53550829,79463524,25912695,76435585,25911695,50522890,6,630,0
80428646,460,4,2059129,57776487,80428646,22652159,78369517,22651979,55717358,0,0,0
80646682,760,1,3027949,53699004,80646682,26947678,77618733,26946758,50671055,7,1170,0
80770539,632,1,3027344,53699004,80770539,27071535,77743195,27069565,50671660,8,900,0
81464359,635,1,3027354,54087340,81464359,27377019,78437005,27096646,51339789,6,360,0
81622099,1012,4,5640904,58731205,81622099,22890894,75981195,22890874,53090301,0,0,0
82797226,383,1,1838952,54087340,82797226,28709886,80958274,27171404,53785350,9,1650,0
82909069,1008,4,5564840,59153095,82909069,23755974,77344229,23755884,53588255,0,0,0
83781584,67,2,769021,769021,83781584,83012563,83012563,27316089,55694414,25,2510,0
84369565,1043,4,6077643,59515348,84369565,24854217,78291922,24854177,53437705,0,0,0
84999022,1115,4,6244220,60016395,84999022,24982627,78754802,24982527,53772175,0,0,0
85009659,1033,1,6032619,57048185,85009659,27961474,78977040,27871187,51104173,7,840,0
85921717,677,1,3027645,57097857,85921717,28823860,82894072,28519602,54374090,7,190,0
86108676,1054,4,6243415,60474477,86108676,25634199,79865261,25634139,54231062,0,0,0
87031811,81,4,810542,61307031,87031811,25724780,86221269,25724720,60496489,0,0,0
88039042,220,4,1730199,61714628,88039042,26324414,86308843,26324334,59984429,0,0,0
88565938,197,2,961301,57561216,88565938,31004722,87604637,27890298,59713709,3,150,0
88770378,588,1,3027017,59454999,88770378,29315379,85743361,29315109,56427982,6,330,0
90060868,110,2,960997,61714628,90060868,28346240,89099871,28346190,60753631,0,0,0
91905894,405,2,1900788,63022138,91905894,28883756,90005106,28883676,61121350,0,0,0
92245209,155,2,961157,63022138,92245209,29223071,91284052,29222951,62060981,0,0,0
92285193,748,1,3027919,61714628,92285193,30570565,89257274,30570195,58686709,2,470,0
93101744,508,4,2230360,63864525,93101744,29237219,90871384,29237139,61634165,0,0,0
93679837,43,4,291317,291317,93679837,93388520,93388520,29809229,63579091,1,190,0
94911748,497,4,2230308,65599552,94911748,29312196,92681440,29312116,63369244,0,0,0
95774807,254,2,1743163,65005814,95774807,30768993,94031644,30768893,63262651,0,0,0
97641057,1038,1,6032653,61714628,97641057,35926429,91608404,35925899,55681975,6,1140,0
98229523,1104,4,6244077,67074153,98229523,31155370,91985446,31155250,60830076,0,0,0
99225441,745,1,3027908,62136244,99225441,37089197,96197533,37088907,59108336,6,270,0
101195177,1005,4,5564833,67556617,101195177,33638560,95630344,33638540,61991784,0,0,0
101731057,637,1,3027365,63365337,101731057,38365720,98703692,38364030,60337972,7,1260,0
102050782,527,4,2230442,68218590,102050782,33832192,99820340,33832112,65988148,0,0,0
104150002,44,4,343915,343915,104150002,103806087,103806087,35167161,68638676,1,200,0
104179384,149,2,961136,68464993,104179384,35714391,103218248,35714321,67503857,0,0,0
105576576,594,1,3027065,66115845,105576576,39460731,102549511,39459291,63088780,7,1880,0
106251087,907,4,4343650,71188632,106251087,35062455,101907437,35062335,66844982,0,0,0
107040132,75,2,769128,769128,107040132,106271004,106271004,37166405,69103059,18,510,0
108127290,1002,4,5564816,72312274,108127290,35815016,102562474,35814896,66747458,0,0,0
109678740,134,2,961082,71950181,109678740,37728559,108717658,37728469,70989099,1,190,0
110332541,642,1,3027407,67370760,110332541,42961781,107305134,42960521,64343353,10,1140,0
110698786,547,4,2394789,74187396,110698786,36511390,108303997,36511330,71792607,0,0,0
111603385,625,1,3027282,67370760,111603385,44232625,108576103,42974594,65600609,10,590,0
112388837,444,4,2058983,75094918,112388837,37293919,110329854,37293799,73035935,0,0,0
113435786,69,2,769060,769060,113435786,112666726,112666726,40079335,72584951,20,1230,0
113598695,218,4,1730179,76006395,113598695,37592300,111868516,37592280,74276216,0,0,0
116926563,167,2,961197,74553984,116926563,42372579,115965366,42372279,73592787,2,780,0
117650137,616,1,3027214,69928269,117650137,47721868,114622923,46392752,68228681,12,1920,0
119270589,420,4,2058826,78214387,119270589,41056202,117211763,41056182,76155561,0,0,0
119710861,262,2,1743212,75767456,119710861,43943405,117967649,43942805,74024244,3,540,0
121304799,667,1,3027625,73277807,121304799,48026992,118277174,47282064,70992870,9,900,0
121775168,498,4,2230311,80428646,121775168,41346522,119544857,41346462,78198335,0,0,0
123013059,450,4,2059028,81464359,123013059,41548700,120954031,41548600,79405331,0,0,0
124886117,609,1,3027159,75280858,124886117,49605259,121858958,49401316,72456622,6,750,0
126500302,46,4,343923,343923,126500302,126156379,126156379,45344643,80811586,1,30,0
128487451,704,1,3027727,77359824,128487451,51127627,125459724,51127227,74332097,4,470,0
130871196,419,4,2058810,82909069,130871196,47962127,128812386,47962007,80850259,0,0,0
130975035,606,1,3027148,78808252,130975035,52166783,127947887,52165593,75781104,6,1620,0
134785099,608,1,3027156,79463524,134785099,55321575,131757943,53987418,77769235,5,660,0
140573402,641,1,3027403,80646682,140573402,59926720,137545999,57609135,79936504,2,60,0
143311835,628,1,3027310,80770539,143311835,62541296,140284525,60223891,80060454,1,30,0
143870857,276,2,1829698,84369565,143870857,59501292,142041159,59501252,82539867,0,0,0
144607702,684,1,3027667,84369565,144607702,60238137,141580035,60238097,81341898,0,0,0
147573870,139,2,961099,84999022,147573870,62574848,146612771,62574808,84037923,0,0,0
148352503,646,1,3027514,84369565,148352503,63982938,145324989,63982818,81342051,1,80,0
157234637,522,4,2230420,86108676,157234637,71125961,155004217,71125881,83878256,0,0,0
158748988,501,4,2230326,87031811,158748988,71717177,156518662,71717097,84801485,0,0,0
166142672,461,4,2059136,88039042,166142672,78103630,164083536,78103530,85979906,0,0,0
170970904,589,1,3027020,84999022,170970904,85971882,167943884,85970862,81972002,4,1860,0
171303695,664,1,3027613,84999022,171303695,86304673,168276082,86303413,81971409,5,570,0
174481859,229,2,1743052,85921717,174481859,88560142,172738807,88559572,84178665,4,210,0
174965622,585,8,2877694,94911748,174965622,80053874,172087928,80053854,92034054,0,0,0
180404104,447,4,2059011,92245209,180404104,88158895,178345093,88158845,90186198,0,0,0
204697512,242,2,1743111,88565938,204697512,116131574,202954401,116131334,86822827,4,520,0
221507819,113,2,961008,90060868,221507819,131446951,220546811,131445971,89099860,4,600,0
