time,job_id,num_gpu,submit_time,start_time,end_time,executed_time,JCT,duration,pending_time,preempt,promote
931258,21,4,912416,912416,931258,18842,18842,18842,0,0,0
931389,24,16,926450,926450,931389,4939,4939,4939,0,0,0
975592,25,16,926459,930392,975592,45200,49133,45200,3933,0,0
985990,41,1,982125,982125,985990,3865,3865,3865,0,0,0
1000104,39,4,963028,963028,1000104,37076,37076,37076,0,0,0
1002141,47,1,993353,993353,1002141,8788,8788,8788,0,0,0
1005484,53,1,1003841,1003841,1005484,1643,1643,1643,0,0,0
1008092,42,4,989813,990126,1008092,17966,18279,17966,313,0,0
1009393,58,1,1007947,1007947,1009393,1446,1446,1446,0,0,0
1012535,57,1,1006297,1006297,1012535,6238,6238,6238,0,0,0
1014256,55,8,1004200,1008092,1014256,6164,10056,6164,3892,0,0
1022592,49,4,999486,999520,1022592,23072,23106,23072,34,0,0
1025289,64,4,1023510,1023510,1025289,1779,1779,1779,0,0,0
1039575,18,1,906242,906242,1039575,133333,133333,133333,0,0,0
1044629,63,1,1022908,1022908,1044629,21721,21721,21721,0,0,0
1051316,32,8,946857,946857,1051316,104459,104459,104459,0,0,0
1057540,22,4,912464,912464,1057540,145076,145076,145076,0,0,0
1065511,73,8,1033426,1041491,1065511,24020,32085,24020,8065,0,0
1086977,86,1,1078349,1078349,1086977,8628,8628,8628,0,0,0
1088798,30,8,931720,931720,1088798,157078,157078,157078,0,0,0
1114631,91,1,1083560,1083560,1114631,31071,31071,31071,0,0,0
1116292,1,8,336541,336541,1116292,779751,779751,779751,0,0,0
1129450,17,1,906050,906050,1129450,223400,223400,223400,0,0,0
1139216,122,8,1115754,1116292,1139216,22924,23462,22924,538,0,0
1142859,83,4,1068634,1078349,1142859,64510,74225,64510,9715,0,0
1150477,54,1,1004148,1004148,1150477,146329,146329,146329,0,0,0
1156171,126,4,1149652,1149652,1156171,6519,6519,6519,0,0,0
1174016,130,1,1158164,1158164,1174016,15852,15852,15852,0,0,0
1174693,131,1,1158343,1158343,1174693,16350,16350,16350,0,0,0
1183981,141,4,1163262,1165251,1183981,18730,20719,18730,1989,0,0
1183985,95,1,1093901,1093901,1183985,90084,90084,90084,0,0,0
1185991,111,1,1099017,1099017,1185991,86974,86974,86974,0,0,0
1193173,124,4,1119028,1139216,1193173,53957,74145,53957,20188,0,0
1203924,76,1,1058834,1058834,1203924,145090,145090,145090,0,0,0
1206025,70,4,1028741,1028741,1206025,177284,177284,177284,0,0,0
1208064,71,4,1029550,1030698,1208064,177366,178514,177366,1148,0,0
1209590,43,4,990126,990126,1209590,219464,219464,219464,0,0,0
1223683,66,8,1024189,1051316,1223683,172367,199494,172367,27127,0,0
1224475,116,8,1105595,1165414,1224475,59061,118880,59061,59819,0,0
1226214,151,1,1165398,1165398,1226214,60816,60816,60816,0,0,0
1236344,114,8,1099265,1165414,1236344,70930,137079,70930,66149,0,0
1237023,170,4,1194187,1206025,1237023,30998,42836,30998,11838,0,0
1237035,177,1,1234963,1234963,1237035,2072,2072,2072,0,0,0
1248859,171,4,1194668,1208064,1248859,40795,54191,40795,13396,0,0
1250682,140,1,1161628,1161628,1250682,89054,89054,89054,0,0,0
1252001,20,4,912363,912363,1252001,339638,339638,339638,0,0,0
1259800,181,4,1241695,1245265,1259800,14535,18105,14535,3570,0,0
1267059,89,1,1078558,1078558,1267059,188501,188501,188501,0,0,0
1268369,195,4,1251897,1252001,1268369,16368,16472,16368,104,0,0
1270720,159,1,1165542,1165542,1270720,105178,105178,105178,0,0,0
1273759,202,4,1255332,1259800,1273759,13959,18427,13959,4468,0,0
1274247,142,1,1165251,1165251,1274247,108996,108996,108996,0,0,0
1275147,72,1,1030698,1030698,1275147,244449,244449,244449,0,0,0
1282302,156,1,1165490,1165490,1282302,116812,116812,116812,0,0,0
1286547,199,4,1255259,1268369,1286547,18178,31288,18178,13110,0,0
1294010,56,8,1005202,1014256,1294010,279754,288808,279754,9054,0,0
1294887,196,1,1252909,1252909,1294887,41978,41978,41978,0,0,0
1297984,88,2,1078520,1078520,1297984,219464,219464,219464,0,0,0
1301259,117,8,1105635,1223683,1301259,77576,195624,77576,118048,0,0
1310986,133,1,1161506,1161506,1310986,149480,149480,149480,0,0,0
1337525,214,4,1279070,1286547,1337525,50978,58455,50978,7477,0,0
1351301,182,1,1244100,1244100,1351301,107201,107201,107201,0,0,0
1360448,212,8,1277547,1301259,1360448,59189,82901,59189,23712,0,0
1361293,228,8,1326576,1360448,1361293,845,34717,845,33872,0,0
1363504,213,4,1278989,1294010,1363504,69494,84515,69494,15021,0,0
1367607,121,8,1114608,1224475,1367607,143132,252999,143132,109867,0,0
1373383,238,4,1369754,1369754,1373383,3629,3629,3629,0,0,0
1376722,235,1,1365390,1365390,1376722,11332,11332,11332,0,0,0
1388696,191,1,1251322,1251322,1388696,137374,137374,137374,0,0,0
1400433,186,1,1245315,1245315,1400433,155118,155118,155118,0,0,0
1403093,215,1,1280138,1280138,1403093,122955,122955,122955,0,0,0
1408748,52,4,1000852,1003841,1408748,404907,407896,404907,2989,0,0
1415826,68,8,1025799,1065511,1415826,350315,390027,350315,39712,0,0
1416149,200,4,1255294,1273759,1416149,142390,160855,142390,18465,0,0
1428226,247,4,1378546,1408748,1428226,19478,49680,19478,30202,0,0
1435357,241,4,1371422,1371422,1435357,63935,63935,63935,0,0,0
1438997,128,8,1155403,1236344,1438997,202653,283594,202653,80941,0,0
1441409,92,1,1087027,1087027,1441409,354382,354382,354382,0,0,0
1445908,251,4,1431972,1435357,1445908,10551,13936,10551,3385,0,0
1464301,223,8,1293192,1361293,1464301,103008,171109,103008,68101,0,0
1466925,259,4,1466312,1466312,1466925,613,613,613,0,0,0
1467741,239,4,1370008,1372999,1467741,94742,97733,94742,2991,0,0
1473303,240,4,1371390,1373383,1473303,99920,101913,99920,1993,0,0
1475498,252,4,1432024,1438997,1475498,36501,43474,36501,6973,0,0
1476394,257,4,1462880,1464301,1476394,12093,13514,12093,1421,0,0
1481702,165,1,1167735,1167735,1481702,313967,313967,313967,0,0,0
1488765,168,1,1178118,1178118,1488765,310647,310647,310647,0,0,0
1526639,45,4,991447,993353,1526639,533286,535192,533286,1906,0,0
1527470,160,1,1167323,1167323,1527470,360147,360147,360147,0,0,0
1530445,263,4,1500042,1526639,1530445,3806,30403,3806,26597,0,0
1535086,15,4,884079,884079,1535086,651007,651007,651007,0,0,0
1537294,87,1,1078499,1078499,1537294,458795,458795,458795,0,0,0
1544679,265,4,1501577,1530445,1544679,14234,43102,14234,28868,0,0
1545292,205,8,1262028,1363504,1545292,181788,283264,181788,101476,0,0
1556440,48,1,996568,996568,1556440,559872,559872,559872,0,0,0
1558552,260,4,1495907,1495907,1558552,62645,62645,62645,0,0,0
1565419,51,1,999843,999843,1565419,565576,565576,565576,0,0,0
1567315,269,4,1542833,1544679,1567315,22636,24482,22636,1846,0,0
1587719,60,4,1020508,1022592,1587719,565127,567211,565127,2084,0,0
1591187,82,1,1064215,1064215,1591187,526972,526972,526972,0,0,0
1592173,280,8,1584868,1591187,1592173,986,7305,986,6319,0,0
1594531,283,1,1590920,1590920,1594531,3611,3611,3611,0,0,0
1594878,291,1,1593034,1593034,1594878,1844,1844,1844,0,0,0
1596522,286,1,1592992,1592992,1596522,3530,3530,3530,0,0,0
1602288,289,1,1593019,1593019,1602288,9269,9269,9269,0,0,0
1602620,290,1,1593027,1593027,1602620,9593,9593,9593,0,0,0
1604530,104,1,1095751,1095751,1604530,508779,508779,508779,0,0,0
1610039,341,1,1609030,1609030,1610039,1009,1009,1009,0,0,0
1610482,347,1,1609092,1609092,1610482,1390,1390,1390,0,0,0
1610589,315,1,1608786,1608786,1610589,1803,1803,1803,0,0,0
1610733,343,1,1609064,1609064,1610733,1669,1669,1669,0,0,0
1610819,328,1,1608902,1608902,1610819,1917,1917,1917,0,0,0
1610975,314,1,1608778,1608778,1610975,2197,2197,2197,0,0,0
1611187,313,1,1608770,1608770,1611187,2417,2417,2417,0,0,0
1612162,310,1,1608397,1608397,1612162,3765,3765,3765,0,0,0
1612396,321,1,1608835,1608835,1612396,3561,3561,3561,0,0,0
1614091,348,1,1609100,1609100,1614091,4991,4991,4991,0,0,0
1614137,305,4,1602931,1608397,1614137,5740,11206,5740,5466,0,0
1614470,338,1,1609005,1609005,1614470,5465,5465,5465,0,0,0
1614790,261,4,1497030,1535086,1614790,79704,117760,79704,38056,0,0
1615054,304,4,1602805,1608397,1615054,6657,12249,6657,5592,0,0
1615875,300,4,1601178,1608770,1615875,7105,14697,7105,7592,0,0
1616132,312,1,1608762,1608762,1616132,7370,7370,7370,0,0,0
1616634,354,1,1612763,1612763,1616634,3871,3871,3871,0,0,0
1620275,112,1,1099054,1099054,1620275,521221,521221,521221,0,0,0
1621892,301,4,1601204,1608835,1621892,13057,20688,13057,7631,0,0
1622257,275,2,1560182,1560182,1622257,62075,62075,62075,0,0,0
1622807,272,8,1546316,1592173,1622807,30634,76491,30634,45857,0,0
1623492,337,1,1608998,1608998,1623492,14494,14494,14494,0,0,0
1626965,320,1,1608828,1608828,1626965,18137,18137,18137,0,0,0
1627645,288,1,1593012,1593012,1627645,34633,34633,34633,0,0,0
1634983,351,1,1609140,1609140,1634983,25843,25843,25843,0,0,0
1635311,334,1,1608974,1608974,1635311,26337,26337,26337,0,0,0
1638039,336,1,1608991,1608991,1638039,29048,29048,29048,0,0,0
1639936,339,1,1609014,1609014,1639936,30922,30922,30922,0,0,0
1643446,346,1,1609085,1609085,1643446,34361,34361,34361,0,0,0
1644498,309,1,1608348,1608348,1644498,36150,36150,36150,0,0,0
1646801,349,1,1609126,1609126,1646801,37675,37675,37675,0,0,0
1647902,295,1,1593071,1593071,1647902,54831,54831,54831,0,0,0
1648519,332,1,1608935,1608935,1648519,39584,39584,39584,0,0,0
1649290,333,1,1608942,1608942,1649290,40348,40348,40348,0,0,0
1659409,323,1,1608850,1608850,1659409,50559,50559,50559,0,0,0
1659875,318,1,1608814,1608814,1659875,51061,51061,51061,0,0,0
1663165,287,1,1593003,1593003,1663165,70162,70162,70162,0,0,0
1664870,363,1,1664264,1664264,1664870,606,606,606,0,0,0
1671548,296,8,1599339,1621892,1671548,49656,72209,49656,22553,0,0
1673452,245,4,1373901,1415826,1673452,257626,299551,257626,41925,0,0
1674924,356,8,1629463,1671548,1674924,3376,45461,3376,42085,0,0
1675041,137,1,1161592,1161592,1675041,513449,513449,513449,0,0,0
1679339,183,4,1245265,1245265,1679339,434074,434074,434074,0,0,0
1683406,317,1,1608801,1608801,1683406,74605,74605,74605,0,0,0
1686126,285,1,1592985,1592985,1686126,93141,93141,93141,0,0,0
1689114,157,1,1165508,1165508,1689114,523606,523606,523606,0,0,0
1694237,135,1,1161554,1161554,1694237,532683,532683,532683,0,0,0
1703059,366,1,1678208,1678208,1703059,24851,24851,24851,0,0,0
1708833,277,8,1580632,1622807,1708833,86026,128201,86026,42175,0,0
1711063,344,1,1609071,1609071,1711063,101992,101992,101992,0,0,0
1714496,322,1,1608843,1608843,1714496,105653,105653,105653,0,0,0
1742624,327,1,1608894,1608894,1742624,133730,133730,133730,0,0,0
1750131,404,1,1690844,1690844,1750131,59287,59287,59287,0,0,0
1759874,319,1,1608822,1608822,1759874,151052,151052,151052,0,0,0
1760837,40,1,981636,981636,1760837,779201,779201,779201,0,0,0
1776502,394,1,1690772,1690772,1776502,85730,85730,85730,0,0,0
1790112,385,1,1690711,1690711,1790112,99401,99401,99401,0,0,0
1792483,372,1,1690262,1690262,1792483,102221,102221,102221,0,0,0
1792579,406,1,1690857,1690857,1792579,101722,101722,101722,0,0,0
1792698,402,1,1690828,1690828,1792698,101870,101870,101870,0,0,0
1792901,384,1,1690704,1690704,1792901,102197,102197,102197,0,0,0
1792986,382,1,1690688,1690688,1792986,102298,102298,102298,0,0,0
1794778,274,4,1550798,1558552,1794778,236226,243980,236226,7754,0,0
1795189,484,4,1775797,1794778,1795189,411,19392,411,18981,0,0
1795601,244,4,1373136,1415826,1795601,379775,422465,379775,42690,1,0
1800277,429,1,1691284,1691284,1800277,108993,108993,108993,0,0,0
1800417,476,4,1714667,1795189,1800417,5228,85750,5228,80522,0,0
1800999,480,4,1754118,1795601,1800999,5398,46881,5398,41483,0,0
1803574,401,1,1690821,1690821,1803574,112753,112753,112753,0,0,0
1803964,335,1,1608983,1608983,1803964,194981,194981,194981,0,0,0
1804519,451,1,1691800,1691800,1804519,112719,112719,112719,0,0,0
1807215,445,1,1691652,1691652,1807215,115563,115563,115563,0,0,0
1807916,330,1,1608921,1608921,1807916,198995,198995,198995,0,0,0
1809550,127,1,1152816,1152816,1809550,656734,656734,656734,0,0,0
1809896,470,4,1712214,1800417,1809896,9479,97682,9479,88203,0,0
1810809,129,1,1157802,1157802,1810809,653007,653007,653007,0,0,0
1814370,472,4,1713270,1800999,1814370,13371,101100,13371,87729,0,0
1816988,357,1,1634921,1634921,1816988,182067,182067,182067,0,0,0
1819138,138,1,1161607,1161607,1819138,657531,657531,657531,0,0,0
1830816,352,1,1609148,1609148,1830816,221668,221668,221668,0,0,0
1833192,367,1,1685457,1685457,1833192,147735,147735,147735,0,0,0
1833699,294,1,1593064,1593064,1833699,240635,240635,240635,0,0,0
1839870,345,1,1609078,1609078,1839870,230792,230792,230792,0,0,0
1849284,284,1,1592975,1592975,1849284,256309,256309,256309,0,0,0
1856638,329,1,1608914,1608914,1856638,247724,247724,247724,0,0,0
1856946,303,4,1602535,1608843,1856946,248103,254411,243106,11305,5,0
1858617,490,4,1842655,1856946,1858617,1671,15962,1671,14291,0,0
1864259,292,1,1593050,1593050,1864259,271209,271209,271209,0,0,0
1873635,299,4,1601071,1608850,1873635,264785,272564,259050,13514,1,0
1876251,467,8,1702189,1702189,1876251,174062,174062,174062,0,1,0
1878273,505,8,1867662,1876251,1878273,2022,10611,2022,8589,0,0
1882593,311,1,1608755,1608755,1882593,273838,273838,273838,0,0,0
1887610,316,1,1608793,1608793,1887610,278817,278817,278817,0,0,0
1887898,507,1,1873295,1873295,1887898,14603,14603,14603,0,0,0
1888263,255,1,1450085,1450085,1888263,438178,438178,438178,0,0,0
1897764,342,1,1609055,1609055,1897764,288709,288709,288709,0,0,0
1899012,500,8,1862599,1878273,1899012,20739,36413,20739,15674,0,0
1906517,77,1,1061017,1061017,1906517,845500,845500,845500,0,0,0
1920331,262,4,1498794,1545292,1920331,375039,421537,368976,52561,1,0
1921268,514,8,1886160,1899012,1921268,22256,35108,22256,12852,0,0
1925945,509,1,1874029,1874029,1925945,51916,51916,51916,0,0,0
1932794,227,2,1322871,1322871,1932794,609923,609923,609923,0,0,0
1937580,407,1,1690862,1690862,1937580,246718,246718,246718,0,0,0
1945151,492,4,1844396,1858617,1945151,86534,100755,86534,14221,0,0
1947696,520,4,1925297,1945151,1947696,2545,22399,2545,19854,0,0
1948035,532,1,1944973,1944973,1948035,3062,3062,3062,0,0,0
1948391,326,1,1608886,1608886,1948391,339505,339505,339505,0,0,0
1950089,477,8,1724431,1921268,1950089,28821,225658,28821,196837,0,0
1959275,409,1,1690866,1690866,1959275,268409,268409,268409,0,0,0
1964229,534,4,1949120,1950089,1964229,14140,15109,14140,969,0,0
1965182,297,4,1601032,1615875,1965182,349307,364150,349307,14843,0,0
1967158,552,1,1966322,1966322,1967158,836,836,836,0,0,0
1967849,551,1,1966298,1966298,1967849,1551,1551,1551,0,0,0
1974744,469,4,1712122,1712122,1974744,262622,262622,262622,0,0,0
1975260,556,1,1974128,1974128,1975260,1132,1132,1132,0,0,0
1981522,488,4,1840397,1873635,1981522,107887,141125,107887,33238,0,0
1987392,234,1,1359082,1359082,1987392,628310,628310,628310,0,0,0
1987408,531,4,1944769,1947696,1987408,39712,42639,39712,2927,0,0
1991860,482,1,1773103,1773103,1991860,218757,218757,218757,0,0,0
1994012,511,1,1876368,1876368,1994012,117644,117644,117644,0,0,0
1994778,550,1,1966274,1966274,1994778,28504,28504,28504,0,0,0
1995470,560,2,1978854,1978854,1995470,16616,16616,16616,0,0,0
1996183,457,1,1691957,1691957,1996183,304226,304226,304226,0,0,0
2009229,567,2,1981247,1981247,2009229,27982,27982,27982,0,0,0
2009565,293,1,1593057,1593057,2009565,416508,416508,416508,0,0,0
2010095,603,1,2008146,2008146,2010095,1949,1949,1949,0,0,0
2010680,233,16,1357023,2008353,2010680,2327,653657,2327,651330,0,0
2011072,613,1,2008386,2008386,2011072,2686,2686,2686,0,0,0
2011731,597,1,2007995,2007995,2011731,3736,3736,3736,0,0,0
2013774,174,16,1223535,2010680,2013774,3094,790239,3094,787145,0,0
2018245,232,16,1355804,2013774,2018245,4471,662441,4471,657970,0,0
2020116,481,4,1766927,1809896,2020116,210220,253189,210220,42969,0,0
2021762,246,4,1378443,1416149,2021762,605613,643319,542672,100647,2,0
2028928,187,1,1245511,1245511,2028928,783417,783417,783417,0,0,0
2032995,237,16,1368374,2018245,2032995,14750,664621,14750,649871,0,0
2036652,601,1,2008130,2008130,2036652,28522,28522,28522,0,0,0
2037215,614,1,2008408,2008408,2037215,28807,28807,28807,0,0,0
2041105,607,1,2008290,2008290,2041105,32815,32815,32815,0,0,0
2041150,592,1,2007925,2007925,2041150,33225,33225,33225,0,0,0
2049465,256,16,1450087,2032995,2049465,16470,599378,16470,582908,0,0
2050608,548,1,1966198,1966198,2050608,84410,84410,84410,0,0,0
2051891,544,1,1965715,1965715,2051891,86176,86176,86176,0,0,0
2053007,582,4,2001933,2006497,2053007,46510,51074,46510,4564,0,0
2055146,598,1,2008086,2008086,2055146,47060,47060,47060,0,0,0
2055533,189,1,1245524,1245524,2055533,810009,810009,810009,0,0,0
2055716,162,1,1167697,1167697,2055716,888019,888019,888019,0,0,0
2059580,569,1,1982000,1982000,2059580,77580,77580,77580,0,0,0
2060906,604,1,2008157,2008157,2060906,52749,52749,52749,0,0,0
2064114,605,1,2008170,2008170,2064114,55944,55944,55944,0,0,0
2066068,243,16,1372999,2049465,2066068,16603,693069,16603,676466,0,0
2070167,143,1,1165268,1165268,2070167,904899,904899,904899,0,0,0
2075148,617,8,2013159,2021762,2075148,53386,61989,53386,8603,0,0
2075279,350,1,1609133,1609133,2075279,466146,466146,466146,0,0,0
2076324,568,1,1981979,1981979,2076324,94345,94345,94345,0,0,0
2080943,324,1,1608857,1608857,2080943,472086,472086,472086,0,0,0
2082263,599,1,2008098,2008098,2082263,74165,74165,74165,0,0,0
2083442,513,16,1884835,2066068,2083442,17374,198607,17374,181233,0,0
2085944,426,1,1690924,1690924,2085944,395020,395020,395020,0,0,0
2086053,595,1,2007965,2007965,2086053,78088,78088,78088,0,0,0
2096910,620,1,2058069,2058069,2096910,38841,38841,38841,0,0,0
2103338,226,16,1312082,2083442,2103338,19896,791256,19896,771360,0,0
2113564,593,1,2007937,2007937,2113564,105627,105627,105627,0,0,0
2115802,600,1,2008116,2008116,2115802,107686,107686,107686,0,0,0
2128188,576,2,1996785,1996785,2128188,131403,131403,131403,0,0,0
2128891,353,16,1610336,2103338,2128891,25553,518555,25553,493002,0,0
2129893,545,1,1965766,1965766,2129893,164127,164127,164127,0,0,0
2135703,176,1,1233879,1233879,2135703,901824,901824,901824,0,0,0
2137204,331,1,1608929,1608929,2137204,528275,528275,528275,0,0,0
2138046,501,1,1862795,1862795,2138046,275251,275251,275251,0,0,0
2142296,101,1,1095578,1095578,2142296,1046718,1046718,1046718,0,0,0
2163288,583,1,2006324,2006324,2163288,156964,156964,156964,0,0,0
2171849,636,2,2153195,2153195,2171849,18654,18654,18654,0,0,0
2175247,504,1,1864812,1864812,2175247,310435,310435,310435,0,0,0
2185150,188,16,1245523,2128891,2185150,56259,939627,56259,883368,0,0
2189212,546,1,1966138,1966138,2189212,223074,223074,223074,0,0,0
2191366,622,8,2133105,2185150,2191366,6216,58261,6216,52045,0,0
2193643,649,4,2186327,2191366,2193643,2277,7316,2277,5039,0,0
2195795,627,8,2150018,2185150,2195795,10645,45777,10645,35132,0,0
2197974,555,1,1972359,1972359,2197974,225615,225615,225615,0,0,0
2199445,651,4,2190311,2191366,2199445,8079,9134,8079,1055,0,0
2200079,656,4,2197006,2199445,2200079,634,3073,634,2439,0,0
2202842,281,4,1587106,1587106,2202842,615736,615736,440770,174966,43,0
2204693,502,4,1863192,1920331,2204693,284362,341501,284362,57139,0,0
2206054,648,1,2183536,2183536,2206054,22518,22518,22518,0,0,0
2211108,389,1,1690738,1690738,2211108,520370,520370,520370,0,0,0
2211164,395,1,1690780,1690780,2211164,520384,520384,520384,0,0,0
2214383,154,1,1165455,1165455,2214383,1048928,1048928,1048928,0,0,0
2220267,487,8,1821990,1981522,2220267,238745,398277,171950,226327,1,0
2222780,433,1,1691387,1691387,2222780,531393,531393,531393,0,0,0
2232551,638,1,2153529,2153529,2232551,79022,79022,79022,0,0,0
2232871,340,1,1609023,1609023,2232871,623848,623848,623848,0,0,0
2239926,658,4,2200224,2202842,2239926,37084,39702,37084,2618,0,0
2250483,660,4,2206543,2214383,2250483,36100,43940,36100,7840,0,0
2257843,671,1,2223276,2223276,2257843,34567,34567,34567,0,0,0
2258902,647,1,2182300,2182300,2258902,76602,76602,76602,0,0,0
2259201,685,1,2249168,2249168,2259201,10033,10033,10033,0,0,0
2269569,655,4,2192489,2193643,2269569,75926,77080,75926,1154,0,0
2284859,672,4,2223453,2239926,2284859,44933,61406,44933,16473,0,0
2289246,577,4,1999867,1999867,2289246,289379,289379,289379,0,15,0
2291513,612,1,2008376,2008376,2291513,283137,283137,283137,0,0,0
2305968,693,4,2285347,2285347,2305968,20621,20621,20621,0,0,0
2308539,681,1,2237299,2237299,2308539,71240,71240,71240,0,0,0
2309743,588,1,2007737,2007737,2309743,302006,302006,302006,0,0,0
2310973,703,1,2308721,2308721,2310973,2252,2252,2252,0,0,0
2317544,591,1,2007912,2007912,2317544,309632,309632,309632,0,0,0
2320919,549,1,1966249,1966249,2320919,354670,354670,354670,0,0,0
2321300,692,8,2281652,2305968,2321300,15332,39648,15332,24316,0,0
2323899,713,1,2318623,2318623,2323899,5276,5276,5276,0,0,0
2326221,708,8,2310700,2321300,2326221,4921,15521,4921,10600,0,0
2327462,491,1,1842658,1842658,2327462,484804,484804,484804,0,0,0
2329642,190,1,1245696,1245696,2329642,1083946,1083946,1083946,0,0,0
2330960,634,2,2153142,2153142,2330960,177818,177818,177818,0,0,0
2334872,695,1,2295536,2295536,2334872,39336,39336,39336,0,0,0
2341115,626,8,2149297,2195795,2341115,145320,191818,145320,46498,0,0
2341730,711,4,2314770,2326221,2341730,15509,26960,15509,11451,0,0
2348399,676,1,2225454,2225454,2348399,122945,122945,122945,0,0,0
2369456,724,1,2330881,2330881,2369456,38575,38575,38575,0,0,0
2373717,725,8,2335207,2341115,2373717,32602,38510,32602,5908,0,0
2378801,554,1,1969507,1969507,2378801,409294,409294,409294,0,0,0
2379244,508,1,1874026,1874026,2379244,505218,505218,505218,0,0,0
2390277,579,4,1999909,2006559,2390277,383718,390368,339064,51304,11,0
2395222,610,1,2008353,2008353,2395222,386869,386869,386869,0,0,0
2395607,729,1,2356683,2356683,2395607,38924,38924,38924,0,0,0
2396587,740,4,2379419,2390277,2396587,6310,17168,6310,10858,0,0
2397151,590,1,2007847,2007847,2397151,389304,389304,389304,0,0,0
2398766,594,1,2007948,2007948,2398766,390818,390818,390818,0,0,0
2399619,204,1,1261278,1261278,2399619,1138341,1138341,1138341,0,2,0
2408245,755,1,2406881,2406881,2408245,1364,1364,1364,0,0,0
2413366,761,1,2410799,2410799,2413366,2567,2567,2567,0,0,0
2437923,661,4,2206543,2220267,2437923,217656,231380,217656,13724,0,0
2439962,736,4,2373939,2396587,2439962,43375,66023,43375,22648,0,0
2440656,562,2,1979101,1979101,2440656,461555,461555,461555,0,0,0
2440738,525,1,1934900,1934900,2440738,505838,505838,505838,0,0,0
2441146,669,8,2220859,2341730,2441146,99416,220287,99416,120871,0,0
2441562,759,1,2409923,2409923,2441562,31639,31639,31639,0,0,0
2445015,611,1,2008366,2008366,2445015,436649,436649,436649,0,0,0
2450931,659,4,2204380,2204693,2450931,246238,246551,246238,313,0,0
2455907,302,2,1601625,1601625,2455907,854282,854282,852892,1390,98,0
2475272,675,8,2225095,2373717,2475272,101555,250177,101555,148622,0,0
2478165,782,1,2464078,2464078,2478165,14087,14087,14087,0,0,0
2479268,775,1,2450238,2450238,2479268,29030,29030,29030,0,0,0
2483354,783,8,2466707,2475272,2483354,8082,16647,8082,8565,0,0
2492605,596,1,2007980,2007980,2492605,484625,484625,484625,0,0,0
2495294,781,8,2462128,2483354,2495294,11940,33166,11940,21226,0,0
2504519,694,1,2288358,2288358,2504519,216161,216161,216161,0,0,0
2513060,741,8,2379991,2437923,2513060,75137,133069,75137,57932,0,0
2517563,773,8,2446077,2450931,2517563,66632,71486,66632,4854,0,0
2537599,712,1,2317985,2317985,2537599,219614,219614,219614,0,0,0
2538912,553,1,1968041,1968041,2538912,570871,570871,570871,0,0,0
2541717,791,1,2482274,2482274,2541717,59443,59443,59443,0,0,0
2543878,769,1,2420202,2420202,2543878,123676,123676,123676,0,0,0
2546018,809,8,2507193,2513060,2546018,32958,38825,32958,5867,0,0
2547882,816,4,2530447,2546018,2547882,1864,17435,1864,15571,0,0
2548219,625,1,2149233,2149233,2548219,398986,398986,398986,0,0,0
2548897,697,8,2304602,2441146,2548897,107751,244295,107751,136544,0,0
2550464,779,8,2454686,2495294,2550464,55170,95778,55170,40608,0,0
2557075,489,1,1842565,1842565,2557075,714510,714510,714510,0,0,0
2557659,219,4,1284627,1294010,2557659,1263649,1273032,702524,570508,80,0
2559192,375,1,1690292,1690292,2559192,868900,868900,868900,0,0,0
2559555,464,1,1692174,1692174,2559555,867381,867381,867381,0,0,0
2565804,380,1,1690344,1690344,2565804,875460,875460,875460,0,0,0
2571505,543,1,1964282,1964282,2571505,607223,607223,607223,0,0,0
2573070,814,4,2528328,2546018,2573070,27052,44742,27052,17690,0,0
2578719,815,4,2530428,2547882,2578719,30837,48291,30837,17454,0,0
2590490,826,4,2550621,2557659,2590490,32831,39869,32831,7038,0,0
2593660,529,4,1943224,1964229,2593660,629431,650436,415723,234713,9,0
2599234,325,1,1608864,1608864,2599234,990370,990370,990370,0,13,0
2599853,787,8,2479353,2517563,2599853,82290,120500,82290,38210,0,0
2624897,496,4,1846107,1965182,2624897,659715,778790,415729,363061,9,0
2654021,819,4,2533783,2548897,2654021,105124,120238,105124,15114,0,0
2658464,674,8,2224179,2550464,2658464,108000,434285,108000,326285,0,0
2662276,822,1,2540419,2540419,2662276,121857,121857,121857,0,0,0
2673013,837,2,2662093,2662093,2673013,10920,10920,10920,0,0,0
2675737,657,4,2199808,2269569,2675737,406168,475929,406168,69761,0,0
2682247,2,1,475911,475911,2682247,2206336,2206336,2206336,0,19,0
2684696,100,1,1095546,1095546,2684696,1589150,1589150,1589150,0,22,0
2701784,709,8,2312146,2593660,2701784,108124,389638,108124,281514,0,0
2709433,812,8,2519332,2599853,2709433,109580,190101,109580,80521,0,0
2710026,813,4,2528322,2548897,2710026,161129,181704,161129,20575,0,0
2714444,856,1,2705681,2705681,2714444,8763,8763,8763,0,0,0
2717431,630,1,2152257,2152257,2717431,565174,565174,565174,0,0,0
2725376,454,1,1691903,1691903,2725376,1033473,1033473,1033473,0,0,0
2733989,825,2,2548896,2548896,2733989,185093,185093,185093,0,0,0
2737729,827,4,2550634,2573070,2737729,164659,187095,164659,22436,0,0
2738679,851,4,2668703,2675737,2738679,62942,69976,62942,7034,0,0
2760656,890,1,2750632,2750632,2760656,10024,10024,10024,0,0,0
2761059,831,1,2605962,2605962,2761059,155097,155097,155097,0,0,0
2763953,749,8,2404498,2654021,2763953,109932,359455,109932,249523,0,0
2765181,439,1,1691534,1691534,2765181,1073647,1073647,1073647,0,0,0
2765888,861,2,2736332,2736332,2765888,29556,29556,29556,0,0,0
2768822,808,8,2502249,2658464,2768822,110358,266573,110358,156215,0,0
2770409,880,8,2738970,2763953,2770409,6456,31439,6456,24983,0,0
2776225,898,1,2755645,2755645,2776225,20580,20580,20580,0,0,0
2777587,905,8,2767308,2768822,2777587,8765,10279,8765,1514,0,0
2779891,912,4,2771579,2777587,2779891,2304,8312,2304,6008,0,0
2782231,524,1,1934815,1934815,2782231,847416,847416,847416,0,0,0
2796133,894,4,2754107,2770409,2796133,25724,42026,25724,16302,0,0
2796605,805,1,2497520,2497520,2796605,299085,299085,299085,0,0,0
2798791,928,1,2798007,2798007,2798791,784,784,784,0,0,0
2799395,909,1,2769560,2769560,2799395,29835,29835,29835,0,0,0
2802191,931,1,2801211,2801211,2802191,980,980,980,0,0,0
2802284,927,1,2797842,2797842,2802284,4442,4442,4442,0,0,0
2809576,609,1,2008335,2008335,2809576,801241,801241,801241,0,0,0
2810245,925,4,2796000,2796133,2810245,14112,14245,14112,133,0,0
2810980,547,1,1966174,1966174,2810980,844806,844806,844806,0,0,0
2812025,943,1,2809529,2809529,2812025,2496,2496,2496,0,0,0
2817575,876,1,2738244,2738244,2817575,79331,79331,79331,0,0,0
2821957,854,4,2703145,2709433,2821957,112524,118812,112524,6288,0,0
2822623,868,1,2736548,2736548,2822623,86075,86075,86075,0,0,0
2822941,850,4,2668600,2701784,2822941,121157,154341,121157,33184,0,0
2825324,951,4,2811545,2821957,2825324,3367,13779,3367,10412,0,0
2826492,935,1,2804436,2804436,2826492,22056,22056,22056,0,0,0
2827555,933,1,2801505,2801505,2827555,26050,26050,26050,0,0,0
2828955,916,2,2783923,2783923,2828955,45032,45032,45032,0,0,0
2832713,962,1,2826624,2826624,2832713,6089,6089,6089,0,0,0
2834394,950,1,2811290,2811290,2834394,23104,23104,23104,0,0,0
2838320,828,4,2553029,2578719,2838320,259601,285291,259601,25690,0,0
2839322,918,4,2786487,2786487,2839322,52835,52835,52835,0,0,0
2840249,956,1,2816767,2816767,2840249,23482,23482,23482,0,0,0
2842669,608,1,2008311,2008311,2842669,834358,834358,834358,0,0,0
2849671,756,8,2407234,2738679,2849671,110992,442437,110992,331445,0,0
2851256,847,1,2662359,2662359,2851256,188897,188897,188897,0,0,0
2856578,978,8,2839393,2849671,2856578,6907,17185,6907,10278,0,0
2856676,936,1,2804850,2804850,2856676,51826,51826,51826,0,0,0
2863332,948,1,2811215,2811215,2863332,52117,52117,52117,0,0,0
2871368,979,4,2839402,2839402,2871368,31966,31966,31966,0,0,0
2871387,887,8,2743102,2810245,2871387,61142,128285,61142,67143,0,0
2873319,966,8,2829120,2856578,2873319,16741,44199,16741,27458,0,0
2873940,589,1,2007756,2007756,2873940,866184,866184,866184,0,0,0
2875085,959,8,2824767,2825324,2875085,49761,50318,49761,557,0,0
2876865,633,1,2152871,2152871,2876865,723994,723994,723994,0,0,0
2878009,929,1,2799257,2799257,2878009,78752,78752,78752,0,0,0
2880978,871,4,2736613,2736613,2880978,144365,144365,144365,0,0,0
2883428,893,4,2753761,2770409,2883428,113019,129667,113019,16648,0,0
2889680,995,1,2877619,2877619,2889680,12061,12061,12061,0,0,0
2893176,629,1,2152220,2152220,2893176,740956,740956,740956,0,0,0
2894926,999,1,2882057,2882057,2894926,12869,12869,12869,0,0,0
2896538,1015,1,2893482,2893482,2896538,3056,3056,3056,0,0,0
2896584,1014,1,2893452,2893452,2896584,3132,3132,3132,0,0,0
2898663,1022,1,2896131,2896131,2898663,2532,2532,2532,0,0,0
2899485,107,1,1095914,1095914,2899485,1803571,1803571,1803571,0,30,0
2899900,903,4,2762657,2777587,2899900,122313,137243,122313,14930,0,0
2900572,796,1,2484191,2484191,2900572,416381,416381,416381,0,0,0
2903572,797,1,2484263,2484263,2903572,419309,419309,419309,0,0,0
2906497,977,4,2839259,2839322,2906497,67175,67238,67175,63,0,0
2907505,1026,1,2904303,2904303,2907505,3202,3202,3202,0,0,0
2919651,914,2,2782504,2782504,2919651,137147,137147,137147,0,0,0
2922173,794,1,2483310,2483310,2922173,438863,438863,438863,0,0,0
2926092,776,2,2450480,2450480,2926092,475612,475612,475612,0,0,0
2926551,938,1,2806604,2806604,2926551,119947,119947,119947,0,0,0
2929996,739,1,2377051,2377051,2929996,552945,552945,552945,0,0,0
2930208,198,1,1254374,1254374,2930208,1675834,1675834,1675834,0,38,0
2931140,853,1,2671801,2671801,2931140,259339,259339,259339,0,0,0
2935439,144,1,1165288,1165288,2935439,1770151,1770151,1770151,0,42,0
2937009,1017,1,2893731,2893731,2937009,43278,43278,43278,0,0,0
2938661,957,1,2821978,2821978,2938661,116683,116683,116683,0,0,0
2940515,1009,4,2890440,2899900,2940515,40615,50075,40615,9460,0,0
2941122,944,8,2810181,2871387,2941122,69735,130941,69735,61206,0,0
2943098,960,8,2825556,2873319,2943098,69779,117542,69779,47763,0,0
2944191,993,1,2877529,2877529,2944191,66662,66662,66662,0,0,0
2949892,852,4,2671185,2701784,2949892,248108,278707,248108,30599,0,0
2955128,917,2,2784159,2784159,2955128,170969,170969,170969,0,0,0
2955250,1034,1,2924989,2924989,2955250,30261,30261,30261,0,0,0
2956638,982,4,2841605,2871368,2956638,85270,115033,85270,29763,0,0
2960936,885,8,2742912,2875085,2960936,85851,218024,85851,132173,0,0
2970106,1037,1,2961144,2961144,2970106,8962,8962,8962,0,0,0
2972977,1011,8,2891633,2941122,2972977,31855,81344,31855,49489,0,0
2976328,1001,4,2882440,2882440,2976328,93888,93888,93888,0,0,0
2976999,1039,1,2968473,2968473,2976999,8526,8526,8526,0,0,0
2977799,849,4,2666580,2709433,2977799,268366,311219,268366,42853,0,0
2981728,1048,1,2978540,2978540,2981728,3188,3188,3188,0,0,0
2983334,954,16,2812234,2976328,2983334,7006,171100,7006,164094,0,0
2986093,1053,1,2982970,2982970,2986093,3123,3123,3123,0,0,0
2986437,1003,1,2882730,2882730,2986437,103707,103707,103707,0,0,0
2988631,731,1,2365059,2365059,2988631,623572,623572,623572,0,0,0
2992244,996,16,2880718,2983334,2992244,8910,111526,8910,102616,0,0
3000386,1044,1,2972870,2972870,3000386,27516,27516,27516,0,0,0
3001043,1040,4,2969900,2969900,3001043,31143,31143,31143,0,0,0
3007341,1065,8,2997034,3001043,3007341,6298,10307,6298,4009,0,0
3008315,1069,8,3003144,3007341,3008315,974,5171,974,4197,0,0
3009562,757,16,2407489,2992244,3009562,17318,602073,17318,584755,0,0
3010515,1041,1,2971369,2971369,3010515,39146,39146,39146,0,0,0
3013736,153,1,1165433,1165433,3013736,1848303,1848303,1848303,0,53,0
3015611,913,1,2777405,2777405,3015611,238206,238206,238206,0,0,0
3020726,1068,8,3002159,3008315,3020726,12411,18567,12411,6156,0,0
3026431,997,1,2880886,2880886,3026431,145545,145545,145545,0,0,0
3029977,875,16,2737400,3009562,3029977,20415,292577,20415,272162,0,0
3031481,923,1,2790636,2790636,3031481,240845,240845,240845,0,0,0
3033511,969,8,2831821,2943098,3033511,90413,201690,90413,111277,0,0
3036223,1006,4,2888982,2888982,3036223,147241,147241,147241,0,0,0
3036564,1086,4,3020342,3020726,3036564,15838,16222,15838,384,0,0
3041730,1050,1,2980938,2980938,3041730,60792,60792,60792,0,0,0
3043382,1000,1,2882080,2882080,3043382,161302,161302,161302,0,0,0
3045227,585,1,2006559,2006559,3045227,1038668,1038668,1038668,0,9,0
3045544,1080,1,3015678,3015678,3045544,29866,29866,29866,0,0,0
3046930,161,1,1167678,1167678,3046930,1879252,1879252,1879245,7,61,0
3047020,981,8,2839809,2949892,3047020,97128,207211,97128,110083,0,0
3048792,1084,1,3018622,3018622,3048792,30170,30170,30170,0,0,0
3051260,1096,8,3046093,3047020,3051260,4240,5167,4240,927,0,0
3057135,1051,1,2982335,2982335,3057135,74800,74800,74800,0,0,0
3058632,766,16,2419971,3036564,3058632,22068,638661,22068,616593,0,0
3067346,1078,8,3013782,3029977,3067346,37369,53564,37369,16195,0,0
3067408,1098,1,3051645,3051645,3067408,15763,15763,15763,0,0,0
3071049,992,1,2877471,2877471,3071049,193578,193578,193578,0,0,0
3072127,877,1,2738257,2738257,3072127,333870,333870,333870,0,0,0
3072985,838,2,2662112,2662112,3072985,410873,410873,410873,0,0,0
3073331,1111,8,3058804,3067346,3073331,5985,14527,5985,8542,0,0
3075478,1052,1,2982676,2982676,3075478,92802,92802,92802,0,0,0
3076851,904,1,2762982,2762982,3076851,313869,313869,313869,0,0,0
3078438,1102,1,3055049,3055049,3078438,23389,23389,23389,0,0,0
3079651,1114,8,3059698,3073331,3079651,6320,19953,6320,13633,0,0
3082621,1013,1,2891773,2891773,3082621,190848,190848,190848,0,0,0
3082750,973,16,2836301,3058632,3082750,24118,246449,24118,222331,0,0
3085089,835,2,2662056,2662056,3085089,423033,423033,423033,0,0,0
3085644,834,2,2662033,2662033,3085644,423611,423611,423611,0,0,0
3086083,704,1,2308795,2308795,3086083,777288,777288,777288,0,0,0
3086554,1124,8,3069894,3079651,3086554,6903,16660,6903,9757,0,0
3091568,1129,1,3073639,3073639,3091568,17929,17929,17929,0,0,0
3092625,1135,1,3081141,3081141,3092625,11484,11484,11484,0,0,0
3099604,1081,1,3018107,3018107,3099604,81497,81497,81497,0,0,0
3105274,1134,1,3081111,3081111,3105274,24163,24163,24163,0,0,0
3107377,1147,1,3097131,3097131,3107377,10246,10246,10246,0,0,0
3111423,1046,1,2977576,2977576,3111423,133847,133847,133847,0,0,0
3112271,410,1,1690870,1690870,3112271,1421401,1421401,1421401,0,19,0
3116773,1097,16,3050600,3082750,3116773,34023,66173,34023,32150,0,0
3118870,1155,16,3114442,3116773,3118870,2097,4428,2097,2331,0,0
3131645,1152,16,3107889,3118870,3131645,12775,23756,12775,10981,0,0
3134715,987,4,2850083,2880978,3134715,253737,284632,222080,62552,18,0
3147939,994,1,2877562,2877562,3147939,270377,270377,270377,0,0,0
3149404,1149,1,3102509,3102509,3149404,46895,46895,46895,0,0,0
3151532,1089,1,3043312,3043312,3151532,108220,108220,108220,0,0,0
3153184,1118,1,3064913,3064913,3153184,88271,88271,88271,0,0,0
3155355,1159,1,3122038,3122038,3155355,33317,33317,33317,0,0,0
3156962,1143,4,3088134,3092625,3156962,64337,68828,64337,4491,0,0
3163105,184,1,1245289,1245289,3163105,1917816,1917816,1917802,14,89,0
3164103,1163,4,3151206,3151206,3164103,12897,12897,12897,0,0,0
3165265,1117,8,3060417,3086554,3165265,78711,104848,78711,26137,0,0
3167772,408,1,1690865,1690865,3167772,1476907,1476907,1476907,0,47,0
3170944,1164,8,3156300,3165265,3170944,5679,14644,5679,8965,0,0
3177970,1145,8,3095341,3131645,3177970,46325,82629,46325,36304,0,0
3181821,1077,4,3013382,3013382,3181821,168439,168439,168439,0,0,0
3194325,1156,8,3114754,3131645,3194325,62680,79571,62680,16891,0,0
3197283,377,1,1690306,1690306,3197283,1506977,1506977,1506156,821,61,0
3201917,1106,1,3056064,3056064,3201917,145853,145853,145853,0,0,0
3205215,926,1,2796380,2796380,3205215,408835,408835,408835,0,0,0
3205996,932,1,2801445,2801445,3205996,404551,404551,404551,0,0,0
3211692,953,4,2811641,2940515,3211692,271177,400051,258597,141454,34,0
3214836,727,1,2342253,2342253,3214836,872583,872583,872583,0,0,0
3216546,848,1,2662435,2662435,3216546,554111,554111,554111,0,0,0
3224357,1108,1,3056816,3056816,3224357,167541,167541,167541,0,0,0
3231486,1099,4,3053148,3053148,3231486,178338,178338,178338,0,0,0
3231691,1105,1,3055728,3055728,3231691,175963,175963,175963,0,0,0
3233589,839,1,2662181,2662181,3233589,571408,571408,571408,0,0,0
3237346,1005,1,2886973,2886973,3237346,350373,350373,350373,0,0,0
3237542,1016,1,2893671,2893671,3237542,343871,343871,343871,0,0,0
3252679,1119,8,3065037,3170944,3252679,81735,187642,81735,105907,0,0
3255265,1007,1,2889623,2889623,3255265,365642,365642,365642,0,0,0
3259938,1141,8,3086361,3177970,3259938,81968,173577,81968,91609,0,0
3264388,378,1,1690321,1690321,3264388,1574067,1574067,1573224,843,86,0
3265794,515,1,1889386,1889386,3265794,1376408,1376408,1375219,1189,23,0
3271968,803,1,2495753,2495753,3271968,776215,776215,776215,0,0,0
3276451,920,1,2787947,2787947,3276451,488504,488504,488504,0,0,0
3277176,1070,1,3004977,3004977,3277176,272199,272199,272199,0,0,0
3281087,1168,1,3165566,3165566,3281087,115521,115521,115521,0,0,0
3296658,1240,8,3231294,3231486,3296658,65172,65364,65172,192,0,0
3299483,1031,1,2910102,2910102,3299483,389381,389381,389381,0,0,0
3302735,1176,8,3186211,3194325,3302735,108410,116524,108410,8114,0,0
3306289,1091,8,3045764,3051260,3306289,255029,260525,129272,131253,4,0
3310579,1020,1,2894811,2894811,3310579,415768,415768,415768,0,0,0
3312088,1246,8,3255235,3259938,3312088,52150,56853,52150,4703,0,0
3338491,1107,1,3056638,3056638,3338491,281853,281853,281853,0,0,0
3340834,1255,1,3279710,3279710,3340834,61124,61124,61124,0,0,0
3352688,1244,1,3251739,3251739,3352688,100949,100949,100949,0,0,0
3354337,1072,1,3005325,3005325,3354337,349012,349012,349012,0,0,0
3356080,1262,1,3335050,3335050,3356080,21030,21030,21030,0,0,0
3359545,1282,1,3359134,3359134,3359545,411,411,411,0,0,0
3363478,1301,1,3362009,3362009,3363478,1469,1469,1469,0,0,0
3363809,1276,8,3357468,3363038,3363809,771,6341,771,5570,0,0
3365193,1311,1,3363038,3363038,3365193,2155,2155,2155,0,0,0
3366159,1304,1,3362093,3362093,3366159,4066,4066,4066,0,0,0
3366763,584,1,2006497,2006497,3366763,1360266,1360266,1358537,1729,28,0
3368343,1327,1,3366667,3366667,3368343,1676,1676,1676,0,0,0
3368696,1274,8,3350039,3363809,3368696,4887,18657,4887,13770,0,0
3369564,1280,1,3359133,3359133,3369564,10431,10431,10431,0,0,0
3370175,1331,1,3369000,3369000,3370175,1175,1175,1175,0,0,0
3372598,1319,1,3364413,3364413,3372598,8185,8185,8185,0,0,0
3373093,102,1,1095698,1095698,3373093,2277395,2277395,2273631,3764,182,0
3378795,1136,8,3082127,3252679,3378795,126116,296668,126116,170552,0,0
3379360,1214,1,3193586,3193586,3379360,185774,185774,185774,0,0,0
3380340,446,1,1691672,1691672,3380340,1688668,1688668,1685290,3378,83,0
3384345,1182,1,3193448,3193448,3384345,190897,190897,190897,0,0,0
3388759,1259,1,3329599,3329599,3388759,59160,59160,59160,0,0,0
3394974,1167,4,3163733,3163733,3394974,231241,231241,231241,0,0,0
3397183,1263,1,3338630,3338630,3397183,58553,58553,58553,0,0,0
3398080,1284,4,3359587,3368696,3398080,29384,38493,29384,9109,0,0
3398132,1290,1,3360234,3360234,3398132,37898,37898,37898,0,0,0
3399654,1322,1,3365657,3365657,3399654,33997,33997,33997,0,0,0
3404262,1266,1,3342588,3342588,3404262,61674,61674,61674,0,0,0
3410259,832,1,2632713,2632713,3410259,777546,777546,777546,0,0,0
3417154,1337,8,3370849,3378795,3417154,38359,46305,38359,7946,0,0
3418034,1224,1,3193628,3193628,3418034,224406,224406,224406,0,0,0
3418099,1344,8,3400170,3417154,3418099,945,17929,945,16984,0,0
3424472,438,1,1691512,1691512,3424472,1732960,1732960,1711968,20992,86,0
3424493,1346,8,3401046,3418099,3424493,6394,23447,6394,17053,0,0
3426736,970,8,2832444,2960936,3426736,465800,594292,145446,448846,6,0
3429540,1361,4,3418942,3419422,3429540,10118,10598,10118,480,0,0
3429735,1127,1,3072346,3072346,3429735,357389,357389,357389,0,0,0
3429793,1373,1,3428247,3428247,3429793,1546,1546,1546,0,0,0
3429958,1350,1,3404105,3404105,3429958,25853,25853,25853,0,0,0
3430487,1364,1,3419511,3419511,3430487,10976,10976,10976,0,0,0
3434733,1233,1,3193663,3193663,3434733,241070,241070,241070,0,0,0
3437600,1216,1,3193593,3193593,3437600,244007,244007,244007,0,0,0
3440782,1079,8,3015240,3036223,3440782,404559,425542,138388,287154,1,0
3441166,1215,1,3193590,3193590,3441166,247576,247576,247576,0,0,0
3445082,1253,8,3276864,3306289,3445082,138793,168218,138793,29425,0,0
3446427,1389,1,3444884,3444884,3446427,1543,1543,1543,0,0,0
3446985,1392,1,3444948,3444948,3446985,2037,2037,2037,0,0,0
3450180,1387,1,3444524,3444524,3450180,5656,5656,5656,0,0,0
3452687,1294,1,3360356,3360356,3452687,92331,92331,92331,0,0,0
3456258,411,1,1690872,1690872,3456258,1765386,1765386,1727631,37755,105,0
3461264,1391,1,3444925,3444925,3461264,16339,16339,16339,0,0,0
3464606,571,1,1982224,1982224,3464606,1482382,1482382,1455166,27216,26,0
3465916,1128,1,3072686,3072686,3465916,393230,393230,393230,0,0,0
3467915,1354,1,3409100,3409100,3467915,58815,58815,58815,0,0,0
3469325,1049,1,2980720,2980720,3469325,488605,488605,488605,0,0,0
3470873,1315,1,3363614,3363614,3470873,107259,107259,107259,0,0,0
3471295,1283,1,3359380,3359380,3471295,111915,111915,111915,0,0,0
3471573,942,1,2808913,2808913,3471573,662660,662660,662660,0,0,0
3474705,1261,1,3333053,3333053,3474705,141652,141652,141652,0,0,0
3476171,1352,1,3404165,3404165,3476171,72006,72006,72006,0,0,0
3477741,1293,8,3360334,3398080,3477741,79661,117407,79661,37746,0,0
3477879,645,1,2162064,2162064,3477879,1315815,1315815,1315815,0,5,0
3479256,1310,1,3362983,3362983,3479256,116273,116273,116273,0,0,0
3480532,1132,1,3079575,3079575,3480532,400957,400957,400957,0,0,0
3481695,1357,1,3411603,3411603,3481695,70092,70092,70092,0,0,0
3484998,1362,8,3419095,3424493,3484998,60505,65903,60505,5398,0,0
3488889,1281,1,3359133,3359133,3488889,129756,129756,129756,0,0,0
3489481,1125,1,3070169,3070169,3489481,419312,419312,419312,0,0,0
3490189,1316,1,3363638,3363638,3490189,126551,126551,126551,0,0,0
3490386,1061,1,2991731,2991731,3490386,498655,498655,498655,0,0,0
3492248,1279,1,3359133,3359133,3492248,133115,133115,133115,0,0,0
3496625,371,1,1690255,1690255,3496625,1806370,1806370,1758303,48067,124,0
3497413,998,1,2882011,2882011,3497413,615402,615402,615402,0,12,0
3500204,146,1,1165316,1165316,3500204,2334888,2334888,2283312,51576,202,0
3500452,1403,1,3455383,3455383,3500452,45069,45069,45069,0,0,0
3503357,1402,8,3449324,3477741,3503357,25616,54033,25616,28417,0,0
3504058,1396,1,3445081,3445081,3504058,58977,58977,58977,0,0,0
3505016,1417,4,3500240,3503357,3505016,1659,4776,1659,3117,0,0
3507557,1424,4,3502023,3503357,3507557,4200,5534,4200,1334,0,0
3512958,798,1,2485732,2485732,3512958,1027226,1027226,1027226,0,45,0
3513082,152,1,1165414,1165414,3513082,2347668,2347668,2286369,61299,231,0
3516817,105,1,1095787,1095787,3516817,2421030,2421030,2358114,62916,255,0
3517548,1027,1,2905196,2905196,3517548,612352,612352,612352,0,1,0
3518517,1438,1,3517032,3517032,3518517,1485,1485,1485,0,0,0
3526612,1368,1,3427475,3427475,3526612,99137,99137,99137,0,0,0
3527443,777,8,2452014,3312088,3527443,215355,1075429,151657,923772,10,0
3529067,1413,8,3497355,3527443,3529067,1624,31712,1624,30088,0,0
3534033,1445,8,3518210,3529067,3534033,4966,15823,4966,10857,0,0
3534963,1455,1,3530069,3530069,3534963,4894,4894,4894,0,0,0
3536072,1446,1,3518233,3518233,3536072,17839,17839,17839,0,0,0
3539711,1433,8,3512747,3534033,3539711,5678,26964,5678,21286,0,0
3542688,175,1,1233608,1233608,3542688,2309080,2309080,2240304,68776,256,0
3543797,1462,1,3541523,3541523,3543797,2274,2274,2274,0,0,0
3544464,1464,1,3541938,3541938,3544464,2526,2526,2526,0,0,0
3551057,1420,8,3501679,3539711,3551057,11346,49378,11346,38032,0,0
3551193,1450,1,3529058,3529058,3551193,22135,22135,22135,0,0,0
3559233,1432,1,3511645,3511645,3559233,47588,47588,47588,0,0,0
3559370,1451,1,3529148,3529148,3559370,30222,30222,30222,0,0,0
3560510,1126,1,3070500,3070500,3560510,490010,490010,490010,0,0,0
3561301,1453,1,3529655,3529655,3561301,31646,31646,31646,0,0,0
3561314,1323,1,3365692,3365692,3561314,195622,195622,195622,0,0,0
3562075,1454,1,3529934,3529934,3562075,32141,32141,32141,0,0,0
3570599,1074,1,3005404,3005404,3570599,565195,565195,565195,0,0,0
3574436,1426,8,3503418,3551057,3574436,23379,71018,23379,47639,0,0
3577894,1407,4,3483316,3483316,3577894,94578,94578,94578,0,0,0
3580408,1458,1,3537196,3537196,3580408,43212,43212,43212,0,0,0
3580876,1457,1,3537065,3537065,3580876,43811,43811,43811,0,0,0
3584734,1456,1,3530171,3530171,3584734,54563,54563,54563,0,0,0
3590201,1161,1,3137006,3137006,3590201,453195,453195,453195,0,0,0
3591582,1473,1,3581313,3581313,3591582,10269,10269,10269,0,0,0
3592000,1459,1,3537306,3537306,3592000,54694,54694,54694,0,0,0
3597997,1379,1,3437574,3437574,3597997,160423,160423,160423,0,0,0
3598671,1351,1,3404131,3404131,3598671,194540,194540,194540,0,0,0
3599244,1463,8,3541924,3574436,3599244,24808,57320,24808,32512,0,0
3605171,164,1,1167724,1167724,3605171,2437447,2437447,2363803,73644,301,0
3605999,1345,8,3400242,3484998,3605999,121001,205757,121001,84756,0,0
3611362,1488,1,3604657,3604657,3611362,6705,6705,6705,0,0,0
3612125,906,1,2768096,2768096,3612125,844029,844029,843507,522,128,0
3620768,1376,1,3437032,3437032,3620768,183736,183736,183736,0,0,0
3623967,1508,1,3617797,3617797,3623967,6170,6170,6170,0,0,0
3625012,1523,1,3623039,3623039,3625012,1973,1973,1973,0,0,0
3625026,1475,1,3586937,3586937,3625026,38089,38089,38089,0,0,0
3625045,1522,1,3622956,3622956,3625045,2089,2089,2089,0,0,0
3627072,1512,1,3621074,3621074,3627072,5998,5998,5998,0,0,0
3628485,1347,1,3402672,3402672,3628485,225813,225813,225813,0,0,0
3628715,1501,1,3617060,3617060,3628715,11655,11655,11655,0,0,0
3630564,1474,1,3585504,3585504,3630564,45060,45060,45060,0,0,0
3632412,1514,1,3622084,3622084,3632412,10328,10328,10328,0,0,0
3632669,1477,4,3594743,3594743,3632669,37926,37926,37926,0,0,0
3633806,1472,1,3580224,3580224,3633806,53582,53582,53582,0,0,0
3636997,1499,1,3616896,3616896,3636997,20101,20101,20101,0,0,0
3637792,1497,1,3616104,3616104,3637792,21688,21688,21688,0,0,0
3640632,1360,4,3415395,3429540,3640632,211092,225237,211092,14145,15,0
3643128,1503,1,3617456,3617456,3643128,25672,25672,25672,0,0,0
3644186,1521,1,3622884,3622884,3644186,21302,21302,21302,0,0,0
3647215,1502,1,3617144,3617144,3647215,30071,30071,30071,0,0,0
3648232,1513,1,3621920,3621920,3648232,26312,26312,26312,0,0,0
3649958,1302,1,3362054,3362054,3649958,287904,287904,287904,0,0,0
3651750,1526,8,3623438,3640632,3651750,11118,28312,11118,17194,0,0
3654639,1412,4,3490509,3505016,3654639,149623,164130,149623,14507,0,0
3656576,1363,1,3419422,3419422,3656576,237154,237154,237154,0,0,0
3657884,1468,4,3571109,3571109,3657884,86775,86775,86775,0,0,0
3657922,393,1,1690765,1690765,3657922,1967157,1967157,1861647,105510,237,0
3662232,1539,1,3635605,3635605,3662232,26627,26627,26627,0,0,0
3662815,1506,1,3617583,3617583,3662815,45232,45232,45232,0,0,0
3663853,1461,8,3539191,3599244,3663853,64609,124662,64609,60053,0,0
3664864,1295,1,3360396,3360396,3664864,304468,304468,304468,0,0,0
3665653,1534,1,3625896,3625896,3665653,39757,39757,39757,0,0,0
3667100,1538,1,3634332,3634332,3667100,32768,32768,32768,0,0,0
3669319,1494,1,3615514,3615514,3669319,53805,53805,53805,0,0,0
3672012,1519,1,3622703,3622703,3672012,49309,49309,49309,0,0,0
3672462,1532,1,3625250,3625250,3672462,47212,47212,47212,0,0,0
3675688,1465,8,3543503,3605999,3675688,69689,132185,69689,62496,0,0
3675778,842,1,2662251,2662251,3675778,1013527,1013527,993975,19552,118,0
3678065,1241,1,3237897,3237897,3678065,440168,440168,440168,0,0,0
3679182,1042,1,2972754,2972754,3679182,706428,706428,706428,0,0,0
3683815,1442,1,3517854,3517854,3683815,165961,165961,165961,0,0,0
3684782,1405,1,3478648,3478648,3684782,206134,206134,206134,0,0,0
3684927,1443,1,3517999,3517999,3684927,166928,166928,166928,0,0,0
3685640,1303,1,3362076,3362076,3685640,323564,323564,323564,0,0,0
3687174,1515,1,3622334,3622334,3687174,64840,64840,64840,0,0,0
3687356,1289,1,3360183,3360183,3687356,327173,327173,327173,0,0,0
3695372,1349,1,3402969,3402969,3695372,292403,292403,292403,0,0,0
3696391,1520,1,3622812,3622812,3696391,73579,73579,73579,0,0,0
3702059,1004,1,2883291,2883291,3702059,818768,818768,812765,6003,37,0
3708994,1571,1,3706239,3706239,3708994,2755,2755,2755,0,0,0
3709678,1575,1,3707765,3707765,3709678,1913,1913,1913,0,0,0
3710058,1577,1,3708089,3708089,3710058,1969,1969,1969,0,0,0
3710484,1578,1,3708232,3708232,3710484,2252,2252,2252,0,0,0
3711127,1583,1,3708635,3708635,3711127,2492,2492,2492,0,0,0
3711349,1581,1,3708485,3708485,3711349,2864,2864,2864,0,0,0
3713594,1533,1,3625753,3625753,3713594,87841,87841,87841,0,0,0
3713818,1023,1,2898363,2900572,3713818,813246,815455,811945,3510,24,0
3717730,1573,1,3706329,3706329,3717730,11401,11401,11401,0,0,0
3718692,1570,1,3706039,3706039,3718692,12653,12653,12653,0,0,0
3723198,1535,1,3626244,3626244,3723198,96954,96954,96954,0,0,0
3724205,1580,1,3708405,3708405,3724205,15800,15800,15800,0,0,0
3726223,1285,1,3359789,3359789,3726223,366434,366434,366434,0,0,0
3727298,1524,1,3623111,3623111,3727298,104187,104187,104187,0,0,0
3729809,1490,8,3605476,3651750,3729809,78059,124333,78059,46274,0,0
3738107,915,2,2782611,2782611,3738107,955496,955496,653954,301542,78,0
3742044,1388,1,3444873,3444873,3742044,297171,297171,297171,0,0,0
3746398,949,1,2811277,2822941,3746398,923457,935121,906052,29069,101,0
3748089,1574,8,3706428,3729809,3748089,18280,41661,18280,23381,0,0
3751512,1582,1,3708556,3708556,3751512,42956,42956,42956,0,0,0
3751766,1566,1,3705591,3705591,3751766,46175,46175,46175,0,0,0
3753002,1436,1,3516025,3516025,3753002,236977,236977,236977,0,0,0
3753850,1059,1,2991710,2991710,3753850,762140,762140,762140,0,18,0
3757458,1579,1,3708324,3708324,3757458,49134,49134,49134,0,0,0
3757599,1586,1,3708871,3708871,3757599,48728,48728,48728,0,0,0
3760326,1550,2,3685334,3685334,3760326,74992,74992,74992,0,0,0
3761688,1483,8,3602159,3663853,3761688,97835,159529,97835,61694,0,0
3773706,1543,8,3655299,3675688,3773706,98018,118407,98018,20389,0,0
3776306,1596,1,3761771,3761771,3776306,14535,14535,14535,0,0,0
3779727,1406,1,3482800,3482800,3779727,296927,296927,296927,0,0,0
3780997,1544,4,3659762,3659762,3780997,121235,121235,121235,0,0,0
3785443,1439,1,3517155,3517155,3785443,268288,268288,268288,0,0,0
3792908,1377,1,3437326,3437326,3792908,355582,355582,355582,0,0,0
3799408,820,1,2536859,2536859,3799408,1262549,1262549,1223073,39476,139,0
3800326,1612,1,3782099,3782099,3800326,18227,18227,18227,0,0,0
3804339,1548,1,3668548,3668548,3804339,135791,135791,135791,0,0,0
3807301,1590,4,3744447,3748089,3807301,59212,62854,59212,3642,0,0
3807560,1613,1,3783673,3783673,3807560,23887,23887,23887,0,0,0
3812207,1611,4,3777479,3780997,3812207,31210,34728,31210,3518,0,0
3819921,97,1,1095394,1095394,3819921,2724527,2724527,2558233,166294,348,0
3820153,1452,1,3529517,3529517,3820153,290636,290636,290636,0,0,0
3823706,1386,1,3444367,3444367,3823706,379339,379339,379339,0,0,0
3829461,1563,8,3703578,3761688,3829461,67773,125883,67773,58110,0,0
3830123,1122,1,3068173,3068173,3830123,761950,761950,761950,0,0,0
3836923,1103,1,3055589,3055589,3836923,781334,781334,781334,0,0,0
3850470,1634,2,3797326,3797326,3850470,53144,53144,53144,0,0,0
3852508,1019,1,2893851,2907505,3852508,945003,958657,928554,30103,52,0
3857075,1609,1,3772020,3772020,3857075,85055,85055,85055,0,0,0
3859739,1594,4,3758807,3758807,3859739,100932,100932,100932,0,0,0
3860242,1355,1,3409908,3409908,3860242,450334,450334,450334,0,0,0
3868516,1559,8,3694914,3773706,3868516,94810,173602,94810,78792,0,0
3868966,1332,1,3369102,3369102,3868966,499864,499864,499864,0,0,0
3869114,1614,1,3784102,3784102,3869114,85012,85012,85012,0,0,0
3869839,1659,8,3849649,3868516,3869839,1323,20190,1323,18867,0,0
3872581,1181,1,3193441,3193441,3872581,679140,679140,679140,0,0,0
3876977,1637,2,3798139,3798139,3876977,78838,78838,78838,0,0,0
3881684,1661,1,3849992,3849992,3881684,31692,31692,31692,0,0,0
3885211,792,1,2482324,2482324,3885211,1402887,1402887,1318505,84382,134,0
3885344,1394,1,3445013,3445013,3885344,440331,440331,440331,0,0,0
3890355,1635,2,3797920,3797920,3890355,92435,92435,92435,0,0,0
3891540,1382,1,3442593,3442593,3891540,448947,448947,448947,0,0,0
3900826,1493,1,3615392,3615392,3900826,285434,285434,285434,0,0,0
3912857,1631,4,3796551,3807301,3912857,105556,116306,105556,10750,0,0
3920351,1565,1,3703723,3703723,3920351,216628,216628,216628,0,0,0
3924671,1500,1,3616971,3616971,3924671,307700,307700,307700,0,0,0
3926018,1667,8,3889980,3912857,3926018,13161,36038,13161,22877,0,0
3926099,1587,8,3717476,3829461,3926099,96638,208623,96638,111985,0,0
3952064,1686,1,3949869,3949869,3952064,2195,2195,2195,0,0,0
3952093,1687,1,3949952,3949952,3952093,2141,2141,2141,0,0,0
3955518,1658,8,3845366,3869839,3955518,85679,110152,85679,24473,0,0
3961148,1633,1,3797268,3797268,3961148,163880,163880,163880,0,0,0
3962841,1708,1,3961673,3961673,3962841,1168,1168,1168,0,0,0
3962993,1706,1,3961531,3961531,3962993,1462,1462,1462,0,0,0
3963023,1710,1,3961834,3961834,3963023,1189,1189,1189,0,0,0
3963489,1700,1,3960993,3960993,3963489,2496,2496,2496,0,0,0
3964329,1682,8,3948277,3955518,3964329,8811,16052,8811,7241,0,0
3964516,1711,1,3961903,3961903,3964516,2613,2613,2613,0,0,0
3964752,1695,1,3960326,3960326,3964752,4426,4426,4426,0,0,0
3966751,1696,1,3960736,3960736,3966751,6015,6015,6015,0,0,0
3969120,1688,1,3950047,3950047,3969120,19073,19073,19073,0,0,0
3970655,1356,1,3411546,3411546,3970655,559109,559109,559109,0,0,0
3971415,1690,1,3950183,3950183,3971415,21232,21232,21232,0,0,0
3971629,1498,1,3616820,3616820,3971629,354809,354809,354809,0,0,0
3972810,1685,1,3949787,3949787,3972810,23023,23023,23023,0,0,0
3979753,1707,1,3961599,3961599,3979753,18154,18154,18154,0,0,0
3981852,1699,1,3960924,3960924,3981852,20928,20928,20928,0,0,0
3983976,1676,4,3937928,3964329,3983976,19647,46048,19647,26401,0,0
3985446,1569,1,3705944,3705944,3985446,279502,279502,279502,0,0,0
3985696,1665,2,3876469,3876469,3985696,109227,109227,109227,0,0,0
3987649,1617,4,3786367,3812207,3987649,175442,201282,175442,25840,0,0
3987859,1404,1,3458247,3458247,3987859,529612,529612,529612,0,0,0
3987909,760,1,2410770,2410770,3987909,1577139,1577139,1478476,98663,157,0
3992830,1378,1,3437452,3437452,3992830,555378,555378,555378,0,0,0
3993579,1709,1,3961747,3961747,3993579,31832,31832,31832,0,0,0
3993998,1718,1,3970334,3970334,3993998,23664,23664,23664,0,0,0
3994332,1674,4,3935479,3964329,3994332,30003,58853,30003,28850,0,0
4002237,1449,1,3525329,3525329,4002237,476908,476908,476908,0,0,0
4009407,922,1,2788786,2788786,4009407,1220621,1220621,1111622,108999,120,0
4015133,1727,1,4012586,4012586,4015133,2547,2547,2547,0,0,0
4016858,1684,1,3949690,3949690,4016858,67168,67168,67168,0,0,0
4018084,1296,1,3360548,3360548,4018084,657536,657536,657536,0,0,0
4018698,1648,8,3829833,3926018,4018698,92680,188865,92680,96185,0,0
4019882,1721,8,3975795,4018698,4019882,1184,44087,1184,42903,0,0
4022355,1728,4,4013947,4019882,4022355,2473,8408,2473,5935,0,0
4024793,1726,1,4010915,4010915,4024793,13878,13878,13878,0,0,0
4027373,1729,1,4014555,4014555,4027373,12818,12818,12818,0,0,0
4030325,1732,1,4016446,4016446,4030325,13879,13879,13879,0,0,0
4030665,1568,1,3705784,3705784,4030665,324881,324881,324881,0,0,0
4031715,1731,4,4016264,4019882,4031715,11833,15451,11833,3618,0,0
4033692,1258,1,3316252,3316252,4033692,717440,717440,717440,0,0,0
4039387,1487,1,3604303,3604303,4039387,435084,435084,435084,0,0,0
4039913,1649,8,3832671,3926099,4039913,113814,207242,113814,93428,0,0
4043446,1740,8,4020490,4039913,4043446,3533,22956,3533,19423,0,0
4043560,866,1,2736499,2736499,4043560,1307061,1307061,1178689,128372,130,0
4045883,1390,1,3444910,3444910,4045883,600973,600973,600973,0,0,0
4047751,1715,8,3965169,4043446,4047751,4305,82582,4305,78277,0,0
4053408,1744,8,4031959,4047751,4053408,5657,21449,5657,15792,0,0
4054375,1736,4,4019116,4022355,4054375,32020,35259,32020,3239,0,0
4054519,1733,1,4016536,4016536,4054519,37983,37983,37983,0,0,0
4057124,1321,1,3365150,3365150,4057124,691974,691974,691974,0,0,0
4060350,1746,8,4034191,4053408,4060350,6942,26159,6942,19217,0,0
4060479,1701,1,3961080,3961080,4060479,99399,99399,99399,0,0,0
4061855,1745,8,4034063,4054375,4061855,7480,27792,7480,20312,0,0
4062695,985,1,2844243,2856676,4062695,1206019,1218452,1120572,97880,98,0
4067744,1618,4,3789445,3859739,4067744,208005,278299,208005,70294,0,0
4071643,1722,8,3980117,4060350,4071643,11293,91526,11293,80233,0,0
4074502,1758,8,4052711,4061855,4074502,12647,21791,12647,9144,0,0
4083858,1714,8,3963849,4067744,4083858,16114,120009,16114,103895,0,0
4087401,1669,4,3934756,3983976,4087401,103425,152645,103425,49220,0,0
4089449,1767,4,4085795,4087401,4089449,2048,3654,2048,1606,0,0
4093158,1764,8,4062291,4071643,4093158,21515,30867,21515,9352,0,0
4112026,1734,1,4016712,4016712,4112026,95314,95314,95314,0,0,0
4114076,1698,8,3960830,4074502,4114076,39574,153246,39574,113672,0,0
4114261,1557,1,3694117,3694117,4114261,420144,420144,420144,0,0,0
4126893,1793,1,4124502,4124502,4126893,2391,2391,2391,0,0,0
4127314,1677,4,3938171,3987649,4127314,139665,189143,139665,49478,0,0
4127347,1802,1,4126148,4126148,4127347,1199,1199,1199,0,0,0
4127746,1803,1,4126346,4126346,4127746,1400,1400,1400,0,0,0
4129501,1678,2,3946168,3946168,4129501,183333,183333,183333,0,0,0
4133654,1703,1,3961334,3961334,4133654,172320,172320,172320,0,0,0
4133729,1787,1,4109733,4109733,4133729,23996,23996,23996,0,0,0
4134288,1775,1,4092939,4092939,4134288,41349,41349,41349,0,0,0
4135110,1765,8,4064308,4083858,4135110,51252,70802,51252,19550,0,0
4142064,1800,1,4125628,4125628,4142064,16436,16436,16436,0,0,0
4143670,1739,1,4020373,4020373,4143670,123297,123297,123297,0,0,0
4146626,1679,8,3946654,4093158,4146626,53468,199972,53468,146504,0,0
4150950,688,1,2255571,2255571,4150950,1895379,1895379,1743448,151931,298,0
4154854,1782,1,4104385,4104385,4154854,50469,50469,50469,0,0,0
4155131,1697,1,3960814,3960814,4155131,194317,194317,194317,0,0,0
4155995,1806,4,4138995,4138995,4155995,17000,17000,17000,0,0,0
4159710,1691,1,3953261,3953261,4159710,206449,206449,206449,0,0,0
4160080,1797,1,4125000,4125000,4160080,35080,35080,35080,0,0,0
4166011,1801,1,4125921,4125921,4166011,40090,40090,40090,0,0,0
4169161,1799,1,4125286,4125286,4169161,43875,43875,43875,0,0,0
4169290,1243,1,3251588,3251588,4169290,917702,917702,917702,0,29,0
4176009,1804,8,4126644,4135110,4176009,40899,49365,40899,8466,0,0
4182839,1409,1,3485998,3485998,4182839,696841,696841,696841,0,0,0
4186612,1716,8,3965506,4114076,4186612,72536,221106,72536,148570,0,0
4205943,1831,1,4204965,4204965,4205943,978,978,978,0,0,0
4207436,1719,4,3974316,3994332,4207436,213104,233120,213104,20016,0,0
4207828,1821,2,4187459,4187459,4207828,20369,20369,20369,0,0,0
4208541,1820,4,4187223,4207436,4208541,1105,21318,1105,20213,0,0
4212079,1824,2,4189402,4189402,4212079,22677,22677,22677,0,0,0
4214057,1297,1,3360708,3360708,4214057,853349,853349,853349,0,38,0
4221585,1776,4,4094367,4094367,4221585,127218,127218,127218,0,0,0
4224373,428,1,1691253,1759874,4224373,2464499,2533120,2223942,309178,526,0
4224420,1829,4,4197529,4208541,4224420,15879,26891,15879,11012,0,0
4227917,1792,1,4124425,4124425,4227917,103492,103492,103492,0,0,0
4228667,1742,1,4023745,4023745,4228667,204922,204922,204922,0,0,0
4238991,1822,4,4188140,4221585,4238991,17406,50851,17406,33445,0,0
4239285,1835,1,4210537,4210537,4239285,28748,28748,28748,0,0,0
4239808,1847,1,4224234,4224234,4239808,15574,15574,15574,0,0,0
4243276,1828,4,4197288,4224420,4243276,18856,45988,18856,27132,0,0
4245797,1035,1,2925137,2956638,4245797,1289159,1320660,1241095,79565,211,0
4247001,1702,1,3961236,3961236,4247001,285765,285765,285765,0,0,0
4247632,1762,8,4053792,4146626,4247632,101006,193840,101006,92834,0,0
4248093,1854,1,4241485,4241485,4248093,6608,6608,6608,0,0,0
4251554,1830,8,4200134,4247632,4251554,3922,51420,3922,47498,0,0
4252397,1833,1,4209674,4209674,4252397,42723,42723,42723,0,0,0
4263109,1865,1,4260901,4260901,4263109,2208,2208,2208,0,0,0
4263462,1846,8,4223886,4251554,4263462,11908,39576,11908,27668,0,0
4265654,360,1,1639334,1639334,4265654,2626320,2626320,2276674,349646,640,0
4270880,1675,4,3937203,4031715,4270880,239165,333677,239165,94512,0,0
4278398,1692,1,3959146,3959146,4278398,319252,319252,319252,0,0,0
4280761,1763,8,4055318,4176009,4280761,104752,225443,104752,120691,0,0
4281158,1840,4,4217853,4238991,4281158,42167,63305,42167,21138,0,0
4288854,1873,4,4280398,4280761,4288854,8093,8456,8093,363,0,0
4292590,1869,4,4272964,4280761,4292590,11829,19626,11829,7797,0,0
4294113,1585,1,3708773,3708773,4294113,585340,585340,585340,0,0,0
4294127,1057,1,2991688,3031481,4294127,1262646,1302439,1255519,46920,225,0
4295165,1819,8,4187061,4263462,4295165,31703,108104,31703,76401,0,0
4296647,1880,1,4292276,4292276,4296647,4371,4371,4371,0,0,0
4301614,1874,4,4280490,4281158,4301614,20456,21124,20456,668,0,0
4306618,1201,1,3193537,3193537,4306618,1113081,1113081,1100717,12364,111,0
4311061,1481,8,3601566,4186612,4311061,124449,709495,124449,585046,0,0
4311948,1366,1,3426265,3429958,4311948,881990,885683,878591,7092,13,0
4315255,1850,1,4226057,4226057,4315255,89198,89198,89198,0,0,0
4320345,1917,1,4313213,4313213,4320345,7132,7132,7132,0,0,0
4322248,1221,1,3193612,3193612,4322248,1128636,1128636,1107997,20639,88,0
4323016,1878,1,4291633,4291633,4323016,31383,31383,31383,0,0,0
4326171,1903,4,4308202,4311061,4326171,15110,17969,15110,2859,0,0
4326451,1834,8,4210203,4292590,4326451,33861,116248,33861,82387,0,0
4327316,1919,1,4319218,4319218,4327316,8098,8098,8098,0,0,0
4327840,1909,4,4310775,4311061,4327840,16779,17065,16779,286,0,0
4329088,1896,1,4306288,4306288,4329088,22800,22800,22800,0,0,0
4331281,1883,8,4298062,4301614,4331281,29667,33219,29667,3552,0,0
4334231,521,1,1925580,1925580,4334231,2408651,2408651,2071950,336701,557,0
4339441,1348,16,3402699,4331281,4339441,8160,936742,8160,928582,0,0
4344251,1796,1,4124790,4124790,4344251,219461,219461,219461,0,0,0
4346519,1838,4,4215093,4243276,4346519,103243,131426,103243,28183,0,0
4349624,1891,4,4305250,4306246,4349624,43378,44374,43378,996,0,0
4352310,1558,16,3694118,4339441,4352310,12869,658192,12869,645323,0,0
4354467,1889,1,4299389,4299389,4354467,55078,55078,55078,0,0,0
4354758,1937,4,4353866,4353866,4354758,892,892,892,0,0,0
4354806,1925,1,4341492,4341492,4354806,13314,13314,13314,0,0,0
4358461,1213,1,3193582,3193582,4358461,1164879,1164879,1129222,35657,82,0
4360843,1939,4,4355252,4355252,4360843,5591,5591,5591,0,0,0
4363567,1815,1,4173649,4173649,4363567,189918,189918,189918,0,0,0
4365776,1272,16,3344326,4352310,4365776,13466,1021450,13466,1007984,0,0
4367765,1908,8,4310117,4326171,4367765,41594,57648,41594,16054,0,0
4372025,575,1,1988402,1988402,4372025,2383623,2383623,2012057,371566,583,0
4373708,1509,1,3618303,3618303,4373708,755405,755405,755405,0,13,0
4375509,1868,1,4272038,4272038,4375509,103471,103471,103471,0,0,0
4377554,1517,1,3622500,3622500,4377554,755054,755054,755054,0,17,0
4378476,1944,1,4364373,4364373,4378476,14103,14103,14103,0,0,0
4379603,1308,16,3362465,4365776,4379603,13827,1017138,13827,1003311,0,0
4384062,1516,1,3622423,3622423,4384062,761639,761639,761639,0,22,0
4388900,1844,8,4222851,4295165,4388900,93735,166049,93735,72314,0,0
4394918,1567,1,3705704,3705704,4394918,689214,689214,689214,0,0,0
4396089,1927,1,4353063,4353063,4396089,43026,43026,43026,0,0,0
4396156,1870,1,4275845,4275845,4396156,120311,120311,120311,0,0,0
4398029,1894,1,4306246,4306246,4398029,91783,91783,91783,0,0,0
4405104,1540,16,3635675,4379603,4405104,25501,769429,25501,743928,0,0
4410375,1893,1,4306126,4306126,4410375,104249,104249,104249,0,0,0
4415201,1949,4,4374376,4374376,4415201,40825,40825,40825,0,0,0
4415696,570,1,1982201,1982201,4415696,2433495,2433495,2030426,403069,628,0
4422059,1704,1,3961442,3961442,4422059,460617,460617,460617,0,0,0
4425893,1843,4,4222236,4265654,4425893,160239,203657,160239,43418,0,0
4428503,1673,4,3935370,4043560,4428503,384943,493133,310110,183023,32,0
4438065,1859,16,4259639,4405104,4438065,32961,178426,32961,145465,0,0
4439486,1963,1,4419234,4419234,4439486,20252,20252,20252,0,0,0
4441390,1959,4,4392568,4392568,4441390,48822,48822,48822,0,0,0
4442943,1969,4,4432125,4438065,4442943,4878,10818,4878,5940,0,0
4449175,1798,1,4125138,4125138,4449175,324037,324037,324037,0,0,0
4451462,1931,1,4353126,4353126,4451462,98336,98336,98336,0,0,0
4452670,1369,1,3427983,3440782,4452670,1011888,1024687,1011330,13357,55,0
4454044,1853,8,4235084,4327840,4454044,126204,218960,106969,111991,16,0
4454476,1848,1,4225088,4225088,4454476,229388,229388,229388,0,0,0
4456016,81,1,1064146,1064146,4456016,3391870,3391870,2840252,551618,848,0
4460122,1683,1,3949616,3949616,4460122,510506,510506,510506,0,0,0
4472816,1897,1,4306419,4306419,4472816,166397,166397,166397,0,0,0
4479397,1981,1,4477866,4477866,4479397,1531,1531,1531,0,0,0
4500544,1992,1,4491156,4491156,4500544,9388,9388,9388,0,0,0
4500680,1948,4,4374344,4374344,4500680,126336,126336,126336,0,0,0
4500761,1986,1,4486285,4486285,4500761,14476,14476,14476,0,0,0
4503051,397,1,1690793,1690793,4503051,2812258,2812258,2234085,578173,747,0
4505099,1832,1,4208644,4208644,4505099,296455,296455,296455,0,0,0
4507141,1411,1,3487778,3487778,4507141,1019363,1019363,1014801,4562,33,0
4510566,1887,1,4299094,4299094,4510566,211472,211472,211472,0,0,0
4511437,1993,1,4498182,4498182,4511437,13255,13255,13255,0,0,0
4514385,1639,2,3798179,3798179,4514385,716206,716206,716206,0,104,0
4514468,1794,1,4124658,4124658,4514468,389810,389810,389810,0,0,0
4520513,1842,4,4221846,4270880,4520513,249633,298667,233351,65316,6,0
4523705,1997,1,4499824,4499824,4523705,23881,23881,23881,0,0,0
4527182,1977,4,4457783,4457783,4527182,69399,69399,69399,0,0,0
4529111,1170,1,3166276,3166276,4529111,1362835,1362835,1265437,97398,150,0
4540715,1994,1,4498787,4498787,4540715,41928,41928,41928,0,0,0
4548175,1967,4,4429857,4438065,4548175,110110,118318,110110,8208,0,0
4549121,1951,8,4375559,4428503,4549121,120618,173562,120618,52944,0,0
4556685,1885,1,4298860,4298860,4556685,257825,257825,257825,0,0,0
4560325,1966,4,4429473,4438065,4560325,122260,130852,122260,8592,0,0
4565114,1970,8,4432290,4441390,4565114,123724,132824,123724,9100,0,0
4568455,455,1,1691921,1792579,4568455,2775876,2876534,2240023,636511,747,0
4578843,1597,8,3761840,4454044,4578843,124799,817003,124799,692204,0,0
4583809,1267,1,3342636,3342636,4583809,1241173,1241173,1135266,105907,84,0
4587389,1837,1,4214501,4214501,4587389,372888,372888,372888,0,0,0
4593397,1780,1,4101388,4101388,4593397,492009,492009,492009,0,0,0
4597662,1983,1,4483812,4483812,4597662,113850,113850,113850,0,0,0
4602655,1725,1,4006238,4006238,4602655,596417,596417,596417,0,0,0
4605145,1996,1,4499762,4499762,4605145,105383,105383,105383,0,0,0
4610578,1858,4,4256980,4288854,4610578,321724,353598,244006,109592,18,0
4610972,1978,4,4457837,4500680,4610972,110292,153135,110292,42843,0,0
4614502,986,1,2845707,3134715,4614502,1479787,1768795,1351577,417218,176,0
4614562,1556,1,3692921,3692921,4614562,921641,921641,921641,0,4,0
4630507,1292,1,3360328,3394974,4630507,1235533,1270179,1153033,117146,90,0
4648163,463,1,1692088,1792698,4648163,2855465,2956075,2250864,705211,771,0
4652196,1884,1,4298657,4298657,4652196,353539,353539,353539,0,0,0
4659290,1957,4,4392357,4392357,4659290,266933,266933,244300,22633,2,0
4664861,1795,1,4124720,4124720,4664861,540141,540141,540141,0,0,0
4674098,1647,1,3827424,3827424,4674098,846674,846674,846674,0,0,0
4677772,1791,8,4122404,4548175,4677772,129597,555368,129597,425771,0,0
4683113,1962,8,4417213,4549121,4683113,133992,265900,133992,131908,0,0
4693303,1712,1,3961974,3961974,4693303,731329,731329,731329,0,0,0
4695107,1991,1,4489242,4489242,4695107,205865,205865,205865,0,0,0
4700497,1654,8,3841532,4565114,4700497,135383,858965,135383,723582,0,0
4711920,1811,1,4156320,4156320,4711920,555600,555600,555600,0,0,0
4717802,1419,8,3501455,4578843,4717802,138959,1216347,138959,1077388,0,0
4734544,1735,1,4016780,4016780,4734544,717764,717764,717764,0,0,0
4748152,889,1,2745477,2745477,4748152,2002675,2002675,1452851,549824,260,0
4751508,1460,8,3537448,4610972,4751508,140536,1214060,140536,1073524,0,0
4770039,1888,1,4299244,4299244,4770039,470795,470795,470795,0,0,0
4772023,1505,1,3617543,3617543,4772023,1154480,1154480,1131698,22782,46,0
4778539,1985,4,4485874,4520513,4778539,258026,292665,258026,34639,0,0
4785401,1898,1,4307079,4307079,4785401,478322,478322,478322,0,0,0
4789320,1663,1,3864395,3864395,4789320,924925,924925,924925,0,0,0
4791551,1542,1,3654916,3654916,4791551,1136635,1136635,1136635,0,35,0
4810502,1518,1,3622628,3649958,4810502,1160544,1187874,1160544,27330,46,0
4819191,1905,8,4309641,4677772,4819191,141419,509550,141419,368131,0,0
4827422,1599,8,3764063,4683113,4827422,144309,1063359,144309,919050,0,0
4836511,1225,1,3193632,3224357,4836511,1612154,1642879,1432210,210669,254,0
4845248,1757,8,4050950,4700497,4845248,144751,794298,144751,649547,0,0
4848451,1777,1,4095020,4095020,4848451,753431,753431,753431,0,0,0
4853650,1934,1,4353128,4353128,4853650,500522,500522,500522,0,0,0
4859018,1317,1,3363638,3471573,4859018,1387445,1495380,1347932,147448,220,0
4867640,1918,8,4318247,4717802,4867640,149838,549393,149838,399555,0,0
4868043,1886,1,4298927,4298927,4868043,569116,569116,569116,0,0,0
4869675,989,4,2855387,3513082,4869675,1356593,2014288,378347,1635941,31,0
4884956,530,1,1944018,1944018,4884956,2940938,2940938,2138407,802531,710,0
4891165,1816,1,4174044,4174044,4891165,717121,717121,717121,0,0,0
4902926,1410,8,3486210,4751508,4902926,151418,1416716,151418,1265298,0,0
4917070,1367,1,3426742,3476171,4917070,1440899,1490328,1391934,98394,227,0
4923730,1668,1,3900131,3900131,4923730,1023599,1023599,1023599,0,16,0
4946326,1933,1,4353128,4353128,4946326,593198,593198,593198,0,0,0
4953095,1953,1,4384611,4384611,4953095,568484,568484,568484,0,0,0
4956672,947,1,2810948,3156962,4956672,1799710,2145724,1510108,635616,293,0
4971776,715,8,2319624,4819191,4971776,152585,2652152,152585,2499567,0,0
4975635,1623,1,3794720,3794720,4975635,1180915,1180915,1180915,0,48,0
4978459,1999,1,4508448,4508448,4978459,470011,470011,470011,0,0,0
4980576,1066,8,3001711,4827422,4980576,153154,1978865,153154,1825711,0,0
4986011,1929,1,4353125,4353125,4986011,632886,632886,632886,0,0,0
4987184,448,1,1691744,1792901,4987184,3194283,3295440,2301054,994386,803,0
5001567,878,8,2738352,4845248,5001567,156319,2263215,156319,2106896,0,0
5022177,1818,1,4185054,4185054,5022177,837123,837123,837123,0,4,0
5031528,1158,8,3114803,4867640,5031528,163888,1916725,163888,1752837,0,0
5036368,1248,8,3260958,4869675,5036368,166693,1775410,166693,1608717,0,0
5037347,1208,1,3193562,3299483,5037347,1737864,1843785,1496549,347236,313,0
5040276,964,4,2828503,4610578,5040276,429698,2211773,381380,1830393,8,0
5062410,1298,1,3361170,3500204,5062410,1562206,1701240,1483900,217340,364,0
5070712,1950,8,4375472,4902926,5070712,167786,695240,167786,527454,0,0
5095821,1395,1,3445055,3500452,5095821,1595369,1650766,1512402,138364,389,0
5122608,1220,1,3193608,3310579,5122608,1812029,1929000,1529093,399907,401,0
5140537,1088,8,3028259,4971776,5140537,168761,2112278,168761,1943517,0,0
5145229,1210,1,3193572,3507557,5145229,1637672,1951657,1533888,417769,434,0
5149447,1067,8,3001927,4980576,5149447,168871,2147520,168871,1978649,0,0
5173018,1879,1,4291700,4291700,5173018,881318,881318,878109,3209,78,0
5173035,1741,4,4021739,4778539,5173035,394496,1151296,394496,756800,3,0
5174113,891,8,2753751,5001567,5174113,172546,2420362,172546,2247816,0,0
5182530,453,1,1691844,1792986,5182530,3389544,3490686,2301568,1189118,958,0
5205571,1841,8,4218711,5031528,5205571,174043,986860,174043,812817,0,0
5214779,665,8,2209978,5036368,5214779,178411,3004801,178411,2826390,0,0
5245525,1320,1,3365017,3507557,5245525,1737968,1880508,1573695,306813,532,0
5252139,1265,8,3342378,5070712,5252139,181427,1909761,181427,1728334,0,0
5254612,1636,1,3797987,3797987,5254612,1456625,1456625,1448291,8334,413,0
5271851,1531,1,3625213,3678065,5271851,1593786,1646638,1562185,84453,534,0
5296333,1964,1,4420096,4420096,5296333,876237,876237,876237,0,0,0
5297433,1083,1,3018485,3163105,5297433,2134328,2278948,1579621,699327,539,0
5324714,961,8,2826337,5140537,5324714,184177,2498377,184177,2314200,0,0
5337443,1326,8,3365948,5149447,5337443,187996,1971495,187996,1783499,0,0
5361916,1010,8,2891585,5173035,5361916,188881,2470331,188881,2281450,0,0
5369501,1809,8,4149178,5174113,5369501,195388,1220323,195388,1024935,0,0
5374739,1047,1,2978463,3683815,5374739,1690924,2396276,1620757,775519,532,0
5404455,702,16,2308613,5369501,5404455,34954,3095842,34954,3060888,0,0
5411682,1421,8,3501680,5205571,5411682,206111,1910002,206111,1703891,0,0
5413404,1867,1,4269940,4269940,5413404,1143464,1143464,1080780,62684,69,0
5420009,1882,1,4294766,4294766,5420009,1125243,1125243,1060394,64849,51,0
5420967,975,8,2838323,5214779,5420967,206188,2582644,206188,2376456,0,0
5430438,845,4,2662324,2717431,5430438,2713007,2768114,420001,2348113,17,0
5446616,1875,16,4284419,5404455,5446616,42161,1162197,42161,1120036,0,0
5454697,437,1,1691493,1800277,5454697,3654420,3763204,2303199,1460005,923,0
5459610,561,8,1978879,5252139,5459610,207471,3480731,207471,3273260,1,0
5474869,1165,4,3156678,5062410,5474869,412459,2318191,412459,1905732,0,0
5489979,874,16,2737382,5446616,5489979,43363,2752597,43363,2709234,0,0
5494120,1234,1,3193667,3684927,5494120,1809193,2300453,1671124,629329,498,0
5513312,1171,1,3166329,3687356,5513312,1825956,2346983,1672773,674210,484,0
5535674,1491,8,3611737,5324714,5535674,210960,1923937,210960,1712977,0,0
5539126,1814,1,4170856,4170856,5539126,1368270,1368270,1274498,93772,156,0
5544355,1881,16,4292869,5489979,5544355,54376,1251486,54376,1197110,0,0
5552362,664,8,2207663,5337443,5552362,214919,3344699,214919,3129780,0,0
5554985,855,4,2703279,5095821,5554985,459164,2851706,459164,2392542,2,0
5564731,1314,1,3363614,3702059,5564731,1862672,2201117,1700620,500497,493,0
5601345,643,16,2158700,5544355,5601345,56990,3442645,56990,3385655,0,0
5621908,1422,8,3501849,5361916,5621908,259992,2120059,217811,1902248,2,0
5622597,1759,16,4052828,5552362,5622597,70235,1569769,70235,1499534,0,0
5625357,921,4,2788649,5145229,5625357,480128,2836708,470633,2366075,5,0
5629900,1928,1,4353064,4410375,5629900,1219525,1276836,1217562,59274,66,0
5639967,1921,8,4332923,5420967,5639967,219000,1307044,219000,1088044,1,0
5652749,456,1,1691940,1803574,5652749,3849175,3960809,2308684,1652125,821,0
5669834,863,2,2736378,4614562,5669834,1055272,2933456,1055272,1878184,35,0
5671672,1365,16,3420130,5601345,5671672,70327,2251542,70327,2181215,0,0
5682264,1730,1,4014622,4014622,5682264,1667642,1667642,1515033,152609,280,0
5682442,1466,8,3545877,5459610,5682442,222832,2136565,222832,1913733,0,0
5703166,788,16,2480259,5622597,5703166,80569,3222907,80569,3142338,0,0
5708010,624,1,2137254,2137254,5708010,3570756,3570756,2132994,1437762,640,0
5717894,1336,8,3370630,5494120,5717894,223774,2347264,223774,2123490,1,0
5720731,1153,16,3114349,5639967,5720731,80764,2606382,80764,2525618,0,0
5754182,216,16,1283033,5671672,5754182,82510,4471149,82510,4388639,0,0
5772436,1273,8,3345422,5535674,5772436,236762,2427014,224393,2202621,3,0
5783731,1895,1,4306246,4425893,5783731,1357838,1477485,1339806,137679,53,0
5785682,680,16,2234146,5703166,5785682,82516,3551536,82516,3469020,0,0
5809989,442,1,1691594,1803964,5809989,4006025,4118395,2328942,1789453,720,0
5810432,768,16,2420131,5720731,5810432,89701,3390301,89701,3300600,0,0
5847356,810,16,2509422,5754182,5847356,93174,3337934,93174,3244760,0,0
5879763,85,16,1078287,5785682,5879763,94081,4801476,94081,4707395,0,0
5892092,1755,8,4044761,5621908,5892092,270184,1847331,227709,1619622,4,0
5907088,1554,16,3692119,5810432,5907088,96656,2214969,96656,2118313,0,0
5911849,1973,4,4434399,5430438,5911849,481411,1477450,481411,996039,4,0
5913463,1372,1,3428118,3753850,5913463,2159613,2485345,1889794,595551,393,0
5945192,965,16,2828509,5847356,5945192,97836,3116683,97836,3018847,0,0
5946157,1862,8,4260520,5717894,5946157,228263,1685637,228263,1457374,1,0
5968094,1771,1,4087394,4087394,5968094,1880700,1880700,1630850,249850,154,0
5982297,62,16,1022622,5879763,5982297,102534,4959675,102534,4857141,0,0
6019733,307,8,1604537,5783731,6019733,236002,4415196,236002,4179194,1,0
6022951,1943,16,4363214,5907088,6022951,115863,1659737,115863,1543874,1,0
6060131,1236,1,3193678,3757458,6060131,2302673,2866453,1903723,962730,307,0
6089063,1952,4,4384596,5474869,6089063,614194,1704467,492703,1211764,7,0
6129267,1604,8,3769926,5892092,6129267,237175,2359341,237175,2122166,1,0
6158513,1180,1,3193437,3757599,6158513,2400914,2965076,1956454,1008622,274,0
6183830,1399,8,3448088,5945192,6183830,238638,2735742,238638,2497104,0,0
6184419,679,8,2234074,5945192,6184419,239227,3950345,239227,3711118,0,0
6185990,1589,4,3744316,5682442,6185990,503548,2441674,503548,1938126,5,0
6202341,1761,8,4053758,5946157,6202341,256184,2148583,256184,1892399,0,0
6222081,1195,1,3193505,3760326,6222081,2461755,3028576,1958210,1070366,229,0
6244005,1849,8,4225292,5982297,6244005,261708,2018713,261708,1757005,0,0
6282812,421,1,1690902,1804519,6282812,4478293,4591910,2414985,2176925,447,0
6284518,1148,8,3099547,6019733,6284518,264785,3184971,264785,2920186,0,0
6288130,1588,8,3718944,6022951,6288130,265179,2569186,265179,2304007,0,0
6290740,698,8,2305032,6022951,6290740,267789,3985708,267789,3717919,0,0
6306036,268,4,1542152,1545292,6306036,4760744,4763884,635677,4128207,52,0
6349655,1169,1,3165603,3869114,6349655,2480541,3184052,1976531,1207521,148,0
6398293,830,8,2560075,6129267,6398293,269026,3838218,269026,3569192,0,0
6422576,1694,1,3960254,3993579,6422576,2428997,2462322,1900906,561416,75,0
6456478,621,8,2126772,6183830,6456478,272648,4329706,272648,4057058,0,0
6463938,802,8,2492333,6184419,6463938,279519,3971605,279519,3692086,0,0
6492025,771,8,2435862,6202341,6492025,289684,4056163,289684,3766479,0,0
6498920,1291,1,3360284,3872581,6498920,2626339,3138636,2024780,1113856,93,0
6511280,1333,4,3370210,5982297,6511280,528983,3141070,528983,2612087,0,0
6545773,1160,1,3136944,3881684,6545773,2664089,3408829,2030335,1378494,77,0
6546704,846,4,2662348,5982297,6546704,564407,3884356,564407,3319949,0,0
6566024,1287,1,3359893,3891540,6566024,2674484,3206131,2036016,1170115,70,0
6579017,1275,8,3356017,6284518,6579017,294499,3223000,294499,2928501,0,0
6591993,61,8,1022485,1023955,6591993,5568038,5569508,591447,4978061,3,0
6637917,721,7,2329770,6288130,6637917,349787,4308147,349787,3958360,1,0
6660628,1342,4,3399195,6089063,6660628,571565,3261433,571565,2689868,0,0
6663943,752,1,2406374,2406374,6663943,4257569,4257569,2275682,1981887,144,0
6685252,1595,1,3760386,3924671,6685252,2760581,2924866,2109087,815779,66,0
6700870,506,8,1872651,6398293,6700870,302577,4828219,302577,4525642,0,0
6713307,710,1,2313989,2326221,6713307,4387086,4399318,2330052,2069266,152,0
6716742,1359,1,3412047,4605145,6716742,2111597,3304695,2111597,1193098,54,0
6756906,1338,1,3371378,4614502,6756906,2142404,3385528,2126459,1259069,52,0
6763628,494,4,1845683,6185990,6763628,577638,4917945,577638,4340307,0,0
6775406,1805,8,4138343,6463938,6775406,311468,2637063,311468,2325595,0,0
6777740,1187,1,3193467,4648163,6777740,2129577,3584273,2129577,1454696,53,0
6788732,1120,1,3065304,4652196,6788732,2136536,3723428,2136536,1586892,54,0
6803580,860,8,2725043,6492025,6803580,311555,4078537,311555,3766982,0,0
6826766,1987,4,4486847,6244005,6826766,582761,2339919,582761,1757158,0,0
6828167,937,1,2805539,4664861,6828167,2163306,4022628,2163306,1859322,59,0
6836865,523,4,1931786,6244005,6836865,592860,4905079,592860,4312219,0,0
6856652,1178,1,3188566,4674098,6856652,2182554,3668086,2182554,1485532,62,0
6881073,1416,4,3499991,6288130,6881073,592943,3381082,592943,2788139,0,0
6887981,376,1,1690299,1690299,6887981,5197682,5197682,2540557,2657125,287,0
6891473,1324,1,3365714,4695107,6891473,2196366,3525759,2196366,1329393,61,0
6899392,1790,8,4120747,6579017,6899392,320375,2778645,320375,2458270,0,0
6913584,1974,8,4438429,6591993,6913584,321591,2475155,321591,2153564,0,0
6923638,1984,4,4485312,6306036,6923638,617602,2438326,617602,1820724,0,0
6937809,1958,1,4392441,4711920,6937809,2225889,2545368,2225889,319479,60,0
6982237,1177,1,3188296,4734544,6982237,2247693,3793941,2247693,1546248,61,0
7021413,1479,1,3595701,4748152,7021413,2273261,3425712,2273261,1152451,62,0
7031461,1942,8,4363039,6700870,7031461,330591,2668422,330591,2337831,0,0
7053659,106,1,1095885,1095885,7053659,5957774,5957774,3118042,2839732,365,0
7061524,1073,1,3005327,4772023,7061524,2289501,4056197,2289501,1766696,63,0
7076630,753,4,2406387,6456478,7076630,620152,4670243,620152,4050091,0,0
7076854,1185,1,3193459,4785401,7076854,2291453,3883395,2291453,1591942,62,0
7109780,719,8,2325593,6775406,7109780,334374,4784187,334374,4449813,0,0
7110390,1256,4,3310232,6456478,7110390,653912,3800158,653912,3146246,1,0
7132655,844,1,2662314,4789320,7132655,2343335,4470341,2343335,2127006,63,0
7147186,786,8,2479196,6803580,7147186,343606,4667990,343606,4324384,0,0
7154575,1288,1,3359921,4791551,7154575,2363024,3794654,2363024,1431630,65,0
7166257,1592,4,3746495,6511280,7166257,654977,3419762,654977,2764785,0,0
7202486,1425,1,3502396,4810502,7202486,2391984,3700090,2391984,1308106,71,0
7221421,1751,4,4040500,6546704,7221421,674717,3180921,674717,2506204,0,0
7246887,132,1,1161486,1161486,7246887,6085401,6085401,3087265,2998136,359,0
7247736,1810,8,4151057,6899392,7247736,348344,3096679,348344,2748335,0,0
7263859,723,8,2330062,6913584,7263859,350275,4933797,350275,4583522,0,0
7292812,1656,1,3844194,4848451,7292812,2444361,3448618,2418423,1030195,69,0
7304666,1056,1,2991676,4853650,7304666,2451016,4312990,2418869,1894121,69,0
7326948,735,4,2373644,6637917,7326948,689031,4953304,689031,4264273,0,0
7339438,872,1,2736623,4917070,7339438,2422368,4602815,2422368,2180447,67,0
7369396,471,4,1712391,6660628,7369396,708768,5657005,708768,4948237,1,0
7382007,734,8,2372549,7031461,7382007,350546,5009458,350546,4658912,0,0
7411811,1584,1,3708703,4923730,7411811,2488081,3703108,2425086,1278022,67,0
7449964,1916,1,4313042,4946326,7449964,2503638,3136922,2431556,705366,66,0
7474651,1784,8,4105774,7109780,7474651,364871,3368877,364871,3004006,0,0
7482416,1906,4,4309920,6763628,7482416,718788,3172496,718788,2453708,0,0
7514363,716,8,2322470,7147186,7514363,367177,5191893,367177,4824716,0,0
7525627,108,1,1098912,1098912,7525627,6426715,6426715,3182484,3244231,353,0
7561025,902,4,2759413,6826766,7561025,734259,4801612,734259,4067353,0,0
7576378,910,8,2769942,7202486,7576378,373892,4806436,373892,4432544,0,0
7588117,806,1,2497555,4956672,7588117,2631445,5090562,2480341,2610221,63,0
7591053,1807,4,4139356,6836865,7591053,754188,3451697,754188,2697509,0,0
7624997,1025,8,2899350,7247736,7624997,377261,4725647,377261,4348386,0,0
7635538,298,4,1601053,6881073,7635538,754465,6034485,754465,5280020,2,0
7641338,746,8,2388184,7263859,7641338,377479,5253154,377479,4875675,0,0
7644606,398,1,1690800,1816988,7644606,5827618,5953806,2649615,3304191,168,0
7698262,1773,4,4089784,6923638,7698262,774624,3608478,774624,2833854,1,0
7750543,225,8,1300071,1475498,7750543,6275045,6450472,498668,5951804,1,0
7773022,883,8,2742538,7382007,7773022,391015,5030484,391015,4639469,0,0
7856187,306,4,1603522,7076630,7856187,779557,6252665,779557,5473108,1,0
7880073,266,8,1523791,7474651,7880073,405422,6356282,405422,5950860,0,0
7914466,967,4,2830160,7110390,7914466,804076,5084306,804076,4280230,2,0
7920713,1666,8,3876531,7514363,7920713,406350,4044182,406350,3637832,0,0
7961660,163,1,1167711,1183981,7961660,6777679,6793949,3166082,3627867,316,0
7984129,1299,8,3361217,7576378,7984129,407751,4622912,407751,4215161,0,0
7998991,772,8,2446000,7591053,7998991,407938,5552991,407938,5145053,0,0
8041588,1435,8,3515188,7624997,8041588,416591,4526400,416591,4109809,1,0
8043305,974,4,2837460,7166257,8043305,877048,5205845,831798,4374047,2,0
8064787,811,8,2512642,7641338,8064787,423449,5552145,423449,5128696,0,0
8123632,1021,1,2894838,4986011,8123632,3137621,5228794,2585400,2643394,41,0
8177340,652,8,2190994,7750543,8177340,426797,5986346,426797,5559549,0,0
8296245,1123,1,3068989,4987184,8296245,3309061,5227256,2609499,2617757,32,0
8310193,765,8,2419952,7880073,8310193,430120,5890241,430120,5460121,0,0
8329536,818,4,2533763,7482416,8329536,847120,5795773,847120,4948653,2,0
8355000,1130,8,3075245,7920713,8355000,434287,5279755,434287,4845468,0,0
8433948,940,8,2807448,7984129,8433948,449819,5626500,449819,5176681,0,0
8450363,1743,8,4029548,7998991,8450363,451372,4420815,451372,3969443,0,0
8463799,689,1,2261952,5022177,8463799,3441622,6201847,2655509,3546338,23,0
8507904,1029,8,2907856,8043305,8507904,464599,5600048,464599,5135449,0,0
8531850,1113,8,3059668,8064787,8531850,467063,5472182,467063,5005119,0,0
8546149,1447,1,3520575,5037347,8546149,3508802,5025574,2669222,2356352,17,0
8577477,1904,4,4309171,7698262,8577477,879215,4268306,879215,3389091,1,0
8644875,958,8,2822534,8177340,8644875,467535,5822341,467535,5354806,0,0
8671965,1866,4,4263429,7773022,8671965,898943,4408536,898943,3509593,0,0
8676614,1770,1,4087366,5772436,8676614,2904178,4589248,2719815,1869433,14,0
8780446,858,8,2705757,8310193,8780446,470253,6074689,470253,5604436,0,0
8832177,823,4,2541525,7914466,8832177,917711,6290652,917711,5372941,1,0
8844442,1998,8,4505802,8355000,8844442,489442,4338640,489442,3849198,0,0
8890224,1055,1,2991565,6060131,8890224,2830093,5898659,2830093,3068566,16,0
8899940,1334,4,3370237,7961660,8899940,938280,5529703,938280,4591423,2,0
8939839,683,8,2239109,8450363,8939839,489476,6700730,489476,6211254,0,0
9005251,1142,8,3088041,8507904,9005251,497347,5917210,497347,5419863,0,0
9047482,208,8,1272262,8531850,9047482,515632,7775220,515632,7259588,0,0
9054309,386,1,1690717,1690717,9054309,7363592,7363592,2956127,4407465,105,0
9168697,1620,8,3790518,8644875,9168697,523822,5378179,523822,4854357,0,0
9193654,1629,1,3796510,6222081,9193654,2971573,5397144,2837127,2560017,12,0
9317909,666,8,2215343,8780446,9317909,537463,7102566,537463,6565103,0,0
9340798,919,4,2786492,8041588,9340798,1299210,6554306,1012979,5541327,3,0
9343168,770,2,2427939,7339438,9343168,2003730,6915229,1812101,5103128,8,0
9354059,1930,1,4353126,6282812,9354059,3071247,5000933,2860457,2140476,9,0
9382250,1940,8,4355438,8844442,9382250,537808,5026812,537808,4489004,0,0
9410348,677,1,2227724,6545773,9410348,2864575,7182624,2864575,4318049,5,0
9474179,564,2,1979172,7561025,9474179,1913154,7495007,1868669,5626338,8,0
9489864,1028,8,2907066,8939839,9489864,550025,6582798,550025,6032773,0,0
9497654,1204,1,3193548,6566024,9497654,2931630,6304106,2931630,3372476,6,0
9557592,650,8,2189591,9005251,9557592,552341,7368001,552341,6815660,0,0
9563115,578,4,1999889,8433948,9563115,1129167,7563226,1129167,6434059,4,0
9581222,435,1,1691432,1833192,9581222,7748030,7889790,3062415,4827375,85,0
9587145,793,1,2483261,6637917,9587145,2949228,7103884,2949228,4154656,7,0
9603211,1380,8,3439192,9047482,9603211,555729,6164019,555729,5608290,1,0
9611366,684,1,2243824,6637917,9611366,2973449,7367542,2973449,4394093,9,0
9640963,441,1,1691572,1833699,9640963,7807264,7949391,3079487,4869904,72,0
9711935,1112,4,3059288,8577477,9711935,1134458,6652647,1134458,5518189,1,0
9730005,449,1,1691765,1839870,9730005,7890135,8038240,3109980,4928260,53,0
9730579,897,8,2755596,9168697,9730579,561882,6974983,561882,6413101,1,0
9797611,434,1,1691413,1932794,9797611,7864817,8106198,3110172,4996026,31,0
9803486,1576,1,3707853,6716742,9803486,3086744,6095633,3086744,3008889,10,0
9812207,1627,4,3796469,8671965,9812207,1140242,6015738,1140242,4875496,1,0
9849483,1018,1,2893819,6756906,9849483,3092577,6955664,3092577,3863087,13,0
9891785,38,8,961993,961993,9891785,8929792,8929792,707797,8221995,4,0
9900465,413,1,1690879,1932794,9900465,7967671,8209586,3129753,5079833,17,0
9958248,623,8,2136763,9382250,9958248,575998,7821485,575998,7245487,1,0
9963389,1199,1,3193525,6788732,9963389,3174657,6769864,3174657,3595207,13,0
9991106,1434,4,3514253,8832177,9991106,1158929,6476853,1158929,5317924,2,0
10031393,1471,1,3580208,6828167,10031393,3203226,6451185,3203226,3247959,12,0
10067856,210,8,1273276,9489864,10067856,577992,8794580,577992,8216588,1,0
10105538,1231,1,3193655,6856652,10105538,3248886,6911883,3248886,3662997,13,0
10149332,1188,1,3193471,6887981,10149332,3261351,6955861,3261351,3694510,14,0
10150770,1605,8,3770058,9557592,10150770,593178,6380712,593178,5787534,1,0
10151634,1980,4,4471989,8939839,10151634,1211795,5679645,1211795,4467850,3,0
10155634,1131,1,3078680,6891473,10155634,3264161,7076954,3264161,3812793,13,0
10201538,1469,8,3571147,9603211,10201538,598327,6630391,598327,6032064,1,0
10211435,1507,1,3617610,6937809,10211435,3273626,6593825,3273626,3320199,12,0
10284447,1935,1,4353129,6982237,10284447,3302210,5931318,3302210,2629108,14,0
10331408,700,8,2305409,9730579,10331408,600829,8025999,600829,7425170,0,0
10348356,424,1,1690915,7021413,10348356,3326943,8657441,3326943,5330498,16,0
10405060,1397,1,3445118,7053659,10405060,3351401,6959942,3351401,3608541,17,0
10436581,1510,1,3618823,7061524,10436581,3375057,6817758,3375057,3442701,16,0
10512636,732,8,2365646,9891785,10512636,620851,8146990,620851,7526139,1,0
10560092,870,4,2736582,9343168,10560092,1216924,7823510,1216924,6606586,4,0
10579704,726,8,2336802,9958248,10579704,621456,8242902,621456,7621446,1,0
10608078,1430,1,3510026,7076854,10608078,3531224,7098052,3512289,3585763,17,0
10692707,581,8,2001905,10067856,10692707,624851,8690802,624851,8065951,0,0
10717109,670,1,2223204,7132655,10717109,3584454,8493905,3520443,4973462,15,0
10769069,843,1,2662291,7154575,10769069,3614494,8106778,3538629,4568149,15,0
10777754,1562,8,3703503,10150770,10777754,626984,7074251,626984,6447267,2,0
10785657,1956,4,4389794,9563115,10785657,1222542,6395863,1222542,5173321,3,0
10833337,1309,8,3362801,10201538,10833337,631799,7470536,631799,6838737,1,0
10886238,1892,1,4305861,7221421,10886238,3664817,6580377,3585605,2994772,16,0
10960121,615,4,2008419,9711935,10960121,1248186,8951702,1248186,7703516,2,0
10966383,96,1,1095354,1095354,10966383,9871029,9871029,4146987,5724042,242,0
10969654,224,16,1297699,10785657,10969654,183997,9671955,183997,9487958,0,0
10978810,1808,8,4139733,10331408,10978810,647402,6839077,647402,6191675,1,0
11022267,415,1,1690884,7326948,11022267,3695319,9331383,3614751,5716632,16,0
11084006,1924,4,4340515,9812207,11084006,1271799,6743491,1271799,5471692,1,0
11155070,1138,16,3082912,10969654,11155070,185416,8072158,185416,7886742,0,0
11167174,988,8,2855060,10512636,11167174,654538,8312114,654538,7657576,0,0
11178004,33,16,952206,975592,11178004,10202412,10225798,389016,9836782,1,0
11255156,1206,1,3193555,7326948,11255156,3928208,8061601,3697534,4364067,10,0
11277283,1971,4,4433484,9991106,11277283,1286177,6843799,1286177,5557622,1,0
11379400,1341,16,3374520,11155070,11379400,224330,8004880,224330,7780550,0,0
11404967,1223,1,3193624,7588117,11404967,3816850,8211343,3772365,4438978,7,0
11425846,211,16,1275933,11178004,11425846,247842,10149913,247842,9902071,0,0
11459256,537,1,1952436,7644606,11459256,3814650,9506820,3814650,5692170,4,0
11477612,1989,4,4487642,10151634,11477612,1325978,6989970,1325978,5663992,3,0
11615540,1058,1,2991699,7773022,11615540,3842518,8623841,3842518,4781323,8,0
11634142,1205,1,3193551,7773022,11634142,3861120,8440591,3861120,4579471,8,0
11644430,1189,1,3193474,7773022,11644430,3871408,8450956,3871408,4579548,8,0
11644990,1478,16,3595699,11379400,11644990,265590,8049291,265590,7783701,0,0
11707850,1307,16,3362445,11425846,11707850,282004,8345405,282004,8063401,0,0
11720114,1212,1,3193578,7773022,11720114,3947092,8526536,3947092,4579444,10,0
11870816,668,8,2220318,10777754,11870816,1093062,9650498,711545,8938953,2,0
11891535,934,1,2803110,7856187,11891535,4035348,9088425,4035348,5053077,12,0
11903017,968,4,2830704,10560092,11903017,1342925,9072313,1342925,7729388,2,0
11930417,194,4,1251798,1360448,11930417,10569969,10678619,1399368,9279251,16,0
11930980,236,16,1368361,11644990,11930980,285990,10562619,285990,10276629,0,0
11934628,1546,4,3661160,10579704,11934628,1354924,8273468,1354924,6918544,2,0
12008712,1408,16,3484665,11707850,12008712,300862,8524047,300862,8223185,0,0
12047037,465,1,1692806,7856187,12047037,4190850,10354231,4110922,6243309,11,0
12056234,1012,4,2891765,10692707,12056234,1363527,9164469,1363527,7800942,2,0
12187353,983,4,2842212,10692707,12187353,1494646,9345141,1446966,7898175,5,0
12191334,587,8,2007731,11477612,12191334,713722,10183603,713722,9469881,0,0
12222702,804,16,2495758,11903017,12222702,319685,9726944,319685,9407259,0,0
12243668,1002,1,2882601,7856187,12243668,4387481,9361067,4307553,5053514,13,0
12268274,65,16,1023955,11930980,12268274,337294,11244319,337294,10907025,1,0
12291265,11,1,880119,880119,12291265,11411146,11411146,5106406,6304740,278,0
12348068,279,16,1583559,12008712,12348068,339356,10764509,339356,10425153,0,0
12388195,841,4,2662218,10833337,12388195,1554858,9725977,1511401,8214576,6,0
12530076,1624,1,3794751,8041588,12530076,4488488,8735325,4488488,4246837,11,0
12570439,74,16,1041491,12222702,12570439,347737,11528948,347737,11181211,0,0
12580407,1968,4,4431138,10960121,12580407,1620286,8149269,1515090,6634179,7,0
12747292,722,8,2329815,11870816,12747292,876476,10417477,723259,9694218,2,0
12811637,1972,4,4434338,11277283,12811637,1534354,8377299,1534354,6842945,4,0
12903685,1717,1,3969174,8123632,12903685,4780053,8934511,4780053,4154458,13,0
12922043,801,8,2487790,12191334,12922043,730709,10434253,730709,9703544,1,0
13014147,565,8,1980098,12268274,13014147,745873,11034049,745873,10288176,1,0
13015833,881,8,2739645,12268274,13015833,747559,10276188,747559,9528629,1,0
13101499,764,8,2419614,12348068,13101499,753431,10681885,753431,9928454,0,0
13103205,859,8,2712874,12348068,13103205,755137,10390331,755137,9635194,1,0
13162089,1200,1,3193529,8296245,13162089,4865844,9968560,4865844,5102716,16,0
13264720,172,4,1195817,1209590,13264720,12055130,12068903,1559851,10509052,11,0
13302150,1196,1,3193509,8433948,13302150,4868202,10108641,4868202,5240439,14,0
13325750,1920,8,4323830,12570439,13325750,755311,9001920,755311,8246609,0,0
13326267,1660,8,3849703,12570439,13326267,755828,9476564,755828,8720736,1,0
13335786,1370,1,3428071,8433948,13335786,4901838,9907715,4901838,5005877,16,0
13394954,1190,1,3193479,8433948,13394954,4961006,10201475,4961006,5240469,19,0
13401211,13,1,880165,880165,13401211,12521046,12521046,5695853,6825193,321,0
13452973,1227,1,3193640,8463799,13452973,4989174,10259333,4989174,5270159,20,0
13507796,1610,8,3777291,12747292,13507796,760504,9730505,760504,8970001,0,0
13562723,1218,1,3193600,8546149,13562723,5016574,10369123,5016574,5352549,17,0
13621491,253,4,1432085,11934628,13621491,1686863,12189406,1555744,10633662,7,0
13696403,1375,8,3435762,12922043,13696403,774360,10260641,774360,9486281,0,0
13725013,167,1,1167770,1193173,13725013,12531840,12557243,5485400,7071843,256,0
13794884,908,8,2769355,13014147,13794884,780737,11025529,780737,10244792,0,0
13797229,1748,8,4037207,13015833,13797229,781396,9760022,781396,8978626,0,0
13884536,1398,8,3447475,13101499,13884536,783037,10437061,783037,9654024,0,0
13904125,517,8,1895072,13103205,13904125,800920,12009053,800920,11208133,0,0
13950882,1197,1,3193513,8890224,13950882,5060658,10757369,5060658,5696711,14,0
14018655,1823,4,4188271,12388195,14018655,1630460,9830384,1630460,8199924,2,0
14089457,1217,1,3193597,8899940,14089457,5189517,10895860,5075047,5820813,13,0
14127703,542,8,1961540,13325750,14127703,801953,12166163,801953,11364210,0,0
14136760,185,8,1245296,13326267,14136760,810493,12891464,810493,12080971,0,0
14266966,222,4,1284745,12580407,14266966,1686559,12982221,1686559,11295662,2,0
14280140,158,1,1165528,1193173,14280140,13086967,13114612,5554576,7560036,242,0
14331099,733,8,2366023,13507796,14331099,823303,11965076,823303,11141773,0,0
14488332,1990,1,4489182,8899940,14488332,5588392,9999150,5187433,4811717,15,0
14500492,1286,1,3359853,8899940,14500492,5600552,11140639,5199593,5941046,16,0
14531456,493,8,1845539,13696403,14531456,835053,12685917,835053,11850864,0,0
14596248,1932,1,4353128,9340798,14596248,5255450,10243120,5244559,4998561,17,0
14635201,541,8,1959609,13794884,14635201,840317,12675592,840317,11835275,0,0
14642038,976,8,2838710,13797229,14642038,844809,11803328,844809,10958519,0,0
14716468,952,1,2811581,9340798,14716468,5375670,11904887,5308490,6596397,17,0
14737516,483,8,1774938,13884536,14737516,852980,12962578,852980,12109598,0,0
14760498,751,8,2405183,13904125,14760498,856373,12355315,856373,11498942,0,0
14791192,388,1,1690731,9474179,14791192,5317013,13100461,5317013,7783448,17,0
14799161,971,1,2836246,9474179,14799161,5324982,11962915,5324982,6637933,19,0
14874072,799,1,2485905,9497654,14874072,5376418,12388167,5376418,7011749,19,0
14959283,459,1,1692014,9581222,14959283,5378061,13267269,5378061,7889208,19,0
14989224,1090,8,3045237,14127703,14989224,861521,11943987,861521,11082466,0,0
14990856,148,1,1165345,1165345,14990856,13825511,13825511,5811505,8014006,231,0
15009519,1936,8,4353723,14136760,15009519,872759,10655796,872759,9783037,0,0
15015747,458,1,1692001,9611366,15015747,5404381,13323746,5404381,7919365,18,0
15050506,381,1,1690680,9640963,15050506,5409543,13359826,5409543,7950283,18,0
15162220,1652,1,3834993,9730005,15162220,5432215,11327227,5432215,5895012,19,0
15233733,443,1,1691611,9797611,15233733,5436122,13542122,5436122,8106000,19,0
15254197,510,8,1875106,14331099,15254197,923098,13379091,923098,12455993,0,0
15332040,1653,1,3837215,9803486,15332040,5528554,11494825,5528554,5966271,20,0
15393484,631,4,2152324,13621491,15393484,1771993,13241160,1771993,11469167,0,0
15406853,1104,1,3055694,9849483,15406853,5557370,12351159,5557370,6793789,19,0
15434293,865,2,2736420,10886238,15434293,4548055,12697873,3456627,9241246,15,0
15460454,1329,8,3367724,14531456,15460454,928998,12092730,928998,11163732,0,0
15470795,817,1,2532070,9900465,15470795,5570330,12938725,5570330,7368395,19,0
15539483,907,1,2768658,9963389,15539483,5576094,12770825,5576094,7194731,18,0
15580506,1414,8,3498818,14635201,15580506,945305,12081688,945305,11136383,0,0
15699405,1109,8,3057117,14737516,15699405,961889,12642288,961889,11680399,0,0
15727885,1482,8,3601585,14760498,15727885,967387,12126300,967387,11158913,0,0
15805708,50,1,999520,999520,15805708,14806188,14806188,6318472,8487716,266,0
15871045,1724,4,4005336,14018655,15871045,1852390,11865709,1852390,10013319,1,0
15968015,1760,8,4053733,14989224,15968015,978791,11914282,978791,10935491,0,0
15989626,125,8,1133603,15009519,15989626,980107,14856023,980107,13875916,0,0
16083731,869,1,2736572,10105538,16083731,5978193,13347159,5978193,7368966,22,0
16187772,368,1,1685688,1685688,16187772,14502084,14502084,6043073,8459011,35,0
16236058,1172,8,3167276,15254197,16236058,981861,13068782,981861,12086921,0,0
16348945,754,2,2406416,12811637,16348945,3537308,13942529,3537308,10405221,7,0
16366675,836,2,2662074,12811637,16366675,3555038,13704601,3555038,10149563,8,0
16457239,1812,8,4158422,15460454,16457239,996785,12298817,996785,11302032,0,0
16465508,1628,1,3796485,10155634,16465508,6309874,12669023,6309874,6359149,26,0
16557567,201,4,1255314,14642038,16557567,1915529,15302253,1915529,13386724,0,0
16566728,278,4,1581732,14642038,16566728,1924690,14984996,1924690,13060306,0,0
16578054,1946,8,4372263,15580506,16578054,997548,12205791,997548,11208243,0,0
16609715,414,1,1690880,10211435,16609715,6398280,14918835,6398280,8520555,27,0
16721601,1689,8,3950080,15699405,16721601,1022196,12771521,1022196,11749325,0,0
16760876,1938,8,4355145,15727885,16760876,1032991,12405731,1032991,11372740,0,0
16816625,526,1,1935047,10284447,16816625,6532178,14881578,6532178,8349400,31,0
16891453,824,2,2541943,13264720,16891453,3626733,14349510,3626733,10722777,7,0
16958245,862,2,2736359,13264720,16958245,3693525,14221886,3693525,10528361,8,0
17001500,1766,8,4072646,15968015,17001500,1033485,12928854,1033485,11895369,0,0
17044891,1541,8,3640312,15989626,17044891,1055265,13404579,1055265,12349314,0,0
17094171,98,1,1095479,1095479,17094171,15998692,15998692,7138947,8859745,251,0
17175317,425,1,1690919,10405060,17175317,6770257,15484398,6770257,8714141,35,0
17226524,1306,1,3362419,10436581,17226524,6789943,13864105,6789943,7074162,36,0
17291722,1250,8,3270949,16236058,17291722,1055664,14020773,1055664,12965109,0,0
17402857,1955,4,4389277,15332040,17402857,2070817,13013580,2070817,10942763,0,0
17504850,1693,4,3959582,15393484,17504850,2111366,13545268,2111366,11433902,2,0
17513818,1564,8,3703663,16457239,17513818,1056579,13810155,1056579,12753576,0,0
17541709,1045,1,2972871,10608078,17541709,6933631,14568838,6933631,7635207,38,0
17635414,1237,8,3193759,16566728,17635414,1068686,14441655,1068686,13372969,0,0
17649108,1530,8,3624228,16578054,17649108,1071054,14024880,1071054,12953826,0,0
17794595,911,8,2770483,16721601,17794595,1072994,15024112,1072994,13951118,0,0
17844829,1705,8,3961472,16760876,17844829,1083953,13883357,1083953,12799404,0,0
17989390,1431,1,3510139,10717109,17989390,7272281,14479251,6944576,7534675,38,0
18028369,1175,4,3183638,15871045,18028369,2157324,14844731,2157324,12687407,0,0
18093498,1415,8,3498887,17001500,18093498,1091998,14594611,1091998,13502613,0,0
18395253,945,8,2810304,17291722,18395253,1103531,15584949,1103531,14481418,0,0
18482927,635,2,2153175,14266966,18482927,4215961,16329752,4215961,12113791,7,0
18536611,180,4,1241289,16348945,18536611,2187666,17295322,2187666,15107656,1,0
18552616,864,2,2736397,14266966,18552616,4285650,15816219,4285650,11530569,9,0
18628430,896,8,2755390,17513818,18628430,1114612,15873040,1114612,14758428,0,0
18752783,653,8,2191069,17635414,18752783,1117369,16561714,1117369,15444345,0,0
18784151,364,8,1669444,17649108,18784151,1135043,17114707,1135043,15979664,0,0
18850814,308,1,1606851,1606851,18850814,17243963,17243963,7122185,10121778,58,0
18931541,1328,8,3367697,17794595,18931541,1136946,15563844,1136946,14426898,0,0
18981990,800,8,2486332,17844829,18981990,1137161,16495658,1137161,15358497,0,0
19015962,1680,16,3947235,18628430,19015962,387532,15068727,387532,14681195,0,0
19238721,1954,4,4384943,16557567,19238721,2681154,14853778,2202991,12650787,1,0
19264647,840,4,2662195,17044891,19264647,2219756,16602452,2219756,14382696,0,0
19325235,673,8,2223540,18093498,19325235,1231737,17101695,1231737,15869958,0,0
19459753,763,16,2413166,19015962,19459753,443791,17046587,443791,16602796,0,0
19628525,640,8,2154476,18395253,19628525,1233272,17474049,1233272,16240777,1,0
19649313,203,4,1255347,17402857,19649313,2246456,18393966,2246456,16147510,0,0
19719950,1191,1,3193483,12530076,19719950,7189874,16526467,7189874,9336593,13,0
19785847,784,2,2470343,14990856,19785847,4794991,17315504,4794991,12520513,13,0
19786288,1772,4,4089411,17504850,19786288,2281438,15696877,2281438,13415439,0,0
19933393,1418,16,3500440,19459753,19933393,473640,16432953,473640,15959313,0,0
19958039,718,8,2323037,18552616,19958039,1405423,17635002,1249702,16385300,1,0
20205743,1496,8,3615601,18931541,20205743,1274202,16590142,1274202,15315940,0,0
20262890,774,8,2446230,18981990,20262890,1280900,17816660,1280900,16535760,0,0
20320369,1872,4,4279427,17635414,20320369,2684955,16040942,2540394,13500548,4,0
20405712,1525,1,3623248,12903685,20405712,7502027,16782464,7502027,9280437,16,0
20582225,267,4,1541381,18028369,20582225,2553856,19040844,2553856,16486988,2,0
20582498,930,16,2800248,19933393,20582498,649105,17782250,649105,17133145,0,0
20628938,1642,8,3812024,19325235,20628938,1303703,16816914,1303703,15513211,0,0
20696125,1300,1,3361468,13162089,20696125,7534036,17334657,7534036,9800621,15,0
20945070,1922,8,4334396,19628525,20945070,1316545,16610674,1316545,15294129,0,0
21010952,110,1,1098983,1098983,21010952,19911969,19911969,8055785,11856184,211,0
21140664,147,1,1165329,1165329,21140664,19975335,19975335,8064522,11910813,151,0
21240531,423,1,1690911,13394954,21240531,7845577,19549620,7845577,11704043,15,0
21252521,359,1,1639287,1675041,21252521,19577480,19613234,7857669,11755565,18,0
21282913,886,8,2743072,19958039,21282913,1324874,18539841,1324874,17214967,0,0
21309247,1827,4,4197246,18536611,21309247,2772636,17112001,2572469,14539532,3,0
21326602,403,1,1690836,13452973,21326602,7873629,19635766,7873629,11762137,14,0
21458392,430,1,1691309,13562723,21458392,7895669,19767083,7895669,11871414,13,0
21618612,1527,8,3623578,20262890,21618612,1355722,17995034,1355722,16639312,0,0
21680965,361,1,1639369,13725013,21680965,7955952,20041596,7955952,12085644,11,0
21831345,19,4,906308,906308,21831345,20925037,20925037,2777061,18147976,13,0
21925069,1591,4,3746053,19264647,21925069,2660422,18179016,2660422,15518594,1,0
21942339,1960,8,4417144,20582498,21942339,1359841,17525195,1359841,16165354,0,0
22045446,730,8,2362242,20582498,22045446,1462948,19683204,1462948,18220256,0,0
22126343,1427,8,3505880,20628938,22126343,1497405,18620463,1497405,17123058,0,0
22338109,1054,1,2989800,13950882,22338109,8387227,19348309,8387227,10961082,13,0
22374326,1638,2,3798158,16958245,22374326,5416081,18576168,5416081,13160087,14,0
22471202,867,4,2736539,19786288,22471202,2684914,19734663,2684914,17049749,0,0
22727931,1325,1,3365736,14089457,22727931,8638474,19362195,8638474,10723721,17,0
22801141,1852,8,4231928,21282913,22801141,1518228,18569213,1518228,17050985,0,0
22831320,1947,8,4373176,21309247,22831320,1522073,18458144,1522073,16936071,0,0
22831963,1340,16,3374496,22126343,22831963,705620,19457467,705620,18751847,0,0
22895643,1750,4,4040328,20205743,22895643,2689900,18855315,2689900,16165415,0,0
23027044,1738,4,4019622,20205743,23027044,2821301,19007422,2821301,16186121,0,0
23120306,452,1,1691827,14280140,23120306,8840166,21428479,8840166,12588313,18,0
23151259,1024,8,2899015,21618612,23151259,1532647,20252244,1532647,18719597,0,0
23477842,557,1,1974659,14488332,23477842,8989510,21503183,8989510,12513673,18,0
23497810,4,8,543390,543390,23497810,22954420,22954420,2042779,20911641,1,0
23581701,220,4,1284690,20582225,23581701,2999476,22297011,2999476,19297535,2,0
23597345,1032,16,2917513,22831963,23597345,765382,20679832,765382,19914450,0,0
23604046,427,1,1691226,14500492,23604046,9103554,21912820,9103554,12809266,22,0
23719819,468,1,1703761,14596248,23719819,9123571,22016058,9123571,12892487,21,0
23963893,1768,4,4086592,20945070,23963893,3018823,19877301,3018823,16858478,0,0
24127308,1179,1,3193433,14716468,24127308,9410840,20933875,9410840,11523035,22,0
24218238,379,1,1690337,14791192,24218238,9427046,22527901,9427046,13100855,21,0
24282860,1271,1,3344219,14799161,24282860,9483699,20938641,9483699,11454942,21,0
24315530,485,8,1806785,22045446,24315530,2270084,22508745,1595286,20913459,1,0
24402005,701,16,2305606,23597345,24402005,804660,22096399,804660,21291739,0,0
24437045,1226,1,3193637,14874072,24437045,9562973,21243408,9562973,11680435,23,0
24467651,1476,8,3594238,22831320,24467651,1636331,20873413,1636331,19237082,1,0
24672043,417,1,1690887,14959283,24672043,9712760,22981156,9687869,13293287,22,0
24792351,535,8,1951848,23151259,24792351,1641092,22840503,1641092,21199411,0,0
24902674,1060,1,2991721,15050506,24902674,9852168,21910953,9777355,12133598,20,0
24938444,678,4,2227731,21252521,24938444,3685923,22710713,3163825,19546888,3,0
25080199,387,1,1690724,15162220,25080199,9917979,23389475,9815726,13573749,20,0
25118539,270,4,1544882,21925069,25118539,3193470,23573657,3193470,20380187,2,0
25173855,1268,8,3343017,23497810,25173855,1676045,21830838,1676045,20154793,0,0
25175820,369,1,1685757,15233733,25175820,9942087,23490063,9839834,13650229,22,0
25329702,536,1,1952420,15470795,25329702,9858907,23377282,9858907,13518375,20,0
25483080,362,1,1639430,15539483,25483080,9943597,23843650,9943597,13900053,21,0
25750465,1651,1,3834945,15805708,25750465,9944757,21915520,9944757,11970763,19,0
25994521,990,8,2857028,24315530,25994521,1678991,23137493,1678991,21458502,0,0
26091898,833,1,2632777,16083731,26091898,10008167,23459121,9990437,13468684,17,0
26137108,1423,8,3501935,24402005,26137108,1735103,22635173,1735103,20900070,0,0
26148619,790,8,2480916,24402005,26148619,1746614,23667703,1746614,21921089,0,0
26151002,1615,4,3785220,22801141,26151002,3349861,22365782,3349861,19015921,3,0
26222411,895,8,2755202,24467651,26222411,1754760,23467209,1754760,21712449,0,0
26567872,1082,8,3018469,24792351,26567872,1775521,23549403,1775521,21773882,0,0
26582712,466,1,1692810,16187772,26582712,10394940,24889902,10377210,14512692,20,0
26755953,221,4,1284714,23027044,26755953,3728909,25471239,3728909,21742330,2,0
26864050,93,1,1088222,1088798,26864050,25775252,25775828,10669718,15106110,179,0
26909559,1093,8,3045805,25118539,26909559,1791020,23863754,1791020,22072734,0,0
27023884,1033,16,2924100,26148619,27023884,875265,24099784,875265,23224519,0,0
27246922,422,1,1690906,16609715,27246922,10637207,25556016,10637207,14918809,25,0
27313146,691,8,2279591,25483080,27313146,1830066,25033555,1830066,23203489,0,0
27410393,1670,4,3934777,23604046,27410393,3806347,23475616,3806347,19669269,1,0
27541871,499,1,1860327,16816625,27541871,10725246,25681544,10725246,14956298,24,0
27672047,1043,1,2972813,16891453,27672047,10780594,24699234,10780594,13918640,24,0
27770933,663,4,2206945,23963893,27770933,3807040,25563988,3807040,21756948,3,0
27777894,516,1,1889570,16891453,27777894,10886441,25888324,10886441,15001883,24,0
27825490,744,8,2385513,25994521,27825490,1830969,25439977,1830969,23609008,0,0
27928217,1269,16,3343960,27023884,27928217,904333,24584257,904333,23679924,0,0
28123318,1173,8,3167913,26222411,28123318,1900907,24955405,1900907,23054498,0,0
28224429,1183,1,3193452,17094171,28224429,11130258,25030977,10920843,14110134,18,0
28469391,1749,8,4039311,26567872,28469391,1901519,24430080,1901519,22528561,1,0
28810454,1713,4,3963727,24938444,28810454,3872010,24846727,3816694,21030033,2,0
28822847,1428,8,3508947,26909559,28822847,1913288,25313900,1913288,23400612,0,0
28857257,1239,16,3227030,27928217,28857257,929040,25630227,929040,24701187,0,0
29155154,1622,1,3794697,17175317,29155154,11979837,25360457,11076718,14283739,15,0
29230358,539,8,1957199,27313146,29230358,1917212,27273159,1917212,25355947,0,0
29524654,540,1,1957901,17226524,29524654,12298130,27566753,11395011,16171742,16,0
29688977,1976,8,4444486,27770933,29688977,1918044,25244491,1918044,23326447,0,0
29746015,807,8,2501458,27825490,29746015,1920525,27244557,1920525,25324032,0,0
29804204,1036,16,2941883,28857257,29804204,946947,26862321,946947,25915374,0,0
29871225,1786,4,4107995,25173855,29871225,4697370,25763230,4040959,21722271,5,0
30074627,699,8,2305071,28123318,30074627,1951309,27769556,1951309,25818247,0,0
30095609,1495,1,3615597,17541709,30095609,12553900,26480012,11581092,14898920,13,0
30372635,447,1,1691721,18752783,30372635,11619852,28680914,11619852,17061062,11,0
30498048,109,1,1098951,1098951,30498048,29399097,29399097,11877744,17521353,141,0
30783928,780,8,2454711,28810454,30783928,1973474,28329217,1973474,26355743,0,0
30787998,1242,16,3244126,29804204,30787998,983794,27543872,983794,26560078,0,0
30826622,1401,8,3449285,28822847,30826622,2003775,27377337,2003775,25373562,0,0
30962568,637,4,2153445,26137108,30962568,4825460,28809123,4218126,24590997,4,0
31237181,1779,8,4095109,29230358,31237181,2006823,27142072,2006823,25135249,0,0
31307069,400,1,1690813,19649313,31307069,11657756,29616256,11657756,17958500,5,0
31347387,888,1,2743130,19649313,31347387,11698074,28604257,11698074,16906183,6,0
31379521,392,1,1690759,19649313,31379521,11730208,29688762,11730208,17958554,7,0
31391629,431,1,1691328,19649313,31391629,11742316,29700301,11742316,17957985,8,0
31470755,432,1,1691363,19719950,31470755,11750805,29779392,11750805,18028587,7,0
31576794,391,1,1690752,19785847,31576794,11790947,29886042,11790947,18095095,6,0
31644866,166,1,1167748,1367607,31644866,30277259,30477118,12030939,18446179,98,0
31759202,248,8,1384680,29746015,31759202,2013187,30374522,2013187,28361335,0,0
31890306,1593,8,3749178,29871225,31890306,2019081,28141128,2019081,26122047,0,0
32096124,884,8,2742846,30074627,32096124,2021497,29353278,2021497,27331781,0,0
32110163,558,2,1978456,23581701,32110163,8528462,30131707,7914270,22217437,10,0
32221715,358,1,1639246,20320369,32221715,11901346,30582469,11901346,18681123,2,0
32328215,574,1,1988375,20320369,32328215,12007846,30339840,12007846,18331994,4,0
32364165,1192,1,3193487,20320369,32364165,12043796,29170678,12043796,17126882,6,0
32408575,632,4,2152367,27410393,32408575,4998182,30256208,4299724,25956484,3,0
32441261,1441,1,3517379,20320369,32441261,12120892,28923882,12120892,16802990,6,0
32790563,1664,1,3876343,20405712,32790563,12384851,28914220,12384851,16529369,5,0
32818679,1926,8,4349964,30783928,32818679,2034751,28468715,2034751,26433964,0,0
32824610,1979,8,4468456,30787998,32824610,2036612,28356154,2036612,26319542,0,0
32825089,720,8,2326979,30787998,32825089,2037091,30498110,2037091,28461019,0,0
32886540,1116,8,3060000,30826622,32886540,2059918,29826540,2059918,27766622,0,0
33175785,1254,1,3279636,20696125,33175785,12479660,29896149,12479660,17416489,2,0
33301206,1137,8,3082170,31237181,33301206,2064025,30219036,2064025,28155011,0,0
33590755,1393,1,3444949,20945070,33590755,12645685,30145806,12645685,17500121,7,0
33591512,44,1,990526,990526,33591512,32600986,32600986,12953525,19647461,159,0
33613752,1640,2,3798201,25080199,33613752,8533553,29815551,8266168,21549383,12,0
33706645,1616,4,3785531,28469391,33706645,5237254,29921114,4358731,25562383,1,0
33780839,436,1,1691458,20945070,33780839,12835769,32089381,12835769,19253612,10,0
33840647,980,8,2839765,31759202,33840647,2081445,31000882,2081445,28919437,0,0
33868915,416,1,1690886,20945070,33868915,12923845,32178029,12923845,19254184,11,0
34013201,1110,8,3058458,31890306,34013201,2122895,30954743,2122895,28831848,0,0
34106668,420,1,1690898,21010952,34106668,13095716,32415770,13021635,19394135,12,0
34257498,479,8,1740302,32096124,34257498,2161374,32517196,2161374,30355822,0,0
34382080,136,1,1161574,1161574,34382080,33220506,33220506,13201485,20019021,98,0
34578254,1643,8,3812798,32408575,34578254,2169679,30765456,2169679,28595777,0,0
34862838,873,1,2736644,21240531,34862838,13622307,32126194,13193863,18932331,9,0
35002898,1247,8,3255384,32818679,35002898,2184219,31747514,2184219,29563295,0,0
35050607,899,8,2756946,32824610,35050607,2225997,32293661,2225997,30067664,0,0
35081653,1756,8,4049625,32825089,35081653,2256564,31032028,2256564,28775464,0,0
35174312,231,8,1350010,32886540,35174312,2287772,33824302,2287772,31536530,0,0
35242066,1769,4,4087155,29688977,35242066,5553089,31154911,4461746,26693165,3,0
35584020,150,1,1165380,1445908,35584020,34138112,34418640,13405896,21012744,79,0
35597513,705,8,2309008,33301206,35597513,2296307,33288505,2296307,30992198,0,0
35762041,572,1,1982246,22374326,35762041,13387715,33779795,13387715,20392080,4,0
35837050,99,1,1095513,1095546,35837050,34741504,34741537,13646164,21095373,97,0
36071907,242,16,1372983,35050607,36071907,1021300,34698924,1021300,33677624,0,0
36184139,1621,8,3790604,33840647,36184139,2343492,32393535,2343492,30050043,0,0
36486784,1914,1,4312695,22471202,36486784,14015582,32174089,14015582,18158507,6,0
36683881,1371,1,3428093,22471202,36683881,14212679,33255788,14118177,19137611,5,0
36775903,1330,8,3367749,34382080,36775903,2393823,33408154,2393823,31014331,0,0
36782858,155,1,1165474,1445908,36782858,35336950,35617384,14366573,21250811,63,0
36825853,0,1,0,0,36825853,36825853,36825853,15486530,21339323,96,0
36973086,1941,8,4355598,34578254,36973086,2394832,32617488,2394832,30222656,0,0
37107959,59,16,1013092,36071907,37107959,1036052,36094867,1036052,35058815,0,0
37212566,1194,1,3193499,22727931,37212566,14484635,34019067,14390133,19628934,7,0
37334243,1788,4,4110710,32364165,37334243,4970078,33223533,4588090,28635443,4,0
37459772,901,8,2758563,35002898,37459772,2456874,34701209,2425828,32275381,1,0
37602771,193,8,1251720,35174312,37602771,2428459,36351051,2428459,33922592,1,0
38043243,1063,8,2996127,35597513,38043243,2445730,35047116,2445730,32601386,0,0
38177549,145,1,1165303,1473303,38177549,36704246,37012246,15161868,21850378,48,0
38181742,963,16,2828497,37107959,38181742,1073783,35353245,1073783,34279462,0,0
38321802,563,2,1979127,29155154,38321802,9166648,36342675,9166648,27176027,8,0
38444765,662,4,2206919,33706645,38444765,4738120,36237846,4738120,31499726,0,0
38538173,1625,1,3796419,23477842,38538173,15060331,34741754,15060331,19681423,12,0
38621637,1139,16,3082926,37459772,38621637,1161865,35538711,1161865,34376846,0,0
38633658,1260,8,3330983,36184139,38633658,2449519,35302675,2449519,32853156,0,0
38642525,373,1,1690269,23581701,38642525,15060824,36952256,15060824,21891432,11,0
38751848,533,4,1946210,34013201,38751848,4738647,36805638,4738647,32066991,0,0
38762557,580,4,1999956,34013201,38762557,4749356,36762601,4749356,32013245,0,0
39034539,1672,4,3935213,34257498,39034539,4777041,35099326,4777041,30322285,0,0
39279803,941,8,2807547,36775903,39279803,2503900,36472256,2503900,33968356,1,0
39353863,1537,16,3631862,38181742,39353863,1172121,35722001,1172121,34549880,0,0
39482936,118,8,1105822,36973086,39482936,2509850,38377114,2509850,35867264,0,0
39554269,1504,1,3617511,23581701,39554269,15972568,35936758,15856795,20079963,15,0
39802161,707,16,2310637,38621637,39802161,1180524,37491524,1180524,36311000,0,0
39988325,738,8,2375225,37334243,39988325,2654082,37613100,2511083,35102017,1,0
40214282,1312,1,3363209,24127308,40214282,16086974,36851073,16022352,20828721,18,0
40283263,503,4,1863316,34257498,40283263,6025765,38419947,5165779,33254168,2,0
40605232,1561,1,3696452,24437045,40605232,16168187,36908780,16168187,20740593,15,0
40658380,1655,16,3841937,39353863,40658380,1304517,36816443,1304517,35511926,0,0
40847893,419,1,1690894,24672043,40847893,16175850,39156999,16175850,22981149,19,0
41192278,119,8,1111825,38633658,41192278,2558620,40080453,2558620,37521833,0,0
41339208,1737,8,4019436,38762557,41339208,2576651,37319772,2576651,34743121,0,0
41909176,602,8,2008139,39279803,41909176,2629373,39901037,2629373,37271664,0,0
42130663,1343,8,3399506,39482936,42130663,2647727,38731157,2647727,36083430,0,0
42491593,1092,8,3045783,39802161,42491593,2689432,39445810,2689432,36756378,0,0
42493484,1318,8,3363912,39802161,42493484,2691323,39129572,2691323,36438249,0,0
42503028,1133,1,3079721,24902674,42503028,17600354,39423307,17163300,22260007,18,0
42710909,821,8,2538363,39988325,42710909,2722584,40172546,2722584,37449962,0,0
43110008,271,4,1544974,37212566,43110008,5897442,41565034,5188442,36376592,2,0
43235760,254,4,1432295,38043243,43235760,5192517,41803465,5192517,36610948,2,0
43730732,80,4,1062187,1062187,43730732,42668545,42668545,5287995,37380550,3,0
43875180,1193,1,3193495,25329702,43875180,18545478,40681685,17445846,23235839,15,0
44025348,1249,8,3265631,41192278,44025348,2833070,40759717,2833070,37926647,0,0
44251569,1150,8,3104922,41339208,44251569,2912361,41146647,2912361,38234286,0,0
44315823,1184,1,3193455,26864050,44315823,17451773,41122368,17451773,23670595,14,0
44440009,1783,4,4104398,38751848,44440009,5688161,40335611,5416179,34919432,1,0
44862269,178,8,1238400,41909176,44862269,2953093,43623869,2953093,40670776,0,0
45038913,1912,1,4312420,27246922,45038913,17791991,40726493,17791991,22934502,14,0
45171327,1101,8,3053861,42130663,45171327,3040664,42117466,3040664,39076802,0,0
45469406,1845,1,4222975,27541871,45469406,17927535,41246431,17927535,23318896,14,0
45537965,1146,8,3095703,42491593,45537965,3046372,42442262,3046372,39395890,0,0
45598767,644,8,2161910,42493484,45598767,3105283,43436857,3105283,40331574,0,0
45851350,829,4,2553043,40283263,45851350,5568087,43298307,5568087,37730220,0,0
45870944,946,1,2810895,27672047,45870944,18198897,43060049,18198897,24861152,15,0
46230101,1890,4,4305223,40658380,46230101,5571721,41924878,5571721,36353157,0,0
46235059,217,4,1284564,40658380,46235059,5576679,44950495,5576679,39373816,0,0
46272549,1547,4,3665692,40658380,46272549,5614169,42606857,5614169,36992688,0,0
46402711,1646,8,3827358,43235760,46402711,3166951,42575353,3166951,39408402,0,0
46410588,1162,1,3138858,27777894,46410588,18632694,43271730,18632694,24639036,18,0
46468480,69,4,1028041,1028041,46468480,45440439,45440439,5815447,39624992,6,0
47210892,1277,20,3357934,46272549,47210892,938343,43852958,938343,42914615,0,0
47223330,1335,8,3370534,44025348,47223330,3197982,43852796,3197982,40654814,0,0
47460260,79,8,1062109,44251569,47460260,3208691,46398151,3208691,43189460,0,0
47892767,1229,1,3193648,28224429,47892767,19668338,44699119,19298838,25400281,19,0
48191646,1087,8,3025072,44862269,48191646,3329377,45166574,3329377,41837197,0,0
48545100,1871,8,4275968,45171327,48545100,3373773,44269132,3373773,40895359,0,0
48809942,1064,16,2996428,47210892,48809942,1599050,45813514,1599050,44214464,0,0
48940156,1385,8,3443903,45537965,48940156,3402191,45496253,3402191,42094062,0,0
48977166,1900,32,4308054,48940156,48977166,37010,44669112,37010,44632102,0,0
49031328,276,4,1579787,42710909,49031328,6320419,47451541,6320419,41131122,0,0
49052217,1140,8,3083693,45598767,49052217,3453450,45968524,3453450,42515074,0,0
49071995,1644,32,3812815,48977166,49071995,94829,45259180,94829,45164351,0,0
49191234,1781,4,4103465,42710909,49191234,6480325,45087769,6480325,38607444,0,0
49228996,1902,32,4308065,49071995,49228996,157001,44920931,157001,44763930,0,0
49471098,1207,1,3193559,30095609,49471098,19375489,46277539,19375489,26902050,16,0
49776480,460,1,1692034,30372635,49776480,19403845,48084446,19403845,28680601,16,0
49968606,396,1,1690786,30498048,49968606,19470558,48277820,19470558,28807262,16,0
50328555,1650,4,3833043,43110008,50328555,7218547,46495512,6723575,39771937,2,0
50722048,37,8,961716,961716,50722048,49760332,49760332,3598447,46161885,2,0
50857511,440,1,1691558,31307069,50857511,19550442,49165953,19550442,29615511,20,0
50918008,1383,16,3443428,48809942,50918008,2108066,47474580,1819226,45655354,1,0
51099114,1270,16,3344094,49228996,51099114,1870118,47755020,1870118,45884902,0,0
51140554,1095,8,3046027,47460260,51140554,3680294,48094527,3680294,44414233,0,0
51285760,1863,4,4260899,44440009,51285760,6845751,47024861,6845751,40179110,1,0
51739766,1230,1,3193652,31347387,51739766,20392379,48546114,20392379,28153735,22,0
51924155,1839,8,4216702,48191646,51924155,3732509,47707453,3732509,43974944,1,0
52417347,1995,8,4499365,48545100,52417347,3872247,47917982,3760186,44157796,2,0
52505172,474,1,1713634,31379521,52505172,21125651,50791538,21125651,29665887,24,0
52733668,1121,1,3067957,31391629,52733668,21342039,49665711,21342039,28323672,26,0
52802481,1154,16,3114403,50918008,52802481,1884473,49688078,1884473,47803605,0,0
52993579,1752,4,4040559,45851350,52993579,7142229,48953020,7012067,41940953,4,0
53023620,1671,4,3935151,45870944,53023620,7152676,49088469,7022514,42065955,4,0
53233303,475,1,1713637,31470755,53233303,21762548,51519666,21762548,29757118,29,0
53382677,399,1,1690807,31576794,53382677,21805883,51691870,21805883,29885987,30,0
53818041,197,4,1253665,46468480,53818041,7349561,52564376,7349561,45214815,1,0
54187971,103,1,1095725,1095914,54187971,53092057,53092246,22249131,30843115,72,0
54511256,742,8,2381329,50722048,54511256,3789208,52129927,3789208,48340719,0,0
54594623,497,4,1853263,47210892,54594623,7383731,52741360,7383731,45357629,3,0
54843431,767,16,2420053,52802481,54843431,2040950,52423378,2040950,50382428,0,0
54894572,1448,8,3521490,51099114,54894572,3795458,51373082,3795458,47577624,0,0
54971157,258,8,1463221,51099114,54971157,3872043,53507936,3872043,49635893,0,0
55043380,892,8,2753753,51140554,55043380,3902826,52289627,3902826,48386801,0,0
55101740,1264,1,3340533,32110163,55101740,22991577,51761207,22191385,29569822,29,0
55410746,134,1,1161521,1473303,55410746,53937443,54249225,22473122,31776103,51,0
55919075,478,8,1730719,51924155,55919075,3994920,54188356,3994920,50193436,0,0
56194832,1313,1,3363305,32221715,56194832,23973117,52831527,22723530,30107997,26,0
56427895,686,8,2252441,52417347,56427895,4010548,54175454,4010548,50164906,0,0
56551856,1545,4,3660369,49031328,56551856,7520528,52891487,7520528,45370959,3,0
56696261,758,1,2409759,32328215,56696261,24368046,54286502,23118459,31168043,30,0
57249066,90,4,1081252,49471098,57249066,7777968,56167814,7777968,48389846,0,0
57412352,1662,1,3858030,33780839,57412352,23631513,53554322,23150755,30403567,29,0
58138584,1555,4,3692850,50328555,58138584,7810029,54445734,7810029,46635705,0,0
58685914,748,8,2403395,54511256,58685914,4174658,56282519,4174658,52107861,0,0
58754558,374,1,1690276,33868915,58754558,24885643,57064282,23683703,33380579,24,0
59043607,762,8,2411456,54843431,59043607,4200176,56632151,4200176,52431975,0,0
59063062,1094,8,3045855,54843431,59063062,4219631,56017207,4219631,51797576,0,0
59122931,1030,8,2908848,54894572,59122931,4228359,56214083,4228359,51985724,0,0
59188992,123,1,1118114,1139216,59188992,58049776,58070878,23728033,34342845,34,0
59360837,879,8,2738353,54971157,59360837,4389680,56622484,4389680,52232804,0,0
59450204,690,8,2279108,55043380,59450204,4406824,57171096,4406824,52764272,0,0
59683904,1857,1,4256276,35837050,59683904,23846854,55427628,23846854,31580774,22,0
60371515,1251,8,3271106,55919075,60371515,4452440,57100409,4452440,52647969,0,0
60521317,573,1,1982272,36486784,60521317,24034533,58539045,24034533,34504512,23,0
60881828,8,8,837589,837589,60881828,60044239,60044239,4639252,55404987,1,0
61477672,1626,4,3796441,52993579,61477672,8484093,57681231,8484093,49197138,0,0
61706780,495,8,1845693,57249066,61706780,4457714,59861087,4457714,55403373,0,0
61719350,1630,4,3796527,53023620,61719350,8695730,57922823,8695730,49227093,0,0
61879735,1910,1,4311954,36683881,61879735,25195854,57567781,24230871,33336910,21,0
62123745,390,1,1690745,36782858,62123745,25340887,60433000,24231651,36201349,18,0
62577278,538,4,1952823,53818041,62577278,8759237,60624455,8759237,51865218,0,0
63170602,1211,1,3193575,36825853,63170602,26344749,59977027,25235513,34741514,21,0
63170785,1907,8,4310017,58685914,63170785,4484871,58860768,4484871,54375897,0,0
63696838,743,8,2384534,59043607,63696838,4653231,61312304,4653231,56659073,0,0
63717898,206,8,1262609,59063062,63717898,4654836,62455289,4654836,57800453,0,0
63831999,1603,8,3769832,59122931,63831999,4709068,60062167,4709068,55353099,0,0
64127144,618,8,2013228,59360837,64127144,4766307,62113916,4766307,57347609,0,0
64603500,857,8,2705699,59450204,64603500,5153296,61897801,5153296,56744505,0,0
64643638,1235,1,3193670,38538173,64643638,26105465,61449968,26105465,35344503,18,0
64918156,522,4,1930098,54594623,64918156,10323533,62988058,10323533,52664525,6,0
65206081,450,1,1691783,38642525,65206081,26563556,63514298,26563556,36950742,16,0
65561421,1747,8,4036359,60371515,65561421,5189906,61525062,5189906,56335156,0,0
66074459,36,8,956090,956090,66074459,65118369,65118369,5239798,59878571,2,0
66993408,209,8,1273245,61706780,66993408,5286628,65720163,5286628,60433535,0,0
67264484,9,8,837888,837888,67264484,66426596,66426596,5540214,60886382,1,0
67339942,1641,2,3798226,49191234,67339942,18148708,63541716,16334046,47207670,2,0
68526708,46,4,991717,999520,68526708,67527188,67534991,11093523,56441468,16,0
68593325,16,8,896743,896743,68593325,67696582,67696582,5515923,62180659,2,0
69136939,1489,8,3605180,63696838,69136939,5440101,65531759,5440101,60091658,0,0
69179419,1657,8,3845179,63717898,69179419,5461521,65334240,5461521,59872719,0,0
69291107,461,1,1692048,39554269,69291107,29736838,67599059,29736838,37862221,17,0
69439209,264,8,1501448,63831999,69439209,5607210,67937761,5607210,62330551,0,0
69761647,1681,8,3947752,64127144,69761647,5634503,65813895,5634503,60179392,0,0
70060798,1202,1,3193540,40214282,70060798,29846516,66867258,29846516,37020742,19,0
70324310,28,8,930880,930880,70324310,69393430,69393430,5751923,63641507,1,0
70500335,444,1,1691634,40605232,70500335,29895103,68808701,29895103,38913598,18,0
70748337,365,16,1669786,68593325,70748337,2155012,69078551,2155012,66923539,0,0
70842435,462,1,1692068,40847893,70842435,29994542,69150367,29994542,39155825,20,0
71348304,169,8,1181272,65561421,71348304,5786883,70167032,5786883,64380149,0,0
71382440,1278,16,3358054,69179419,71382440,2203021,68024386,2203021,65821365,0,0
71991394,1429,8,3508975,66074459,71991394,5916935,68482419,5916935,62565484,0,0
72809103,1437,4,3516892,61477672,72809103,11331431,69292211,11331431,57960780,1,0
73011869,1444,8,3518099,66993408,73011869,6018461,69493770,6018461,63475309,0,0
73048261,113,1,1099104,1150477,73048261,71897784,71949157,30550894,41398263,25,0
73091082,1486,16,3603230,70748337,73091082,2342745,69487852,2342745,67145107,0,0
73319664,1470,8,3571448,67264484,73319664,6055180,69748216,6055180,63693036,0,0
74185988,1945,16,4367266,71382440,74185988,2803548,69818722,2803548,67015174,0,0
74539550,149,1,1165363,43875180,74539550,30664370,73374187,30664370,42709817,23,0
74818595,1774,4,4090632,61719350,74818595,13099245,70727963,12401702,58326261,3,0
75729799,405,1,1690850,44315823,75729799,31413976,74038949,30879290,43159659,19,0
76165418,972,16,2836299,73091082,76165418,3074336,73329119,3074336,70254783,0,0
76455436,1876,8,4288803,69761647,76455436,6693789,72166633,6693789,65472844,1,0
77036927,1076,8,3013225,70324310,77036927,6712617,74023702,6712617,67311085,1,0
77401397,1817,4,4179419,64918156,77401397,12483241,73221978,12483241,60738737,2,0
77467729,1789,16,4120729,74185988,77467729,3281741,73347000,3281741,70065259,0,0
78078238,789,8,2480826,71348304,78078238,6729934,75597412,6729934,68867478,1,0
78106870,139,1,1161611,45038913,78106870,33067957,76945259,31051092,45894167,15,0
78791703,7,8,671239,671239,78791703,78120464,78120464,7090786,71029678,1,0
79506538,667,16,2218836,76165418,79506538,3341120,77287702,3341120,73946582,0,0
79943612,619,1,2057998,45469406,79943612,34474206,77885614,31158874,46726740,8,0
80069676,639,8,2153614,73011869,80069676,7057807,77916062,7057807,70858255,1,0
80410852,586,8,2007701,73319664,80410852,7091188,78403151,7091188,71311963,0,0
80827225,1166,16,3157915,77467729,80827225,3359496,77669310,3359496,74309814,0,0
81077464,1257,4,3310362,67339942,81077464,13737522,77767102,12934118,64832984,3,0
82334281,682,1,2237532,46230101,82334281,36104180,80096749,32842623,47254126,9,0
82944343,218,4,1284590,68526708,82944343,14417635,81659753,13614231,68045522,5,0
83077074,1549,16,3673785,79506538,83077074,3570536,79403289,3570536,75832753,0,0
83678621,27,8,930730,930730,83678621,82747891,82747891,7248545,75499346,1,0
84287204,924,8,2795275,77036927,84287204,7250277,81491929,7250277,74241652,0,0
84543848,706,16,2310327,80827225,84543848,3716623,82233521,3716623,78516898,0,0
85425915,1600,8,3764205,78078238,85425915,7347677,81661710,7347677,74314033,0,0
85945529,737,8,2374026,78106870,85945529,7838659,83571503,7838659,75732844,0,0
86039402,1492,1,3615154,49968606,86039402,36070796,82424248,36070796,46353452,9,0
86498117,984,4,2842353,72809103,86498117,13689014,83655764,13689014,69966750,1,0
86674386,1353,8,3406034,78791703,86674386,7882683,83268352,7882683,75385669,0,0
87527767,14,1,881304,881304,87527767,86646463,86646463,36872754,49773709,49,0
87983936,1720,8,3975440,80069676,87983936,7914260,84008496,7914260,76094236,0,0
88402913,1825,8,4194251,80410852,88402913,7992061,84208662,7992061,76216601,0,0
89496927,1203,1,3193544,51285760,89496927,38211167,86303383,38211167,48092216,12,0
90034910,1572,4,3706242,74818595,90034910,15216315,86328668,15216315,71112353,0,0
91248712,1100,8,3053489,83077074,91248712,8171638,88195223,8171638,80023585,0,0
91382912,900,8,2758515,83077074,91382912,8305838,88624397,8305838,80318559,0,0
91681975,12,1,880145,880145,91681975,90801830,90801830,40594521,50207309,58,0
91728573,616,2,2008509,59683904,91728573,32044669,89720064,31800659,57919405,27,0
92280578,75,8,1042649,83678621,92280578,8601957,91237929,8601957,82635972,0,0
92934997,1062,8,2995996,84287204,92934997,8647793,89939001,8647793,81291208,0,0
93360483,1961,8,4417173,84543848,93360483,8816635,88943310,8816635,80126675,0,0
93544215,273,8,1550718,84543848,93544215,9000367,91993497,9000367,82993130,0,0
93818907,1198,1,3193517,51739766,93818907,42079141,90625390,42079141,48546249,21,0
94578344,714,8,2319610,85425915,94578344,9152429,92258734,9152429,83106305,0,0
94656964,1228,1,3193644,52505172,94656964,42151792,91463320,42151792,49311528,20,0
95056131,1186,1,3193463,52733668,95056131,42322463,91862668,42322463,49540205,20,0
95098749,78,8,1062049,85945529,95098749,9153220,94036700,9153220,84883480,0,0
95893844,1723,8,3997704,86674386,95893844,9219458,91896140,9219458,82676682,0,0
96293018,527,1,1936564,53233303,96293018,43059715,94356454,43059715,51296739,19,0
97380355,882,8,2739712,87983936,97380355,9396419,94640643,9396419,85244224,0,0
97931583,566,8,1980210,88402913,97931583,9528670,95951373,9528670,86422703,0,0
98396008,94,4,1092167,77401397,98396008,20994611,97303841,18024017,79279824,3,0
98400601,383,1,1690695,53382677,98400601,45017924,96709906,45017924,51691982,20,0
99773625,1855,8,4245400,90034910,99773625,9738715,95528225,9738715,85789510,0,0
101184690,939,8,2807374,91248712,101184690,9935978,98377316,9935978,88441338,0,0
101372638,115,8,1101445,91382912,101372638,9989726,100271193,9989726,90281467,0,0
101697824,370,1,1685912,54187971,101697824,47509853,100011912,47509853,52502059,23,0
102343086,1245,8,3252017,92280578,102343086,10062508,99091069,10062508,89028561,0,0
102439094,1785,4,4107881,82944343,102439094,19494751,98331213,19494751,78836462,2,0
103043516,696,8,2297936,92934997,103043516,10108519,100745580,10108519,90637061,0,0
103888700,1400,8,3449080,93360483,103888700,10528217,100439620,10528217,89911403,0,0
104339966,230,8,1339183,93544215,104339966,10795751,103000783,10795751,92205032,0,0
105380415,728,8,2344821,94578344,105380415,10802071,103035594,10802071,92233523,0,0
105950258,1560,8,3695009,95098749,105950258,10851509,102255249,10851509,91403740,0,0
106657892,418,1,1690891,55101740,106657892,51556152,104967001,51556152,53410849,26,0
107418031,1551,8,3688899,95893844,107418031,11524187,103729132,11524187,92204945,0,0
108935283,1602,8,3764385,97380355,108935283,11554928,105170898,11554928,93615970,0,0
110125418,1965,8,4421903,97931583,110125418,12193835,105703515,12193835,93509680,0,0
111020482,1601,8,3764312,98396008,111020482,12624474,107256170,12624474,94631696,0,0
111113443,473,1,1713480,55410746,111113443,55702697,109399963,55702697,53697266,34,0
111360612,486,16,1811759,105950258,111360612,5410354,109548853,5410354,104138499,0,0
112266999,1219,1,3193604,56194832,112266999,56072167,109073395,56072167,53001228,33,0
112532436,173,8,1207706,99773625,112532436,12758811,111324730,12758811,98565919,0,0
112777603,1209,1,3193568,56696261,112777603,56081342,109584035,56081342,53502693,31,0
113952847,1813,8,4169731,101184690,113952847,12768157,109783116,12768157,97014959,0,0
114152857,1988,8,4487069,101372638,114152857,12780219,109665788,12780219,96885569,0,0
115302588,991,8,2867960,102343086,115302588,12959502,112434628,12959502,99475126,0,0
116250429,23,16,926406,926406,116250429,115324023,115324023,6129666,109194357,2,0
117546009,29,8,931137,931720,117546009,116614289,116614872,13672446,102942426,2,0
117949281,1144,7,3088486,103043516,117949281,14905765,114860795,14905765,99955030,0,0
118076991,35,16,953317,111360612,118076991,6716379,117123674,6716379,110407295,0,0
118548811,355,8,1619883,104339966,118548811,14208845,116928928,14208845,102720083,0,0
119812456,1480,1,3599672,57412352,119812456,62400104,116212784,62400104,53812680,41,0
121435814,1252,8,3273178,105380415,121435814,16055399,118162636,14587626,103575010,1,0
122427369,1913,1,4312491,58754558,122427369,63672811,118114878,62625954,55488924,40,0
123403941,512,16,1879956,116250429,123403941,7153512,121523985,7153512,114370473,0,0
124780975,249,8,1409023,108935283,124780975,15845692,123371952,14950628,108421324,1,0
128162787,518,8,1895143,112532436,128162787,15630351,126267644,15630351,110637293,0,0
129745722,1619,8,3790445,113952847,129745722,15792875,125955277,15792875,110162402,0,0
130270904,1923,8,4336958,114152857,130270904,16118047,125933946,16118047,109815899,0,0
130497799,1232,1,3193659,59188992,130497799,71308807,127304140,65756326,61547814,30,0
131491157,1861,8,4259695,115302588,131491157,16188569,127231462,16188569,111042893,0,0
133758611,795,8,2483315,117546009,133758611,16212602,131275296,16212602,115062694,0,0
134322869,1075,8,3005983,117949281,134322869,16373588,131316886,16373588,114943298,0,0
135186002,654,8,2191212,118076991,135186002,17109011,132994790,17109011,115885779,0,0
135590690,179,8,1240489,118076991,135590690,17513699,134350201,17513699,116836502,0,0
135779995,1008,4,2890017,87527767,135779995,48252228,132889978,42515479,90374499,25,0
136536590,1608,8,3771100,118548811,136536590,17987779,132765490,17987779,114777711,0,0
139707400,67,8,1025721,121435814,139707400,18271586,138681679,18271586,120410093,0,0
141000264,1836,8,4214464,122427369,141000264,18572895,136785800,18572895,118212905,0,0
142946388,750,8,2404645,123403941,142946388,19542447,140541743,19542447,120999296,0,0
143111946,26,8,930392,930730,143111946,142181216,142181554,19708155,122473399,1,0
144788421,717,8,2322912,124780975,144788421,20007446,142465509,20007446,122458063,0,0
148717280,1339,8,3371496,128162787,148717280,20554493,145345784,20554493,124791291,0,0
150451869,1632,1,3797231,65206081,150451869,85245788,146654638,82524932,64129706,35,0
150953318,1157,8,3114770,129745722,150953318,21207596,147838548,21207596,126630952,0,0
151893593,229,8,1336414,130270904,151893593,21622689,150557179,21622689,128934490,0,0
156032317,1877,8,4289489,133758611,156032317,22273706,151742828,22273706,129469122,0,0
156824080,747,8,2403373,134322869,156824080,22501211,154420707,22501211,131919496,0,0
157878933,10,1,880076,880076,157878933,156998857,156998857,87572377,69426480,98,0
157941186,606,8,2008272,135186002,157941186,22755184,155932914,22755184,133177730,0,0
159808618,642,8,2157440,135590690,159808618,24217928,157651178,24217928,133433250,0,0
161104420,207,8,1271714,136536590,161104420,24567830,159832706,24567830,135264876,0,0
163906674,1511,1,3619305,70842435,163906674,93064239,160287369,93064239,67223130,36,0
164675419,1607,8,3770918,139707400,164675419,24968019,160904501,24968019,135936482,0,0
167123013,1606,8,3770850,141000264,167123013,26122749,163352163,26122749,137229414,0,0
168595879,34,16,953266,156824080,168595879,11771799,167642613,11771799,155870814,0,0
168660077,1915,1,4312850,73048261,168660077,95611816,164347227,93775074,70572153,31,0
169145225,778,8,2454643,142946388,169145225,26198837,166690582,26198837,140491745,0,0
169319973,1085,8,3019184,143111946,169319973,26208027,166300789,26208027,140092762,0,0
172254926,31,8,938339,144788421,172254926,27466505,171316587,27466505,143850082,0,0
175735153,955,4,2814649,119812456,175735153,55922697,172920504,46858909,126061595,2,0
176246904,1778,8,4095052,148717280,176246904,27529624,172151852,27529624,144622228,0,0
179932081,84,8,1071580,150953318,179932081,28978763,178860501,28978763,149881738,0,0
180965037,528,4,1941972,131491157,180965037,49473880,179023065,49473880,129549185,2,0
181307096,1826,8,4194650,151893593,181307096,29413503,177112446,29413503,147698943,0,0
181536255,1484,16,3603092,168595879,181536255,12940376,177933163,12940376,164992787,0,0
184077138,412,1,1690875,74539550,184077138,109537588,182386263,105310177,77076086,33,0
184485621,1384,16,3443613,169319973,184485621,15165648,181042008,15165648,165876360,0,0
186598643,628,8,2150028,156032317,186598643,30566326,184448615,29449220,154999395,1,0
190168073,1851,8,4229135,159808618,190168073,30359455,185938938,30359455,155579483,0,0
192489323,1553,16,3691977,176246904,192489323,16242419,188797346,16242419,172554927,0,0
192910147,1151,8,3107807,161104420,192910147,31805727,189802340,31805727,157996613,0,0
193957961,1911,1,4312249,75729799,193957961,118228162,189645712,110295630,79350082,28,0
197290206,1071,8,3005048,164675419,197290206,32614787,194285158,32614787,161670371,0,0
199027992,519,16,1918310,181536255,199027992,17491737,197109682,17491737,179617945,0,0
199752413,1467,8,3563716,167123013,199752413,32629400,196188697,32629400,163559297,1,0
205841891,687,8,2252454,169145225,205841891,36696666,203589437,33761713,169827724,1,0
206199127,498,1,1860323,86498117,206199127,119701010,204338804,119701010,84637794,31,0
208178774,1485,4,3603227,135779995,208178774,72398779,204575547,72398779,132176768,11,0
214931928,1305,16,3362331,192489323,214931928,22442605,211569597,22442605,189126992,1,0
216039640,1856,8,4248721,175735153,216039640,40304487,211790919,36619310,175171609,1,0
216228193,1901,32,4308059,214931928,216228193,1296265,211920134,1296265,210623869,0,0
218544575,785,8,2472181,181307096,218544575,37237479,216072394,37237479,178834915,1,0
222302849,745,8,2388060,184485621,222302849,37817228,219914789,37817228,182097561,0,0
223218708,1529,8,3623818,184485621,223218708,38733087,219594890,38733087,180861803,0,0
226341705,1174,8,3168827,186598643,226341705,39743062,223172878,39743062,183429816,0,0
230179959,1038,8,2964423,190168073,230179959,40011886,227215536,40011886,187203650,0,0
237372758,1754,16,4044551,206199127,237372758,31173631,233328207,29877366,203450841,2,0
239369460,1440,8,3517295,192910147,239369460,46459313,235852165,46459313,189392852,2,0
245276847,192,8,1251444,197290206,245276847,47986641,244025403,47986641,196038762,1,0
250896356,3,8,476285,476285,250896356,250420071,250420071,52322471,198097600,2,0
253627698,1381,8,3440492,199027992,253627698,54599706,250187206,54599706,195587500,1,0
255232501,1645,8,3821570,199752413,255232501,55480088,251410931,55480088,195930843,1,0
272548275,1374,16,3428655,237372758,272548275,35175517,269119620,35175517,233944103,0,0
276580241,120,8,1114093,205841891,276580241,70738350,275466148,60897837,214568311,2,0
277591366,1982,8,4480780,216228193,277591366,61363173,273110586,61363173,211747413,0,0
278078858,646,8,2170440,216228193,278078858,61850665,275908418,61850665,214057753,0,0
280914157,1238,8,3195047,218544575,280914157,62369582,277719110,62369582,215349528,0,0
288873087,1860,8,4259669,222302849,288873087,66570238,284613418,66570238,218043180,0,0
289623902,1753,16,4043556,250896356,289623902,38727546,285580346,38727546,246852800,1,0
294606511,1598,8,3763948,223218708,294606511,71387803,290842563,71387803,219454760,0,0
298611477,559,8,1978795,226341705,298611477,72269772,296632682,72269772,224362910,0,0
307351066,641,8,2156743,230179959,307351066,77171107,305194323,77171107,228023216,0,0
316427945,1899,32,4307901,298611477,316427945,17816468,312120044,17816468,294303576,0,0
318972081,1864,16,4260900,272548275,318972081,46423806,314711181,46423806,268287375,1,0
320053200,1115,8,3059922,239369460,320053200,80683740,316993278,80683740,236309538,1,0
337236165,282,8,1587573,245276847,337236165,91959318,335648592,89227976,246420616,2,0
348170213,1975,8,4443663,255232501,348170213,92937712,343726550,92937712,250788838,1,0
369846995,1528,8,3623665,276580241,369846995,93266754,366223330,93266754,272956576,1,0
384789867,6,8,627951,627951,384789867,384161916,384161916,107500942,276660974,3,0
388329861,5,8,600049,600049,388329861,387729812,387729812,110577404,277152408,20,0
399909117,1536,8,3628889,280914157,399909117,118994960,396280228,118994960,277285268,1,0
416490273,250,8,1422864,288873087,416490273,127617186,415067409,127617186,287450223,1,0
447416858,1552,8,3691049,289623902,447416858,157792956,443725809,149053367,294672442,2,0
466291074,1358,1,3411993,86498117,466291074,379792957,462879081,375733463,87145618,90,0
518560272,1222,1,3193617,86498117,518560272,432062155,515366655,424979556,90387099,90,0
