time,job_id,num_gpu,submit_time,start_time,end_time,executed_time,JCT,duration,pending_time,preempt,promote
2603599,1,1,266564,266564,2603599,2337035,2337035,2337035,0,0,0
3473655,57,1,2717244,2717244,3473655,756411,756411,756411,0,0,0
3552201,117,1,3551397,3551397,3552201,804,804,804,0,0,0
3565365,124,1,3564757,3564757,3565365,608,608,608,0,0,0
3565623,126,1,3564927,3564927,3565623,696,696,696,0,0,0
3567641,133,1,3567044,3567044,3567641,597,597,597,0,0,0
3572822,125,1,3564766,3564766,3572822,8056,8056,8056,0,0,0
3573017,142,1,3571105,3571105,3573017,1912,1912,1912,0,0,0
3575341,141,1,3570115,3570115,3575341,5226,5226,5226,0,0,0
3575658,151,1,3574908,3574908,3575658,750,750,750,0,0,0
3576531,122,1,3561873,3561873,3576531,14658,14658,14658,0,0,0
3578165,159,1,3577410,3577410,3578165,755,755,755,0,0,0
3579142,132,1,3567039,3567039,3579142,12103,12103,12103,0,0,0
3580145,157,1,3576571,3576571,3580145,3574,3574,3574,0,0,0
3581475,165,1,3578780,3578780,3581475,2695,2695,2695,0,0,0
3584239,160,1,3577412,3577412,3584239,6827,6827,6827,0,0,0
3584508,156,1,3575453,3575453,3584508,9055,9055,9055,0,0,0
3584602,162,1,3578012,3578012,3584602,6590,6590,6590,0,0,0
3587686,154,1,3575265,3575265,3587686,12421,12421,12421,0,0,0
3589456,161,1,3577496,3577496,3589456,11960,11960,11960,0,0,0
3593759,164,1,3578752,3578752,3593759,15007,15007,15007,0,0,0
3595245,153,1,3575206,3575206,3595245,20039,20039,20039,0,0,0
3599192,163,1,3578169,3578169,3599192,21023,21023,21023,0,0,0
3602446,146,1,3573828,3573828,3602446,28618,28618,28618,0,0,0
3604281,130,1,3566453,3566453,3604281,37828,37828,37828,0,0,0
3607978,177,1,3607156,3607156,3607978,822,822,822,0,0,0
3608384,131,1,3566765,3566765,3608384,41619,41619,41619,0,0,0
3610792,110,1,3525795,3525795,3610792,84997,84997,84997,0,0,0
3614844,158,1,3577076,3577076,3614844,37768,37768,37768,0,0,0
3617598,170,1,3586063,3586063,3617598,31535,31535,31535,0,0,0
3636707,169,1,3584166,3584166,3636707,52541,52541,52541,0,0,0
3638317,186,2,3626966,3626966,3638317,11351,11351,11351,0,0,0
3641211,195,1,3640288,3640288,3641211,923,923,923,0,0,0
3642563,143,1,3571167,3571167,3642563,71396,71396,71396,0,0,0
3645816,174,1,3605302,3605302,3645816,40514,40514,40514,0,0,0
3647604,212,1,3647110,3647110,3647604,494,494,494,0,0,0
3647733,202,1,3647004,3647004,3647733,729,729,729,0,0,0
3647877,233,1,3647290,3647290,3647877,587,587,587,0,0,0
3647919,238,1,3647307,3647307,3647919,612,612,612,0,0,0
3647919,247,1,3647341,3647341,3647919,578,578,578,0,0,0
3647979,223,1,3647208,3647208,3647979,771,771,771,0,0,0
3648001,232,1,3647282,3647282,3648001,719,719,719,0,0,0
3648008,256,1,3647605,3647605,3648008,403,403,403,0,0,0
3648098,228,1,3647261,3647261,3648098,837,837,837,0,0,0
3648212,235,1,3647299,3647299,3648212,913,913,913,0,0,0
3648369,259,1,3647663,3647663,3648369,706,706,706,0,0,0
3648407,128,1,3565644,3565644,3648407,82763,82763,82763,0,0,0
3649361,205,1,3647031,3647031,3649361,2330,2330,2330,0,0,0
3649704,215,1,3647178,3647178,3649704,2526,2526,2526,0,0,0
3649792,252,1,3647457,3647457,3649792,2335,2335,2335,0,0,0
3650363,251,1,3647436,3647436,3650363,2927,2927,2927,0,0,0
3650783,226,1,3647254,3647254,3650783,3529,3529,3529,0,0,0
3650925,208,1,3647078,3647078,3650925,3847,3847,3847,0,0,0
3650965,243,1,3647320,3647320,3650965,3645,3645,3645,0,0,0
3652586,260,1,3647728,3647728,3652586,4858,4858,4858,0,0,0
3653226,237,1,3647300,3647300,3653226,5926,5926,5926,0,0,0
3653957,200,1,3643855,3643855,3653957,10102,10102,10102,0,0,0
3655691,224,1,3647219,3647219,3655691,8472,8472,8472,0,0,0
3656278,168,1,3583573,3583573,3656278,72705,72705,72705,0,0,0
3656331,210,1,3647103,3647103,3656331,9228,9228,9228,0,0,0
3656601,269,1,3654136,3654136,3656601,2465,2465,2465,0,0,0
3656639,258,1,3647625,3647625,3656639,9014,9014,9014,0,0,0
3656965,266,1,3653392,3653392,3656965,3573,3573,3573,0,0,0
3658331,198,1,3642439,3642439,3658331,15892,15892,15892,0,0,0
3658879,219,1,3647197,3647197,3658879,11682,11682,11682,0,0,0
3659289,275,1,3658350,3658350,3659289,939,939,939,0,0,0
3659681,234,1,3647291,3647291,3659681,12390,12390,12390,0,0,0
3659890,214,1,3647127,3647127,3659890,12763,12763,12763,0,0,0
3660089,227,1,3647259,3647259,3660089,12830,12830,12830,0,0,0
3660242,225,1,3647227,3647227,3660242,13015,13015,13015,0,0,0
3660568,246,1,3647338,3647338,3660568,13230,13230,13230,0,0,0
3660993,148,1,3574099,3574099,3660993,86894,86894,86894,0,0,0
3662783,257,1,3647609,3647609,3662783,15174,15174,15174,0,0,0
3663285,241,1,3647317,3647317,3663285,15968,15968,15968,0,0,0
3663862,213,1,3647112,3647112,3663862,16750,16750,16750,0,0,0
3665107,194,1,3637534,3637534,3665107,27573,27573,27573,0,0,0
3665773,274,8,3658035,3658035,3665773,7738,7738,7738,0,0,0
3666673,255,1,3647572,3647572,3666673,19101,19101,19101,0,0,0
3667508,176,1,3607097,3607097,3667508,60411,60411,60411,0,0,0
3668280,248,1,3647344,3647344,3668280,20936,20936,20936,0,0,0
3670319,231,1,3647281,3647281,3670319,23038,23038,23038,0,0,0
3670741,272,1,3654830,3654830,3670741,15911,15911,15911,0,0,0
3671208,280,1,3670578,3670578,3671208,630,630,630,0,0,0
3671398,283,1,3670980,3670980,3671398,418,418,418,0,0,0
3672149,286,1,3671467,3671467,3672149,682,682,682,0,0,0
3672466,239,1,3647308,3647308,3672466,25158,25158,25158,0,0,0
3672749,289,1,3671964,3671964,3672749,785,785,785,0,0,0
3672828,291,1,3672180,3672180,3672828,648,648,648,0,0,0
3672857,216,1,3647178,3647178,3672857,25679,25679,25679,0,0,0
3673218,296,1,3672410,3672410,3673218,808,808,808,0,0,0
3673573,261,1,3647753,3647753,3673573,25820,25820,25820,0,0,0
3674669,301,1,3674271,3674271,3674669,398,398,398,0,0,0
3676104,290,1,3672117,3672117,3676104,3987,3987,3987,0,0,0
3678939,288,1,3671939,3671939,3678939,7000,7000,7000,0,0,0
3680724,166,1,3578792,3578792,3680724,101932,101932,101932,0,0,0
3681454,299,1,3673994,3673994,3681454,7460,7460,7460,0,0,0
3681852,277,1,3666094,3666094,3681852,15758,15758,15758,0,0,0
3682000,178,1,3607159,3607159,3682000,74841,74841,74841,0,0,0
3683005,150,1,3574847,3574847,3683005,108158,108158,108158,0,0,0
3683779,303,1,3676808,3676808,3683779,6971,6971,6971,0,0,0
3683784,300,1,3674114,3674114,3683784,9670,9670,9670,0,0,0
3684483,281,1,3670734,3670734,3684483,13749,13749,13749,0,0,0
3684486,295,1,3672383,3672383,3684486,12103,12103,12103,0,0,0
3686400,279,1,3670395,3670395,3686400,16005,16005,16005,0,0,0
3686426,244,1,3647325,3647325,3686426,39101,39101,39101,0,0,0
3687197,287,1,3671667,3671667,3687197,15530,15530,15530,0,0,0
3688150,196,1,3640478,3640478,3688150,47672,47672,47672,0,0,0
3689062,302,1,3676392,3676392,3689062,12670,12670,12670,0,0,0
3689549,222,1,3647208,3647208,3689549,42341,42341,42341,0,0,0
3689608,297,1,3672580,3672580,3689608,17028,17028,17028,0,0,0
3692224,207,1,3647066,3647066,3692224,45158,45158,45158,0,0,0
3695307,298,1,3673190,3673190,3695307,22117,22117,22117,0,0,0
3698387,185,2,3623941,3623941,3698387,74446,74446,74446,0,0,0
3698825,285,1,3671357,3671357,3698825,27468,27468,27468,0,0,0
3703221,245,1,3647332,3647332,3703221,55889,55889,55889,0,0,0
3707178,206,1,3647031,3647031,3707178,60147,60147,60147,0,0,0
3707809,313,1,3706636,3706636,3707809,1173,1173,1173,0,0,0
3710196,314,1,3708723,3708723,3710196,1473,1473,1473,0,0,0
3712969,221,1,3647202,3647202,3712969,65767,65767,65767,0,0,0
3723461,268,1,3654012,3654012,3723461,69449,69449,69449,0,0,0
3724723,278,1,3670151,3670151,3724723,54572,54572,54572,0,0,0
3725101,321,1,3724222,3724222,3725101,879,879,879,0,0,0
3725639,294,1,3672253,3672253,3725639,53386,53386,53386,0,0,0
3725691,284,1,3670988,3670988,3725691,54703,54703,54703,0,0,0
3726690,201,1,3646276,3646276,3726690,80414,80414,80414,0,0,0
3727660,209,1,3647099,3647099,3727660,80561,80561,80561,0,0,0
3727714,236,1,3647300,3647300,3727714,80414,80414,80414,0,0,0
3728008,211,1,3647105,3647105,3728008,80903,80903,80903,0,0,0
3728655,217,1,3647188,3647188,3728655,81467,81467,81467,0,0,0
3732779,318,1,3715968,3715968,3732779,16811,16811,16811,0,0,0
3733341,230,1,3647274,3647274,3733341,86067,86067,86067,0,0,0
3734554,292,1,3672227,3672227,3734554,62327,62327,62327,0,0,0
3738260,328,1,3736349,3736349,3738260,1911,1911,1911,0,0,0
3742355,220,1,3647201,3647201,3742355,95154,95154,95154,0,0,0
3742605,341,1,3741711,3741711,3742605,894,894,894,0,0,0
3744209,338,1,3740212,3740212,3744209,3997,3997,3997,0,0,0
3744285,253,1,3647459,3647459,3744285,96826,96826,96826,0,0,0
3744687,249,1,3647345,3647345,3744687,97342,97342,97342,0,0,0
3745653,347,1,3744774,3744774,3745653,879,879,879,0,0,0
3752702,348,1,3744827,3744827,3752702,7875,7875,4252,3623,7,0
3764616,582,1,3762668,3762668,3764616,1948,1948,1948,0,0,0
3767596,407,1,3745823,3745823,3767596,21773,21773,12656,9117,6,0
3769474,484,1,3746468,3746468,3769474,23006,23006,12339,10667,5,0
3770065,363,1,3745440,3745440,3770065,24625,24625,12934,11691,17,0
3770227,404,1,3745817,3745817,3770227,24410,24410,12818,11592,10,0
3770228,409,1,3745855,3745855,3770228,24373,24373,12819,11554,9,0
3770262,551,1,3747034,3747034,3770262,23228,23228,12208,11020,24,0
3770375,560,1,3747112,3747112,3770375,23263,23263,12889,10374,18,0
3770384,384,1,3745630,3745630,3770384,24754,24754,12862,11892,9,0
3770398,382,1,3745615,3745615,3770398,24783,24783,12876,11907,8,0
3770422,372,1,3745526,3745526,3770422,24896,24896,12901,11995,9,0
3770454,532,1,3746880,3746880,3770454,23574,23574,12919,10655,9,0
3770945,385,1,3745645,3745645,3770945,25300,25300,13423,11877,10,0
3770961,480,1,3746411,3746411,3770961,24550,24550,12978,11572,13,0
3772986,346,1,3744664,3744664,3772986,28322,28322,13545,14777,19,0
3778477,583,1,3769615,3769615,3778477,8862,8862,8862,0,0,0
3779556,525,1,3746824,3746824,3779556,32732,32732,17588,15144,14,0
3779861,505,1,3746662,3746662,3779861,33199,33199,17684,15515,14,0
3780192,561,1,3747175,3747175,3780192,33017,33017,17684,15333,22,0
3781889,394,1,3745725,3745725,3781889,36164,36164,19390,16774,17,0
3781906,477,1,3746376,3746376,3781906,35530,35530,17948,17582,16,0
3782452,552,1,3747050,3747050,3782452,35402,35402,18487,16915,30,0
3784302,356,1,3745371,3745371,3784302,38931,38931,19539,19392,22,0
3784600,556,1,3747066,3747066,3784600,37534,37534,18690,18844,26,0
3785493,504,1,3746651,3746651,3785493,38842,38842,19869,18973,17,0
3786044,470,1,3746329,3746329,3786044,39715,39715,21207,18508,16,0
3786490,524,1,3746804,3746804,3786490,39686,39686,21544,18142,16,0
3786738,406,1,3745820,3745820,3786738,40918,40918,21920,18998,16,0
3787657,603,1,3787055,3787055,3787657,602,602,602,0,0,0
3787828,513,1,3746718,3746718,3787828,41110,41110,21098,20012,18,0
3788100,597,1,3786814,3786814,3788100,1286,1286,1286,0,0,0
3788453,569,1,3747314,3747314,3788453,41139,41139,20747,20392,22,0
3788564,426,1,3745965,3745965,3788564,42599,42599,21838,20761,16,0
3789271,568,1,3747314,3747314,3789271,41957,41957,21078,20879,23,0
3789273,353,1,3745349,3745349,3789273,43924,43924,22183,21741,27,0
3789888,429,1,3745993,3745993,3789888,43895,43895,22493,21402,18,0
3790251,520,1,3746776,3746776,3790251,43475,43475,22059,21416,17,0
3791091,402,1,3745807,3745807,3791091,45284,45284,22905,22379,19,0
3791720,367,1,3745488,3745488,3791720,46232,46232,23046,23186,26,0
3791767,451,1,3746184,3746184,3791767,45583,45583,23252,22331,21,0
3793506,445,1,3746129,3746129,3793506,47377,47377,23850,23527,23,0
3793537,490,1,3746510,3746510,3793537,47027,47027,23753,23274,16,0
3793569,354,1,3745366,3745366,3793569,48203,48203,23580,24623,34,0
3794105,476,1,3746364,3746364,3794105,47741,47741,24394,23347,22,0
3794194,607,1,3787061,3787061,3794194,7133,7133,7133,0,0,0
3795457,401,1,3745789,3745789,3795457,49668,49668,25225,24443,25,0
3796625,601,1,3787044,3787044,3796625,9581,9581,9581,0,0,0
3798400,604,1,3787055,3787055,3798400,11345,11345,11345,0,0,0
3799706,605,1,3787058,3787058,3799706,12648,12648,12648,0,0,0
3801051,613,1,3800383,3800383,3801051,668,668,668,0,0,0
3802870,595,1,3784244,3784244,3802870,18626,18626,18626,0,0,0
3808746,602,1,3787054,3787054,3808746,21692,21692,21692,0,0,0
3809144,599,1,3786963,3786963,3809144,22181,22181,22181,0,0,0
3810025,600,1,3787039,3787039,3810025,22986,22986,22986,0,0,0
3811157,614,1,3802816,3802816,3811157,8341,8341,8341,0,0,0
3815989,620,1,3815002,3815002,3815989,987,987,987,0,0,0
3816255,622,1,3815247,3815247,3816255,1008,1008,1008,0,0,0
3817765,621,1,3815068,3815068,3817765,2697,2697,2697,0,0,0
3819615,617,1,3814820,3814820,3819615,4795,4795,4795,0,0,0
3824255,627,1,3820034,3820034,3824255,4221,4221,4221,0,0,0
3825689,553,1,3747052,3747052,3825689,78637,78637,43537,35100,39,0
3825918,514,1,3746733,3746733,3825918,79185,79185,42862,36323,27,0
3832833,344,1,3743085,3743085,3832833,89748,89748,42094,47654,32,0
3841657,343,1,3742286,3742286,3841657,99371,99371,50128,49243,27,0
3843987,638,1,3842068,3842068,3843987,1919,1919,1919,0,0,0
3845506,629,1,3823211,3823211,3845506,22295,22295,22295,0,0,0
3860506,457,1,3746224,3746224,3860506,114282,114282,65258,49024,30,0
3863837,327,1,3735060,3735060,3863837,128777,128777,53957,74820,22,0
3871576,472,1,3746331,3746331,3871576,125245,125245,63743,61502,31,0
3875116,507,1,3746665,3746665,3875116,128451,128451,65848,62603,30,0
3879376,410,1,3745861,3745861,3879376,133515,133515,65867,67648,33,0
3883861,584,1,3769618,3769618,3883861,114243,114243,68411,45832,11,0
3884711,598,1,3786922,3786922,3884711,97789,97789,64192,33597,2,0
3886854,515,1,3746740,3746740,3886854,140114,140114,66343,73771,30,0
3888523,650,1,3883556,3883556,3888523,4967,4967,4967,0,0,0
3890047,649,1,3880144,3880144,3890047,9903,9903,9903,0,0,0
3890613,587,1,3769659,3769659,3890613,120954,120954,71234,49720,16,0
3894317,618,1,3814858,3814858,3894317,79459,79459,73889,5570,2,0
3895499,651,1,3887806,3887806,3895499,7693,7693,7693,0,0,0
3896743,648,1,3874264,3874264,3896743,22479,22479,22479,0,0,0
3903486,656,1,3902978,3902978,3903486,508,508,508,0,0,0
3911638,339,1,3741251,3741251,3911638,170387,170387,79513,90874,31,0
3917263,309,1,3680101,3680101,3917263,237162,237162,84380,152782,6,0
3918169,647,1,3874091,3874091,3918169,44078,44078,44078,0,0,0
3919988,619,1,3814979,3814979,3919988,105009,105009,83249,21760,5,0
3920775,660,1,3909567,3909567,3920775,11208,11208,11208,0,0,0
3921190,658,1,3907083,3907083,3921190,14107,14107,14107,0,0,0
3925787,282,1,3670951,3670951,3925787,254836,254836,86569,168267,4,0
3925803,665,1,3921476,3921476,3925803,4327,4327,4327,0,0,0
3925820,575,1,3756158,3756158,3925820,169662,169662,84087,85575,28,0
3929209,657,1,3902981,3902981,3929209,26228,26228,26228,0,0,0
3929837,653,1,3889964,3889964,3929837,39873,39873,39873,0,0,0
3936283,632,1,3829995,3829995,3936283,106288,106288,88793,17495,5,0
3936951,676,1,3934794,3934794,3936951,2157,2157,2157,0,0,0
3937438,293,1,3672229,3672229,3937438,265209,265209,95332,169877,4,0
3937636,674,1,3931311,3931311,3937636,6325,6325,6325,0,0,0
3942274,655,1,3902974,3902974,3942274,39300,39300,39300,0,0,0
3942944,675,1,3931338,3931338,3942944,11606,11606,11606,0,0,0
3945568,661,1,3913270,3913270,3945568,32298,32298,32298,0,0,0
3946648,679,1,3936744,3936744,3946648,9904,9904,9904,0,0,0
3957633,666,1,3921569,3921569,3957633,36064,36064,36064,0,0,0
3960655,652,1,3888614,3888614,3960655,72041,72041,72041,0,0,0
3970293,918,1,3966753,3966753,3970293,3540,3540,3540,0,0,0
3980489,880,1,3962390,3962390,3980489,18099,18099,10478,7621,7,0
3980914,927,1,3980158,3980158,3980914,756,756,756,0,0,0
3980948,928,1,3980189,3980189,3980948,759,759,759,0,0,0
3981410,756,1,3961141,3961141,3981410,20269,20269,10682,9587,20,0
3981445,837,1,3961937,3961937,3981445,19508,19508,10671,8837,27,0
3981459,931,1,3980534,3980534,3981459,925,925,925,0,0,0
3981916,713,1,3960773,3960773,3981916,21143,21143,11050,10093,26,0
3982047,887,1,3962450,3962450,3982047,19597,19597,10901,8696,9,0
3982254,885,1,3962428,3962428,3982254,19826,19826,11021,8805,10,0
3982376,697,1,3960616,3960616,3982376,21760,21760,11121,10639,31,0
3982893,711,1,3960771,3960771,3982893,22122,22122,11567,10555,33,0
3984429,692,1,3960581,3960581,3984429,23848,23848,11181,12667,36,0
3984731,741,1,3961000,3961000,3984731,23731,23731,11502,12229,32,0
3990633,782,1,3961421,3961421,3990633,29212,29212,15499,13713,16,0
3991405,809,1,3961655,3961655,3991405,29750,29750,15590,14160,17,0
3992053,861,1,3962196,3962196,3992053,29857,29857,16085,13772,15,0
3992065,808,1,3961643,3961643,3992065,30422,30422,15602,14820,19,0
3992527,715,1,3960798,3960798,3992527,31729,31729,15991,15738,21,0
3993028,749,1,3961082,3961082,3993028,31946,31946,16602,15344,22,0
3995093,725,1,3960867,3960867,3995093,34226,34226,15943,18283,38,0
3995790,868,1,3962253,3962253,3995790,33537,33537,17943,15594,32,0
3995871,936,1,3981118,3981118,3995871,14753,14753,14753,0,0,0
3996121,909,1,3962803,3962803,3996121,33318,33318,17775,15543,35,0
3996415,912,1,3962841,3962841,3996415,33574,33574,18069,15505,29,0
3996758,816,1,3961762,3961762,3996758,34996,34996,18357,16639,16,0
3997090,794,1,3961517,3961517,3997090,35573,35573,18514,17059,18,0
3998198,826,1,3961845,3961845,3998198,36353,36353,18703,17650,20,0
3998988,856,1,3962099,3962099,3998988,36889,36889,18825,18064,18,0
3999114,716,1,3960807,3960807,3999114,38307,38307,18898,19409,41,0
3999357,708,1,3960736,3960736,3999357,38621,38621,18949,19672,33,0
3999510,695,1,3960609,3960609,3999510,38901,38901,19089,19812,40,0
4000002,759,1,3961161,3961161,4000002,38841,38841,19583,19258,29,0
4000075,755,1,3961141,3961141,4000075,38934,38934,19854,19080,29,0
4000167,775,1,3961331,3961331,4000167,38836,38836,19754,19082,35,0
4000190,757,1,3961154,3961154,4000190,39036,39036,19771,19265,28,0
4000498,894,1,3962505,3962505,4000498,37993,37993,19753,18240,35,0
4000781,685,1,3960546,3960546,4000781,40235,40235,20164,20071,27,0
4000885,736,1,3960939,3960939,4000885,39946,39946,20019,19927,46,0
4001008,703,1,3960664,3960664,4001008,40344,40344,20145,20199,41,0
4001207,702,1,3960641,3960641,4001207,40566,40566,20163,20403,44,0
4001464,810,1,3961657,3961657,4001464,39807,39807,20384,19423,26,0
4001969,724,1,3960865,3960865,4001969,41104,41104,20824,20280,44,0
4002022,875,1,3962325,3962325,4002022,39697,39697,20789,18908,28,0
4002776,812,1,3961692,3961692,4002776,41084,41084,21191,19893,23,0
4004441,787,1,3961469,3961469,4004441,42972,42972,21334,21638,24,0
4005568,777,1,3961377,3961377,4005568,44191,44191,21286,22905,22,0
4013165,933,1,3980571,3980571,4013165,32594,32594,27232,5362,5,0
4014286,932,1,3980571,3980571,4014286,33715,33715,28353,5362,5,0
4021638,924,1,3976568,3976568,4021638,45070,45070,29727,15343,12,0
4023890,926,1,3977569,3977569,4023890,46321,46321,31935,14386,12,0
4032017,962,1,4030780,4030780,4032017,1237,1237,1237,0,0,0
4033355,966,1,4031617,4031617,4033355,1738,1738,1738,0,0,0
4038857,925,1,3977543,3977543,4038857,61314,61314,36722,24592,13,0
4041080,961,1,4030755,4030755,4041080,10325,10325,10325,0,0,0
4041375,965,1,4030891,4030891,4041375,10484,10484,10484,0,0,0
4051557,960,1,4030723,4030723,4051557,20834,20834,20834,0,0,0
4054331,860,1,3962151,3962151,4054331,92180,92180,52228,39952,28,0
4058456,938,1,3986190,3986190,4058456,72266,72266,44935,27331,2,0
4060117,893,1,3962505,3962505,4060117,97612,97612,53817,43795,48,0
4060153,783,1,3961428,3961428,4060153,98725,98725,55428,43297,32,0
4060671,774,1,3961320,3961320,4060671,99351,99351,55946,43405,38,0
4062135,681,1,3955416,3955416,4062135,106719,106719,46870,59849,30,0
4062672,874,1,3962325,3962325,4062672,100347,100347,56364,43983,35,0
4062777,891,1,3962480,3962480,4062777,100297,100297,56477,43820,29,0
4062852,781,1,3961409,3961409,4062852,101443,101443,58127,43316,29,0
4067317,1006,1,4063022,4063022,4067317,4295,4295,4295,0,0,0
4067348,1011,1,4063079,4063079,4067348,4269,4269,4269,0,0,0
4067473,1037,1,4063276,4063276,4067473,4197,4197,4197,0,0,0
4067577,1048,1,4063426,4063426,4067577,4151,4151,4151,0,0,0
4068973,982,1,4062524,4062524,4068973,6449,6449,6449,0,0,0
4069336,1034,1,4063230,4063230,4069336,6106,6106,6106,0,0,0
4069707,1065,1,4063948,4063948,4069707,5759,5759,5759,0,0,0
4069715,1069,1,4063971,4063971,4069715,5744,5744,5744,0,0,0
4069731,1067,1,4063969,4063969,4069731,5762,5762,5762,0,0,0
4070110,973,1,4062418,4062418,4070110,7692,7692,7692,0,0,0
4070427,1026,1,4063184,4063184,4070427,7243,7243,7243,0,0,0
4070518,1044,1,4063396,4063396,4070518,7122,7122,7122,0,0,0
4070604,981,1,4062496,4062496,4070604,8108,8108,8108,0,0,0
4070720,996,1,4062807,4062807,4070720,7913,7913,7913,0,0,0
4070780,977,1,4062463,4062463,4070780,8317,8317,8317,0,0,0
4070858,1015,1,4063096,4063096,4070858,7762,7762,7762,0,0,0
4071193,1039,1,4063295,4063295,4071193,7898,7898,7898,0,0,0
4071302,1053,1,4063591,4063591,4071302,7711,7711,7711,0,0,0
4071451,1068,1,4063971,4063971,4071451,7480,7480,7480,0,0,0
4079394,1014,2,4063087,4063087,4079394,16307,16307,16307,0,0,0
4084865,1040,1,4063330,4063330,4084865,21535,21535,21535,0,0,0
4085023,1010,1,4063066,4063066,4085023,21957,21957,21957,0,0,0
4085300,999,1,4062845,4062845,4085300,22455,22455,22455,0,0,0
4099782,969,1,4062358,4062358,4099782,37424,37424,37424,0,0,0
4100511,989,1,4062634,4062634,4100511,37877,37877,37877,0,0,0
4100816,978,1,4062475,4062475,4100816,38341,38341,38341,0,0,0
4102199,771,1,3961307,3961307,4102199,140892,140892,56256,84636,34,0
4114982,766,1,3961223,3961223,4114982,153759,153759,58802,94957,29,0
4117796,1078,1,4093922,4093922,4117796,23874,23874,23874,0,0,0
4125130,768,1,3961273,3961273,4125130,163857,163857,56154,107703,34,0
4125158,761,1,3961182,3961182,4125158,163976,163976,56456,107520,39,0
4128228,871,1,3962280,3962280,4128228,165948,165948,53680,112268,42,0
4129037,678,1,3936391,3936391,4129037,192646,192646,54352,138294,5,0
4129501,878,1,3962377,3962377,4129501,167124,167124,54952,112172,30,0
4131019,680,1,3955412,3955412,4131019,175607,175607,61890,113717,21,0
4134815,1079,1,4093941,4093941,4134815,40874,40874,40874,0,0,0
4137420,1084,1,4094054,4094054,4137420,43366,43366,43366,0,0,0
4138901,1081,1,4093947,4093947,4138901,44954,44954,44954,0,0,0
4140498,988,1,4062630,4062630,4140498,77868,77868,65578,12290,1,0
4141029,1070,1,4064003,4064003,4141029,77026,77026,67834,9192,1,0
4152978,1029,1,4063200,4063200,4152978,89778,89778,72544,17234,2,0
4155255,1061,1,4063641,4063641,4155255,91614,91614,71037,20577,3,0
4171363,995,1,4062771,4062771,4171363,108592,108592,71843,36749,3,0
4172863,1097,1,4172200,4172200,4172863,663,663,663,0,0,0
4173181,1098,1,4172202,4172202,4173181,979,979,979,0,0,0
4174607,1331,1,4173794,4173794,4174607,813,813,813,0,0,0
4174868,1308,1,4173696,4173696,4174868,1172,1172,849,323,1,0
4175077,1156,1,4172997,4172997,4175077,2080,2080,802,1278,6,0
4175268,1129,1,4172872,4172872,4175268,2396,2396,786,1610,6,0
4175304,1176,1,4173090,4173090,4175304,2214,2214,835,1379,5,0
4175373,1373,1,4173983,4173983,4175373,1390,1390,884,506,2,0
4175378,1135,1,4172898,4172898,4175378,2480,2480,840,1640,6,0
4175504,1282,1,4173576,4173576,4175504,1928,1928,975,953,4,0
4175804,1182,1,4173112,4173112,4175804,2692,2692,1170,1522,6,0
4175851,1438,1,4174300,4174300,4175851,1551,1551,929,622,2,0
4176183,1424,1,4174224,4174224,4176183,1959,1959,1298,661,3,0
4176183,1450,1,4174355,4174355,4176183,1828,1828,1292,536,1,0
4176203,1445,1,4174329,4174329,4176203,1874,1874,1006,868,2,0
4176212,1319,1,4173738,4173738,4176212,2474,2474,1177,1297,4,0
4176238,1420,1,4174199,4174199,4176238,2039,2039,1195,844,3,0
4176272,1419,1,4174197,4174197,4176272,2075,2075,1205,870,4,0
4176381,1387,1,4174045,4174045,4176381,2336,2336,1199,1137,3,0
4176388,1433,1,4174272,4174272,4176388,2116,2116,1206,910,4,0
4176402,1155,1,4172990,4172990,4176402,3412,3412,1219,2193,10,0
4176439,1214,1,4173242,4173242,4176439,3197,3197,1243,1954,7,0
4176732,1315,1,4173718,4173718,4176732,3014,3014,1350,1664,12,0
4176779,1153,1,4172985,4172985,4176779,3794,3794,1366,2428,24,0
4176834,1143,1,4172934,4172934,4176834,3900,3900,1377,2523,20,0
4176869,1316,1,4173724,4173724,4176869,3145,3145,1372,1773,21,0
4176910,1290,1,4173612,4173612,4176910,3298,3298,1388,1910,19,0
4178655,1526,1,4176848,4176848,4178655,1807,1807,989,818,2,0
4178889,1512,1,4176781,4176781,4178889,2108,2108,818,1290,1,0
4179441,1580,1,4177101,4177101,4179441,2340,2340,1147,1193,5,0
4179474,1708,1,4177655,4177655,4179474,1819,1819,858,961,2,0
4179508,1696,1,4177608,4177608,4179508,1900,1900,889,1011,2,0
4179518,1763,1,4177920,4177920,4179518,1598,1598,812,786,1,0
4179541,1764,1,4177929,4177929,4179541,1612,1612,826,786,1,0
4179621,1740,1,4177798,4177798,4179621,1823,1823,970,853,1,0
4179671,1803,1,4178207,4178207,4179671,1464,1464,912,552,1,0
4179703,1613,1,4177232,4177232,4179703,2471,2471,1005,1466,5,0
4179860,1706,1,4177650,4177650,4179860,2210,2210,1162,1048,4,0
4179885,1686,1,4177567,4177567,4179885,2318,2318,1170,1148,3,0
4179901,1532,1,4176874,4176874,4179901,3027,3027,1162,1865,4,0
4179975,1710,1,4177668,4177668,4179975,2307,2307,1134,1173,2,0
4179983,1599,1,4177179,4177179,4179983,2804,2804,1162,1642,5,0
4179998,1648,1,4177396,4177396,4179998,2602,2602,1173,1429,7,0
4180008,1596,1,4177165,4177165,4180008,2843,2843,1171,1672,9,0
4180042,1633,1,4177329,4177329,4180042,2713,2713,1196,1517,6,0
4180067,1474,1,4176590,4176590,4180067,3477,3477,1196,2281,4,0
4180071,1460,1,4176493,4176493,4180071,3578,3578,1198,2380,2,0
4180078,1634,1,4177331,4177331,4180078,2747,2747,1203,1544,8,0
4180096,1574,1,4177063,4177063,4180096,3033,3033,1215,1818,8,0
4180129,1793,1,4178068,4178068,4180129,2061,2061,1233,828,4,0
4180131,1488,1,4176660,4176660,4180131,3471,3471,1218,2253,7,0
4180231,1575,1,4177074,4177074,4180231,3157,3157,1317,1840,12,0
4180247,1765,1,4177930,4177930,4180247,2317,2317,1234,1083,5,0
4180355,1503,1,4176740,4176740,4180355,3615,3615,1343,2272,8,0
4180410,1649,1,4177405,4177405,4180410,3005,3005,1303,1702,7,0
4180462,1577,1,4177083,4177083,4180462,3379,3379,1347,2032,13,0
4180534,1667,1,4177485,4177485,4180534,3049,3049,1374,1675,15,0
4180542,1676,1,4177523,4177523,4180542,3019,3019,1382,1637,12,0
4180619,1514,1,4176791,4176791,4180619,3828,3828,1399,2429,18,0
4180699,1402,1,4174116,4174116,4180699,6583,6583,1406,5177,28,0
4180767,1506,1,4176748,4176748,4180767,4019,4019,1409,2610,20,0
4180809,1767,1,4177938,4177938,4180809,2871,2871,1412,1459,18,0
4180842,1687,1,4177569,4177569,4180842,3273,3273,1415,1858,20,0
4181703,1903,1,4180895,4180895,4181703,808,808,808,0,0,0
4181799,1831,1,4180512,4180512,4181799,1287,1287,792,495,4,0
4181867,1862,1,4180661,4180661,4181867,1206,1206,863,343,4,0
4181996,1963,1,4181193,4181193,4181996,803,803,803,0,0,0
4182000,1869,1,4180693,4180693,4182000,1307,1307,924,383,4,0
4182007,1859,1,4180646,4180646,4182007,1361,1361,875,486,4,0
4182024,1880,1,4180751,4180751,4182024,1273,1273,950,323,2,0
4182039,1917,1,4180962,4180962,4182039,1077,1077,974,103,2,0
4182148,1981,1,4181352,4181352,4182148,796,796,796,0,0,0
4182499,1819,1,4180457,4180457,4182499,2042,2042,1320,722,8,0
4182510,1830,1,4180511,4180511,4182510,1999,1999,1351,648,7,0
4182581,1939,1,4181059,4181059,4182581,1522,1522,1154,368,2,0
4182587,1818,1,4180451,4180451,4182587,2136,2136,1408,728,8,0
4182664,1821,1,4180470,4180470,4182664,2194,2194,1450,744,8,0
4182761,1758,1,4177901,4177901,4182761,4860,4860,1516,3344,19,0
4182775,1919,1,4180967,4180967,4182775,1808,1808,1346,462,3,0
4182806,1317,1,4173730,4173730,4182806,9076,9076,1452,7624,26,0
4182821,1389,1,4174058,4174058,4182821,8763,8763,1436,7327,23,0
4182873,1635,1,4177332,4177332,4182873,5541,5541,1474,4067,26,0
4182878,1927,1,4181007,4181007,4182878,1871,1871,1427,444,2,0
4182906,1164,1,4173039,4173039,4182906,9867,9867,1454,8413,36,0
4182909,1711,1,4177668,4177668,4182909,5241,5241,1429,3812,21,0
4182913,1755,1,4177888,4177888,4182913,5025,5025,1433,3592,20,0
4182921,1361,1,4173929,4173929,4182921,8992,8992,1440,7552,28,0
4182925,1147,1,4172949,4172949,4182925,9976,9976,1438,8538,32,0
4182931,1224,1,4173287,4173287,4182931,9644,9644,1440,8204,26,0
4182953,1883,1,4180779,4180779,4182953,2174,2174,1459,715,5,0
4182981,1554,1,4176978,4176978,4182981,6003,6003,1468,4535,26,0
4183062,1969,1,4181221,4181221,4183062,1841,1841,1524,317,1,0
4183073,1937,1,4181047,4181047,4183073,2026,2026,1458,568,3,0
4183112,1523,1,4176834,4176834,4183112,6278,6278,1492,4786,22,0
4183113,1700,1,4177624,4177624,4183113,5489,5489,1460,4029,28,0
4183123,1925,1,4180992,4180992,4183123,2131,2131,1469,662,5,0
4183139,1865,1,4180671,4180671,4183139,2468,2468,1477,991,8,0
4183169,1367,1,4173956,4173956,4183169,9213,9213,1498,7715,26,0
4183203,1745,1,4177834,4177834,4183203,5369,5369,1504,3865,24,0
4183268,1666,1,4177478,4177478,4183268,5790,5790,1539,4251,21,0
4183268,1829,1,4180510,4180510,4183268,2758,2758,1535,1223,11,0
4183283,1962,1,4181179,4181179,4183283,2104,2104,1494,610,2,0
4183291,1293,1,4173626,4173626,4183291,9665,9665,1501,8164,32,0
4183306,1432,1,4174271,4174271,4183306,9035,9035,1508,7527,30,0
4183331,1522,1,4176834,4176834,4183331,6497,6497,1525,4972,27,0
4183349,1298,1,4173644,4173644,4183349,9705,9705,1519,8186,31,0
4183363,1418,1,4174196,4174196,4183363,9167,9167,1522,7645,34,0
4183366,1878,1,4180739,4180739,4183366,2627,2627,1511,1116,10,0
4183376,1597,1,4177171,4177171,4183376,6205,6205,1521,4684,32,0
4183388,1824,1,4180486,4180486,4183388,2902,2902,1530,1372,13,0
4183400,1274,1,4173533,4173533,4183400,9867,9867,1533,8334,34,0
4183420,1490,1,4176668,4176668,4183420,6752,6752,1542,5210,23,0
4183420,1891,1,4180831,4180831,4183420,2589,2589,1541,1048,6,0
4183449,1563,1,4177014,4177014,4183449,6435,6435,1552,4883,26,0
4183451,1473,1,4176584,4176584,4183451,6867,6867,1527,5340,23,0
4183508,1145,1,4172941,4172941,4183508,10567,10567,1584,8983,38,0
4183532,1728,1,4177752,4177752,4183532,5780,5780,1552,4228,18,0
4183547,1822,1,4180482,4180482,4183547,3065,3065,1545,1520,15,0
4183574,1637,1,4177345,4177345,4183574,6229,6229,1566,4663,26,0
4183575,1475,1,4176595,4176595,4183575,6980,6980,1543,5437,23,0
4183586,1134,1,4172897,4172897,4183586,10689,10689,1554,9135,39,0
4183601,1301,1,4173655,4173655,4183601,9946,9946,1561,8385,32,0
4183643,1215,1,4173250,4173250,4183643,10393,10393,1594,8799,38,0
4183681,1491,1,4176675,4176675,4183681,7006,7006,1590,5416,26,0
4183734,1233,1,4173326,4173326,4183734,10408,10408,1607,8801,33,0
4183761,1327,1,4173771,4173771,4183761,9990,9990,1587,8403,31,0
4183884,1539,1,4176913,4176913,4183884,6971,6971,1689,5282,30,0
4183890,1721,1,4177719,4177719,4183890,6171,6171,1589,4582,25,0
4183905,1158,1,4173003,4173003,4183905,10902,10902,1599,9303,45,0
4183930,1396,1,4174089,4174089,4183930,9841,9841,1615,8226,29,0
4183940,1682,1,4177551,4177551,4183940,6389,6389,1599,4790,31,0
4183944,1276,1,4173545,4173545,4183944,10399,10399,1598,8801,34,0
4183950,1255,1,4173426,4173426,4183950,10524,10524,1604,8920,32,0
4183969,1854,1,4180623,4180623,4183969,3346,3346,1618,1728,17,0
4183991,1733,1,4177771,4177771,4183991,6220,6220,1622,4598,26,0
4184054,1762,1,4177919,4177919,4184054,6135,6135,1609,4526,30,0
4184068,1578,1,4177089,4177089,4184068,6979,6979,1617,5362,38,0
4184116,1659,1,4177450,4177450,4184116,6666,6666,1656,5010,33,0
4184187,1802,1,4178196,4178196,4184187,5991,5991,1693,4298,34,0
4184234,1746,1,4177835,4177835,4184234,6399,6399,1668,4731,30,0
4184256,1357,1,4173912,4173912,4184256,10344,10344,1649,8695,35,0
4184294,1354,1,4173899,4173899,4184294,10395,10395,1687,8708,32,0
4184470,1392,1,4174071,4174071,4184470,10399,10399,1832,8567,35,0
4184486,1806,1,4180385,4180385,4184486,4101,4101,1677,2424,18,0
4184505,1322,1,4173751,4173751,4184505,10754,10754,1682,9072,37,0
4184531,1727,1,4177745,4177745,4184531,6786,6786,1698,5088,24,0
4184619,1791,1,4178054,4178054,4184619,6565,6565,1765,4800,36,0
4184661,1311,1,4173706,4173706,4184661,10955,10955,1727,9228,35,0
4184682,1540,1,4176914,4176914,4184682,7768,7768,1710,6058,32,0
4184739,1715,1,4177693,4177693,4184739,7046,7046,1746,5300,24,0
4184878,1091,1,4171913,4171913,4184878,12965,12965,1835,11130,28,0
4184904,1360,1,4173925,4173925,4184904,10979,10979,1734,9245,34,0
4184954,1828,1,4180507,4180507,4184954,4447,4447,1777,2670,15,0
4185013,1246,1,4173384,4173384,4185013,11629,11629,1788,9841,43,0
4185018,1581,1,4177105,4177105,4185018,7913,7913,1741,6172,29,0
4185027,1775,1,4177974,4177974,4185027,7053,7053,1759,5294,23,0
4185203,1559,1,4176998,4176998,4185203,8205,8205,1934,6271,38,0
4185228,1216,1,4173253,4173253,4185228,11975,11975,1792,10183,43,0
4185271,1992,1,4184050,4184050,4185271,1221,1221,1221,0,0,0
4185282,1714,1,4177692,4177692,4185282,7590,7590,1796,5794,26,0
4185650,1820,1,4180464,4180464,4185650,5186,5186,2158,3028,22,0
4185657,1417,1,4174185,4174185,4185657,11472,11472,1800,9672,42,0
4185684,1413,1,4174169,4174169,4185684,11515,11515,1827,9688,42,0
4185904,1846,1,4180588,4180588,4185904,5316,5316,2024,3292,15,0
4185932,1364,1,4173938,4173938,4185932,11994,11994,1855,10139,43,0
4186554,1464,1,4176518,4176518,4186554,10036,10036,2454,7582,28,0
4186962,1909,1,4180922,4180922,4186962,6040,6040,2243,3797,13,0
4187056,1136,1,4172905,4172905,4187056,14151,14151,1948,12203,48,0
4187166,1970,1,4181233,4181233,4187166,5933,5933,2050,3883,15,0
4187285,1654,1,4177421,4177421,4187285,9864,9864,2060,7804,37,0
4187500,1501,1,4176728,4176728,4187500,10772,10772,2247,8525,37,0
4188694,1102,1,4172515,4172515,4188694,16179,16179,2071,14108,44,0
4188810,1412,1,4174165,4174165,4188810,14645,14645,2188,12457,44,0
4189631,1299,1,4173651,4173651,4189631,15980,15980,2982,12998,44,0
4189695,1117,1,4172638,4172638,4189695,17057,17057,2251,14806,47,0
4189896,1124,1,4172671,4172671,4189896,17225,17225,2444,14781,42,0
4189919,1462,1,4176507,4176507,4189919,13412,13412,2270,11142,36,0
4189994,1583,1,4177114,4177114,4189994,12880,12880,2326,10554,42,0
4190776,1631,1,4177317,4177317,4190776,13459,13459,3086,10373,42,0
4192210,1152,1,4172984,4172984,4192210,19226,19226,3080,16146,45,0
4192788,1571,1,4177050,4177050,4192788,15738,15738,3032,12706,38,0
4194467,1253,1,4173415,4173415,4194467,21052,21052,4224,16828,48,0
4195447,1451,1,4174356,4174356,4195447,21091,21091,4230,16861,37,0
4196333,1604,1,4177200,4177200,4196333,19133,19133,4136,14997,47,0
4197154,1660,1,4177450,4177450,4197154,19704,19704,4071,15633,41,0
4197576,1847,1,4180592,4180592,4197576,16984,16984,3672,13312,25,0
4197738,1096,1,4172174,4172174,4197738,25564,25564,3414,22150,43,0
4197806,1099,1,4172205,4172205,4197806,25601,25601,3482,22119,43,0
4198154,1931,1,4181025,4181025,4198154,17129,17129,4020,13109,20,0
4198519,1159,1,4173011,4173011,4198519,25508,25508,4195,21313,52,0
4198549,1665,1,4177470,4177470,4198549,21079,21079,4101,16978,35,0
4198652,1916,1,4180952,4180952,4198652,17700,17700,4153,13547,22,0
4198776,1739,1,4177795,4177795,4198776,20981,20981,4195,16786,35,0
4198790,1678,1,4177531,4177531,4198790,21259,21259,4115,17144,43,0
4199290,1894,1,4180853,4180853,4199290,18437,18437,4619,13818,24,0
4199603,1508,1,4176761,4176761,4199603,22842,22842,4463,18379,43,0
4200053,1722,1,4177725,4177725,4200053,22328,22328,4624,17704,42,0
4200122,1805,1,4178246,4178246,4200122,21876,21876,4264,17612,45,0
4200169,1344,1,4173855,4173855,4200169,26314,26314,4277,22037,45,0
4200234,1477,1,4176609,4176609,4200234,23625,23625,4295,19330,39,0
4200445,1237,1,4173346,4173346,4200445,27099,27099,4482,22617,52,0
4200549,1181,1,4173106,4173106,4200549,27443,27443,4397,23046,57,0
4200572,1481,1,4176621,4176621,4200572,23951,23951,4318,19633,37,0
4200656,1304,1,4173671,4173671,4200656,26985,26985,4480,22505,52,0
4200723,1744,1,4177825,4177825,4200723,22898,22898,4503,18395,44,0
4201009,1620,1,4177260,4177260,4201009,23749,23749,4735,19014,42,0
4202637,1465,1,4176519,4176519,4202637,26118,26118,6097,20021,39,0
4203002,1266,1,4173482,4173482,4203002,29520,29520,4847,24673,49,0
4203164,1761,1,4177915,4177915,4203164,25249,25249,4665,20584,44,0
4203200,1695,1,4177606,4177606,4203200,25594,25594,4660,20934,42,0
4203458,1294,1,4173628,4173628,4203458,29830,29830,4906,24924,55,0
4205747,1719,1,4177715,4177715,4205747,28032,28032,6949,21083,45,0
4206215,1642,1,4177368,4177368,4206215,28847,28847,5203,23644,48,0
4207525,1248,1,4173393,4173393,4207525,34132,34132,6157,27975,61,0
4207937,1089,1,4171575,4171575,4207937,36362,36362,5315,31047,16,0
4209831,1588,1,4177139,4177139,4209831,32692,32692,7097,25595,38,0
4212394,1841,1,4180566,4180566,4212394,31828,31828,6753,25075,26,0
4212426,1455,1,4176476,4176476,4212426,35950,35950,6126,29824,38,0
4212497,1149,1,4172960,4172960,4212497,39537,39537,6094,33443,54,0
4212608,1113,1,4172603,4172603,4212608,40005,40005,6205,33800,55,0
4213333,1309,1,4173696,4173696,4213333,39637,39637,6904,32733,57,0
4213354,1468,1,4176538,4176538,4213354,36816,36816,6261,30555,44,0
4213723,1558,1,4176991,4176991,4213723,36732,36732,7134,29598,48,0
4213875,1938,1,4181055,4181055,4213875,32820,32820,6676,26144,30,0
4213919,1668,1,4177485,4177485,4213919,36434,36434,6833,29601,40,0
4213942,1848,1,4180597,4180597,4213942,33345,33345,6776,26569,27,0
4214084,1543,1,4176925,4176925,4214084,37159,37159,7060,30099,45,0
4214196,1743,1,4177823,4177823,4214196,36373,36373,7066,29307,47,0
4214419,1168,1,4173053,4173053,4214419,41366,41366,6932,34434,59,0
4214699,1221,1,4173275,4173275,4214699,41424,41424,6947,34477,61,0
4214825,1213,1,4173240,4173240,4214825,41585,41585,6949,34636,61,0
4214830,1850,1,4180606,4180606,4214830,34224,34224,7001,27223,32,0
4214849,1283,1,4173576,4173576,4214849,41273,41273,7097,34176,57,0
4215036,1284,1,4173579,4173579,4215036,41457,41457,6964,34493,58,0
4215612,1422,1,4174217,4174217,4215612,41395,41395,7413,33982,54,0
4216053,1398,1,4174099,4174099,4216053,41954,41954,7854,34100,53,0
4216257,1201,1,4173196,4173196,4216257,43061,43061,8187,34874,55,0
4216339,1163,1,4173028,4173028,4216339,43311,43311,8372,34939,62,0
4220318,1180,1,4173105,4173105,4220318,47213,47213,12251,34962,62,0
4220417,1570,1,4177049,4177049,4220417,43368,43368,7299,36069,50,0
4220466,1519,1,4176809,4176809,4220466,43657,43657,7348,36309,46,0
4220927,1573,1,4177061,4177061,4220927,43866,43866,7809,36057,53,0
4222094,1643,1,4177373,4177373,4222094,44721,44721,8367,36354,48,0
4222114,1776,1,4177979,4177979,4222114,44135,44135,7220,36915,41,0
4222125,1949,1,4181106,4181106,4222125,41019,41019,7211,33808,22,0
4222236,1979,1,4181313,4181313,4222236,40923,40923,7322,33601,24,0
4223585,1844,1,4180580,4180580,4223585,43005,43005,8671,34334,35,0
4226525,1944,1,4181081,4181081,4226525,45444,45444,11611,33833,25,0
4227823,1263,1,4173459,4173459,4227823,54364,54364,8512,45852,49,0
4231010,1093,1,4172135,4172135,4231010,58875,58875,11709,47166,58,0
4231579,1742,1,4177811,4177811,4231579,53768,53768,7789,45979,47,0
4231684,1669,1,4177491,4177491,4231684,54193,54193,7894,46299,43,0
4233634,1756,1,4177896,4177896,4233634,55738,55738,9844,45894,51,0
4234049,1804,1,4178232,4178232,4234049,55817,55817,7635,48182,51,0
4234405,1469,1,4176558,4176558,4234405,57847,57847,9747,48100,47,0
4234738,1661,1,4177455,4177455,4234738,57283,57283,10177,47106,53,0
4237802,1623,1,4177278,4177278,4237802,60524,60524,12729,47795,49,0
4239554,1521,1,4176823,4176823,4239554,62731,62731,11499,51232,42,0
4240238,1544,1,4176936,4176936,4240238,63302,63302,12183,51119,47,0
4240436,1843,1,4180570,4180570,4240436,59866,59866,11809,48057,35,0
4240630,1289,1,4173605,4173605,4240630,67025,67025,11892,55133,62,0
4240709,1926,1,4181006,4181006,4240709,59703,59703,11888,47815,33,0
4241904,1285,1,4173589,4173589,4241904,68315,68315,13087,55228,63,0
4241977,1849,1,4180602,4180602,4241977,61375,61375,11961,49414,35,0
4242068,1677,1,4177524,4177524,4242068,64544,64544,12020,52524,41,0
4242172,1948,1,4181101,4181101,4242172,61071,61071,12065,49006,30,0
4242353,1978,1,4181311,4181311,4242353,61042,61042,12242,48800,29,0
4242453,1835,1,4180536,4180536,4242453,61917,61917,12256,49661,41,0
4242781,1391,1,4174070,4174070,4242781,68711,68711,12547,56164,41,0
4243017,1874,1,4180709,4180709,4243017,62308,62308,12492,49816,32,0
4243274,1688,1,4177579,4177579,4243274,65695,65695,12458,53237,50,0
4243328,1685,1,4177564,4177564,4243328,65764,65764,12512,53252,50,0
4243997,1870,1,4180695,4180695,4243997,63302,63302,13161,50141,38,0
4244058,1356,1,4173909,4173909,4244058,70149,70149,12094,58055,60,0
4244402,1183,1,4173119,4173119,4244402,71283,71283,12885,58398,68,0
4245184,1497,1,4176705,4176705,4245184,68479,68479,13354,55125,57,0
4245271,1655,1,4177431,4177431,4245271,67840,67840,12660,55180,55,0
4245294,1195,1,4173175,4173175,4245294,72119,72119,12906,59213,61,0
4245326,1441,1,4174316,4174316,4245326,71010,71010,12923,58087,53,0
4245595,1535,1,4176887,4176887,4245595,68708,68708,12983,55725,49,0
4245691,1405,1,4174129,4174129,4245691,71562,71562,13019,58543,55,0
4245895,1679,1,4177532,4177532,4245895,68363,68363,13147,55216,60,0
4245988,1244,1,4173374,4173374,4245988,72614,72614,13180,59434,58,0
4246190,1699,1,4177623,4177623,4246190,68567,68567,13299,55268,50,0
4246600,1716,1,4177704,4177704,4246600,68896,68896,13507,55389,42,0
4246648,1921,1,4180977,4180977,4246648,65671,65671,13201,52470,33,0
4246703,1593,1,4177159,4177159,4246703,69544,69544,13220,56324,60,0
4246963,1873,1,4180708,4180708,4246963,66255,66255,13469,52786,34,0
4247225,1524,1,4176836,4176836,4247225,70389,70389,13504,56885,55,0
4247519,1272,1,4173518,4173518,4247519,74001,74001,13584,60417,61,0
4247565,1967,1,4181209,4181209,4247565,66356,66356,13388,52968,29,0
4247650,1346,1,4173858,4173858,4247650,73792,73792,13481,60311,59,0
4248608,1348,1,4173869,4173869,4248608,74739,74739,14439,60300,65,0
4248654,1698,1,4177618,4177618,4248654,71036,71036,13476,57560,54,0
4248655,1337,1,4173820,4173820,4248655,74835,74835,13496,61339,57,0
4249040,1187,1,4173140,4173140,4249040,75900,75900,13878,62022,69,0
4249201,1732,1,4177768,4177768,4249201,71433,71433,13668,57765,47,0
4249222,1119,1,4172653,4172653,4249222,76569,76569,13565,63004,69,0
4249232,1495,1,4176696,4176696,4249232,72536,72536,13562,58974,57,0
4249236,1138,1,4172914,4172914,4249236,76322,76322,13578,62744,65,0
4249595,1256,1,4173427,4173427,4249595,76168,76168,13943,62225,58,0
4249789,1236,1,4173344,4173344,4249789,76445,76445,13786,62659,56,0
4249792,1779,1,4177993,4177993,4249792,71799,71799,13671,58128,50,0
4249919,1759,1,4177911,4177911,4249919,72008,72008,13798,58210,51,0
4249945,1225,1,4173291,4173291,4249945,76654,76654,13818,62836,66,0
4250068,1562,1,4177009,4177009,4250068,73059,73059,13925,59134,56,0
4250108,1414,1,4174169,4174169,4250108,75939,75939,13971,61968,57,0
4250124,1594,1,4177159,4177159,4250124,72965,72965,13938,59027,60,0
4250184,1329,1,4173781,4173781,4250184,76403,76403,14004,62399,58,0
4250613,1565,1,4177021,4177021,4250613,73592,73592,14370,59222,57,0
4250841,1587,1,4177135,4177135,4250841,73706,73706,14595,59111,60,0
4250883,1832,1,4180521,4180521,4250883,70362,70362,13914,56448,43,0
4251021,1541,1,4176916,4176916,4251021,74105,74105,14070,60035,54,0
4251044,1976,1,4181268,4181268,4251044,69776,69776,13972,55804,37,0
4251192,1307,1,4173684,4173684,4251192,77508,77508,14156,63352,64,0
4251252,1368,1,4173967,4173967,4251252,77285,77285,14127,63158,66,0
4251271,1731,1,4177762,4177762,4251271,73509,73509,14061,59448,52,0
4251634,1321,1,4173745,4173745,4251634,77889,77889,14446,63443,62,0
4251644,1546,1,4176938,4176938,4251644,74706,74706,14099,60607,58,0
4251699,1185,1,4173129,4173129,4251699,78570,78570,14185,64385,74,0
4251766,1126,1,4172692,4172692,4251766,79074,79074,14202,64872,65,0
4251882,1960,1,4181165,4181165,4251882,70717,70717,14358,56359,34,0
4252098,1295,1,4173631,4173631,4252098,78467,78467,14544,63923,69,0
4252503,1701,1,4177630,4177630,4252503,74873,74873,14560,60313,56,0
4254052,1900,1,4180882,4180882,4254052,73170,73170,15963,57207,42,0
4254190,1128,1,4172714,4172714,4254190,81476,81476,14582,66894,72,0
4254510,1220,1,4173267,4173267,4254510,81243,81243,14907,66336,69,0
4254514,1658,1,4177446,4177446,4254514,77068,77068,14549,62519,69,0
4254529,1617,1,4177251,4177251,4254529,77278,77278,14578,62700,53,0
4254785,1690,1,4177581,4177581,4254785,77204,77204,14849,62355,56,0
4254789,1482,1,4176634,4176634,4254789,78155,78155,14618,63537,68,0
4254967,1499,1,4176721,4176721,4254967,78246,78246,14799,63447,61,0
4255631,1502,1,4176735,4176735,4255631,78896,78896,15463,63433,59,0
4256407,1261,1,4173445,4173445,4256407,82962,82962,15581,67381,64,0
4256471,1726,1,4177745,4177745,4256471,78726,78726,14899,63827,48,0
4256979,1314,1,4173718,4173718,4256979,83261,83261,15412,67849,66,0
4257564,1407,1,4174141,4174141,4257564,83423,83423,16043,67380,68,0
4258037,1766,1,4177933,4177933,4258037,80104,80104,15905,64199,57,0
4258222,1718,1,4177715,4177715,4258222,80507,80507,15592,64915,55,0
4258280,1922,1,4180980,4180980,4258280,77300,77300,16026,61274,40,0
4259322,1472,1,4176576,4176576,4259322,82746,82746,17160,65586,65,0
4259573,1259,1,4173442,4173442,4259573,86131,86131,16874,69257,66,0
4259743,1363,1,4173933,4173933,4259743,85810,85810,16803,69007,67,0
4259808,1101,1,4172216,4172216,4259808,87592,87592,16466,71126,54,0
4260204,1366,1,4173949,4173949,4260204,86255,86255,16503,69752,74,0
4263765,1852,1,4180614,4180614,4263765,83151,83151,20063,63088,51,0
4263979,1449,1,4174348,4174348,4263979,89631,89631,17031,72600,53,0
4264679,1323,1,4173756,4173756,4264679,90923,90923,16585,74338,66,0
4265075,1951,1,4181113,4181113,4265075,83962,83962,16309,67653,40,0
4268185,1116,1,4172634,4172634,4268185,95551,95551,20078,75473,76,0
4268637,1401,1,4174112,4174112,4268637,94525,94525,17423,77102,75,0
4270186,1636,1,4177342,4177342,4270186,92844,92844,17263,75581,61,0
4270271,1741,1,4177811,4177811,4270271,92460,92460,15922,76538,56,0
4272929,1513,1,4176781,4176781,4272929,96148,96148,20080,76068,71,0
4273160,1977,1,4181287,4181287,4273160,91873,91873,17578,74295,37,0
4273495,1463,1,4176514,4176514,4273495,96981,96981,17883,79098,53,0
4275300,1454,1,4174373,4174373,4275300,100927,100927,19512,81415,69,0
4275457,1111,1,4172588,4172588,4275457,102869,102869,18085,84784,72,0
4275457,1114,1,4172608,4172608,4275457,102849,102849,18085,84764,71,0
4275534,1385,1,4174042,4174042,4275534,101492,101492,19587,81905,64,0
4276178,1947,1,4181098,4181098,4276178,95080,95080,20220,74860,45,0
4276432,1943,1,4181074,4181074,4276432,95358,95358,19973,75385,48,0
4276587,1444,1,4174329,4174329,4276587,102258,102258,19745,82513,62,0
4276866,1993,1,4184052,4184052,4276866,92814,92814,20047,72767,36,0
4276906,1534,1,4176887,4176887,4276906,100019,100019,20088,79931,65,0
4277015,1121,1,4172654,4172654,4277015,104361,104361,20187,84174,72,0
4277734,1382,1,4174028,4174028,4277734,103706,103706,20286,83420,50,0
4278324,1898,1,4180872,4180872,4278324,97452,97452,20673,76779,41,0
4278579,1476,1,4176597,4176597,4278579,101982,101982,20788,81194,65,0
4279132,1280,1,4173566,4173566,4279132,105566,105566,21331,84235,77,0
4279589,1871,1,4180695,4180695,4279589,98894,98894,21792,77102,53,0
4279705,1188,1,4173141,4173141,4279705,106564,106564,21257,85307,78,0
4279927,1875,1,4180712,4180712,4279927,99215,99215,22130,77085,49,0
4280023,1770,1,4177955,4177955,4280023,102068,102068,20895,81173,62,0
4280107,1810,1,4180410,4180410,4280107,99697,99697,20886,78811,43,0
4281141,1737,1,4177787,4177787,4281141,103354,103354,21265,82089,61,0
4281520,1933,1,4181033,4181033,4281520,100487,100487,21644,78843,48,0
4281618,1112,1,4172601,4172601,4281618,109017,109017,20839,88178,75,0
4282165,1997,1,4184070,4184070,4282165,98095,98095,21261,76834,34,0
4283280,1692,1,4177592,4177592,4283280,105688,105688,22097,83591,63,0
4283548,1150,1,4172962,4172962,4283548,110586,110586,20467,90119,80,0
4284009,1161,1,4173015,4173015,4284009,110994,110994,20928,90066,77,0
4285286,1250,1,4173401,4173401,4285286,111885,111885,22204,89681,66,0
4287268,1330,1,4173784,4173784,4287268,113484,113484,23920,89564,68,0
4287547,1466,1,4176527,4176527,4287547,111020,111020,21163,89857,70,0
4288155,1199,1,4173189,4173189,4288155,114966,114966,22813,92153,76,0
4288254,1800,1,4178159,4178159,4288254,110095,110095,21872,88223,54,0
4288599,1725,1,4177739,4177739,4288599,110860,110860,22640,88220,60,0
4289682,1530,1,4176868,4176868,4289682,112814,112814,23317,89497,70,0
4289810,1239,1,4173357,4173357,4289810,116453,116453,22821,93632,75,0
4289990,1786,1,4178039,4178039,4289990,111951,111951,22858,89093,59,0
4290081,1240,1,4173359,4173359,4290081,116722,116722,22912,93810,75,0
4291200,1166,1,4173044,4173044,4291200,118156,118156,24027,94129,78,0
4291341,1966,1,4181206,4181206,4291341,110135,110135,22904,87231,50,0
4291432,1264,1,4173469,4173469,4291432,117963,117963,23135,94828,69,0
4291571,1223,1,4173279,4173279,4291571,118292,118292,23279,95013,72,0
4291591,1729,1,4177757,4177757,4291591,113834,113834,23159,90675,62,0
4292023,1902,1,4180895,4180895,4292023,111128,111128,23594,87534,49,0
4292317,1566,1,4177026,4177026,4292317,115291,115291,24120,91171,68,0
4292635,1205,1,4173209,4173209,4292635,119426,119426,24136,95290,88,0
4292773,1132,1,4172885,4172885,4292773,119888,119888,23747,96141,89,0
4292934,1231,1,4173315,4173315,4292934,119619,119619,23884,95735,73,0
4293001,1707,1,4177654,4177654,4293001,115347,115347,23839,91508,69,0
4293046,1953,1,4181123,4181123,4293046,111923,111923,23853,88070,45,0
4293263,1896,1,4180858,4180858,4293263,112405,112405,23518,88887,45,0
4293397,1211,1,4173235,4173235,4293397,120162,120162,24355,95807,79,0
4293543,1537,1,4176899,4176899,4293543,116644,116644,23814,92830,69,0
4293813,1403,1,4174124,4174124,4293813,119689,119689,24077,95612,79,0
4293857,1380,1,4174018,4174018,4293857,119839,119839,24187,95652,55,0
4294149,1148,1,4172953,4172953,4294149,121196,121196,24436,96760,83,0
4294182,1627,1,4177301,4177301,4294182,116881,116881,24163,92718,77,0
4294363,1589,1,4177140,4177140,4294363,117223,117223,24364,92859,66,0
4295767,1703,1,4177637,4177637,4295767,118130,118130,25699,92431,65,0
4296177,1296,1,4173641,4173641,4296177,122536,122536,24841,97695,78,0
4296206,1212,1,4173237,4173237,4296206,122969,122969,24384,98585,79,0
4296912,1639,1,4177354,4177354,4296912,119558,119558,25079,94479,68,0
4297447,1957,1,4181156,4181156,4297447,116291,116291,24991,91300,49,0
4297513,1208,1,4173222,4173222,4297513,124291,124291,24791,99500,84,0
4297565,1842,1,4180570,4180570,4297565,116995,116995,24593,92402,58,0
4298116,1834,1,4180533,4180533,4298116,117583,117583,25144,92439,61,0
4298129,1675,1,4177517,4177517,4298129,120612,120612,25704,94908,61,0
4298365,1787,1,4178045,4178045,4298365,120320,120320,25336,94984,65,0
4298468,1610,1,4177228,4177228,4298468,121240,121240,26599,94641,76,0
4298606,1691,1,4177590,4177590,4298606,121016,121016,26187,94829,65,0
4299147,1611,1,4177231,4177231,4299147,121916,121916,27278,94638,74,0
4299488,1561,1,4177004,4177004,4299488,122484,122484,26164,96320,79,0
4300214,1277,1,4173546,4173546,4300214,126668,126668,26897,99771,73,0
4300956,1986,1,4181428,4181428,4300956,119528,119528,28531,90997,43,0
4301059,1771,1,4177957,4177957,4301059,123102,123102,28637,94465,64,0
4301397,1409,1,4174152,4174152,4301397,127245,127245,28085,99160,70,0
4302035,1355,1,4173900,4173900,4302035,128135,128135,29176,98959,77,0
4302681,1273,1,4173521,4173521,4302681,129160,129160,29364,99796,76,0
4302712,1092,1,4172132,4172132,4302712,130580,130580,25050,105530,69,0
4303307,1950,1,4181111,4181111,4303307,122196,122196,27103,95093,51,0
4303909,1095,1,4172160,4172160,4303909,131749,131749,26247,105502,62,0
4303921,1453,1,4174370,4174370,4303921,129551,129551,26239,103312,76,0
4304277,1206,1,4173214,4173214,4304277,131063,131063,27249,103814,90,0
4304633,1090,1,4171848,4171848,4304633,132785,132785,26971,105814,49,0
4304666,1435,1,4174284,4174284,4304666,130382,130382,26972,103410,74,0
4304739,1757,1,4177898,4177898,4304739,126841,126841,27053,99788,68,0
4304948,1428,1,4174254,4174254,4304948,130694,130694,27278,103416,77,0
4305257,1914,1,4180946,4180946,4305257,124311,124311,29047,95264,50,0
4306746,1109,1,4172573,4172573,4306746,134173,134173,29713,104460,86,0
4307179,1709,1,4177664,4177664,4307179,129515,129515,25785,103730,77,0
4307373,1313,1,4173708,4173708,4307373,133665,133665,25661,108004,75,0
4307905,1189,1,4173145,4173145,4307905,134760,134760,26130,108630,85,0
4307948,1342,1,4173844,4173844,4307948,134104,134104,26187,107917,73,0
4308324,1868,1,4180682,4180682,4308324,127642,127642,26825,100817,58,0
4308475,1600,1,4177182,4177182,4308475,131293,131293,27067,104226,76,0
4308636,1173,1,4173076,4173076,4308636,135560,135560,26857,108703,76,0
4308924,1249,1,4173398,4173398,4308924,135526,135526,27212,108314,73,0
4310172,1520,1,4176821,4176821,4310172,133351,133351,30177,103174,72,0
4311089,1586,1,4177127,4177127,4311089,133962,133962,29691,104271,76,0
4311389,1369,1,4173969,4173969,4311389,137420,137420,25776,111644,76,0
4311711,1197,1,4173181,4173181,4311711,138530,138530,29628,108902,81,0
4311773,1790,1,4178052,4178052,4311773,133721,133721,26120,107601,76,0
4312370,1582,1,4177111,4177111,4312370,135259,135259,26716,108543,67,0
4312427,1797,1,4178088,4178088,4312427,134339,134339,29416,104923,61,0
4312431,1747,1,4177843,4177843,4312431,134588,134588,26790,107798,69,0
4312931,1929,1,4181019,4181019,4312931,131912,131912,27230,104682,47,0
4313369,1735,1,4177780,4177780,4313369,135589,135589,27728,107861,65,0
4315242,1906,1,4180910,4180910,4315242,134332,134332,31362,102970,52,0
4315428,1998,1,4184074,4184074,4315428,131354,131354,29703,101651,33,0
4315538,1673,1,4177507,4177507,4315538,138031,138031,29728,108303,75,0
4316472,1663,1,4177464,4177464,4316472,139008,139008,30662,108346,82,0
4316628,1760,1,4177914,4177914,4316628,138714,138714,29923,108791,76,0
4316798,1196,1,4173176,4173176,4316798,143622,143622,30140,113482,83,0
4317102,1889,1,4180818,4180818,4317102,136284,136284,30352,105932,50,0
4317125,1167,1,4173052,4173052,4317125,144073,144073,30202,113871,88,0
4317434,1362,1,4173932,4173932,4317434,143502,143502,30416,113086,81,0
4317975,1615,1,4177244,4177244,4317975,140731,140731,30676,110055,73,0
4318161,1416,1,4174184,4174184,4318161,143977,143977,30816,113161,81,0
4318287,1674,1,4177510,4177510,4318287,140777,140777,30788,109989,77,0
4319069,1411,1,4174155,4174155,4319069,144914,144914,31475,113439,80,0
4319080,1494,1,4176688,4176688,4319080,142392,142392,30689,111703,77,0
4319099,1550,1,4176963,4176963,4319099,142136,142136,30752,111384,77,0
4319211,1942,1,4181072,4181072,4319211,138139,138139,30858,107281,56,0
4319365,1175,1,4173089,4173089,4319365,146276,146276,30919,115357,88,0
4319477,1146,1,4172949,4172949,4319477,146528,146528,31060,115468,87,0
4319725,1297,1,4173642,4173642,4319725,146083,146083,31304,114779,85,0
4319871,1542,1,4176925,4176925,4319871,142946,142946,31088,111858,75,0
4319884,1531,1,4176874,4176874,4319884,143010,143010,31150,111860,75,0
4319951,1333,1,4173797,4173797,4319951,146154,146154,31189,114965,80,0
4320211,1845,1,4180585,4180585,4320211,139626,139626,31387,108239,62,0
4320364,1320,1,4173743,4173743,4320364,146621,146621,31613,115008,83,0
4320517,1548,1,4176952,4176952,4320517,143565,143565,31356,112209,73,0
4321055,1749,1,4177856,4177856,4321055,143199,143199,31749,111450,76,0
4321182,1210,1,4173232,4173232,4321182,147950,147950,32435,115515,99,0
4321595,1190,1,4173152,4173152,4321595,148443,148443,32298,116145,89,0
4322172,1423,1,4174218,4174218,4322172,147954,147954,32387,115567,83,0
4322944,1395,1,4174087,4174087,4322944,148857,148857,33159,115698,87,0
4323540,1662,1,4177461,4177461,4323540,146079,146079,32499,113580,87,0
4324580,1940,1,4181061,4181061,4324580,143519,143519,32435,111084,57,0
4324817,1985,1,4181417,4181417,4324817,143400,143400,31637,111763,47,0
4326298,1879,1,4180748,4180748,4326298,145550,145550,34157,111393,63,0
4327380,1965,1,4181205,4181205,4327380,146175,146175,35217,110958,58,0
4328314,1920,1,4180975,4180975,4328314,147339,147339,36134,111205,49,0
4328869,1777,1,4177989,4177989,4328869,150880,150880,36677,114203,72,0
4329160,1446,1,4174337,4174337,4329160,154823,154823,34169,120654,74,0
4329598,1866,1,4180678,4180678,4329598,148920,148920,33221,115699,68,0
4329611,1200,1,4173195,4173195,4329611,156416,156416,34144,122272,86,0
4329788,1457,1,4176486,4176486,4329788,153302,153302,34798,118504,74,0
4329920,1218,1,4173262,4173262,4329920,156658,156658,34452,122206,96,0
4330883,1100,1,4172214,4172214,4330883,158669,158669,34875,123794,66,0
4331191,1094,1,4172138,4172138,4331191,159053,159053,35183,123870,65,0
4331398,1603,1,4177195,4177195,4331398,154203,154203,35105,119098,83,0
4331509,1406,1,4174139,4174139,4331509,157370,157370,35055,122315,83,0
4331522,1120,1,4172654,4172654,4331522,158868,158868,35515,123353,79,0
4331803,1383,1,4174032,4174032,4331803,157771,157771,35325,122446,61,0
4331961,1579,1,4177095,4177095,4331961,154866,154866,33231,121635,90,0
4332060,1265,1,4173471,4173471,4332060,158589,158589,31512,127077,80,0
4332178,1217,1,4173255,4173255,4332178,158923,158923,36712,122211,92,0
4332245,1118,1,4172653,4172653,4332245,159592,159592,36238,123354,79,0
4332319,1899,1,4180873,4180873,4332319,151446,151446,33346,118100,59,0
4334050,1618,1,4177256,4177256,4334050,156794,156794,37761,119033,76,0
4334831,1110,1,4172583,4172583,4334831,162248,162248,35219,127029,91,0
4334910,1269,1,4173497,4173497,4334910,161413,161413,34362,127051,86,0
4335528,1404,1,4174126,4174126,4335528,161402,161402,34656,126746,84,0
4335802,1107,1,4172556,4172556,4335802,163246,163246,36190,127056,82,0
4336966,1140,1,4172922,4172922,4336966,164044,164044,37098,126946,89,0
4337036,1326,1,4173769,4173769,4337036,163267,163267,32576,130691,82,0
4338043,1328,1,4173781,4173781,4338043,164262,164262,33583,130679,81,0
4338710,1614,1,4177239,4177239,4338710,161471,161471,36134,125337,79,0
4341270,1905,1,4180906,4180906,4341270,160364,160364,40056,120308,63,0
4342278,1234,1,4173329,4173329,4342278,168949,168949,41132,127817,88,0
4342436,1612,1,4177232,4177232,4342436,165204,165204,39860,125344,80,0
4343216,1533,1,4176883,4176883,4343216,166333,166333,42009,124324,84,0
4343417,1347,1,4173864,4173864,4343417,169553,169553,42213,127340,86,0
4343452,1945,1,4181084,4181084,4343452,162368,162368,41490,120878,61,0
4344259,1857,1,4180638,4180638,4344259,163621,163621,43029,120592,65,0
4344262,1275,1,4173535,4173535,4344262,170727,170727,38626,132101,77,0
4344487,1609,1,4177224,4177224,4344487,167263,167263,43283,123980,86,0
4345764,1592,1,4177152,4177152,4345764,168612,168612,44536,124076,85,0
4346596,1350,1,4173871,4173871,4346596,172725,172725,44634,128091,88,0
4346815,1122,1,4172663,4172663,4346815,174152,174152,39345,134807,84,0
4347505,1959,1,4181162,4181162,4347505,166343,166343,44930,121413,63,0
4348410,1500,1,4176727,4176727,4348410,171683,171683,41750,129933,75,0
4348533,1624,1,4177283,4177283,4348533,171250,171250,40531,130719,72,0
4350320,1782,1,4178008,4178008,4350320,172312,172312,40497,131815,73,0
4350450,1910,1,4180923,4180923,4350450,169527,169527,40616,128911,51,0
4351379,1861,1,4180652,4180652,4351379,170727,170727,41524,129203,69,0
4351738,1425,1,4174228,4174228,4351738,177510,177510,44252,133258,88,0
4351773,1853,1,4180620,4180620,4351773,171153,171153,41941,129212,68,0
4352083,1773,1,4177968,4177968,4352083,174115,174115,42213,131902,70,0
4352633,1628,1,4177306,4177306,4352633,175327,175327,42808,132519,87,0
4354680,1372,1,4173982,4173982,4354680,180698,180698,41330,139368,90,0
4356495,1335,1,4173806,4173806,4356495,182689,182689,44096,138593,85,0
4356522,1538,1,4176899,4176899,4356522,179623,179623,42515,137108,83,0
4356574,1505,1,4176747,4176747,4356574,179827,179827,42567,137260,82,0
4357038,1452,1,4174358,4174358,4357038,182680,182680,43012,139668,81,0
4357421,1349,1,4173869,4173869,4357421,183552,183552,40752,142800,87,0
4357894,1131,1,4172885,4172885,4357894,185009,185009,44669,140340,101,0
4358805,1646,1,4177386,4177386,4358805,181419,181419,41403,140016,87,0
4359842,1496,1,4176703,4176703,4359842,183139,183139,45781,137358,83,0
4360414,1258,1,4173441,4173441,4360414,186973,186973,45121,141852,85,0
4361121,1705,1,4177646,4177646,4361121,183475,183475,41889,141586,76,0
4361136,1105,1,4172553,4172553,4361136,188583,188583,45472,143111,82,0
4361776,1684,1,4177557,4177557,4361776,184219,184219,42536,141683,73,0
4362243,1816,1,4180446,4180446,4362243,181797,181797,42094,139703,66,0
4362329,1426,1,4174239,4174239,4362329,188090,188090,45062,143028,90,0
4362354,1353,1,4173894,4173894,4362354,188460,188460,46783,141677,82,0
4363409,1336,1,4173812,4173812,4363409,189597,189597,46188,143409,85,0
4363476,1601,1,4177183,4177183,4363476,186293,186293,46806,139487,91,0
4364407,1928,1,4181010,4181010,4364407,183397,183397,46754,136643,56,0
4364521,1247,1,4173388,4173388,4364521,191133,191133,47819,143314,92,0
4365533,1799,1,4178141,4178141,4365533,187392,187392,45771,141621,69,0
4365648,1137,1,4172914,4172914,4365648,192734,192734,45694,147040,87,0
4366115,1292,1,4173616,4173616,4366115,192499,192499,50542,141957,92,0
4366265,1751,1,4177867,4177867,4366265,188398,188398,45589,142809,75,0
4366589,1840,1,4180555,4180555,4366589,186034,186034,45937,140097,65,0
4367233,1621,1,4177270,4177270,4367233,189963,189963,46598,143365,81,0
4367248,1811,1,4180412,4180412,4367248,186836,186836,46629,140207,61,0
4367612,1602,1,4177191,4177191,4367612,190421,190421,46936,143485,88,0
4367930,1461,1,4176503,4176503,4367930,191427,191427,46158,145269,81,0
4368658,1227,1,4173299,4173299,4368658,195359,195359,46989,148370,87,0
4368686,1994,1,4184054,4184054,4368686,184632,184632,46616,138016,40,0
4371552,1650,1,4177405,4177405,4371552,194147,194147,50924,143223,77,0
4371633,1458,1,4176486,4176486,4371633,195147,195147,46308,148839,82,0
4373161,1341,1,4173838,4173838,4373161,199323,199323,47867,151456,83,0
4373655,1492,1,4176676,4176676,4373655,196979,196979,48380,148599,86,0
4374365,1486,1,4176647,4176647,4374365,197718,197718,49093,148625,87,0
4374501,1365,1,4173945,4173945,4374501,200556,200556,49195,151361,87,0
4375791,1680,1,4177541,4177541,4375791,198250,198250,48923,149327,75,0
4377212,1388,1,4174055,4174055,4377212,203157,203157,47588,155569,81,0
4378190,1720,1,4177717,4177717,4378190,200473,200473,48700,151773,75,0
4380948,1399,1,4174101,4174101,4380948,206847,206847,48957,157890,91,0
4381454,1815,1,4180439,4180439,4381454,201015,201015,60831,140184,67,0
4382235,1877,1,4180734,4180734,4382235,201501,201501,47449,154052,64,0
4382708,1421,1,4174210,4174210,4382708,208498,208498,47928,160570,89,0
4383570,1415,1,4174182,4174182,4383570,209388,209388,48790,160598,80,0
4386994,1262,1,4173456,4173456,4386994,213538,213538,50350,163188,84,0
4387581,1515,1,4176793,4176793,4387581,210788,210788,50146,160642,89,0
4387770,1434,1,4174284,4174284,4387770,213486,213486,50316,163170,82,0
4396840,1881,1,4180765,4180765,4396840,216075,216075,62054,154021,58,0
4398115,1855,1,4180626,4180626,4398115,217489,217489,52180,165309,66,0
4398599,1736,1,4177783,4177783,4398599,220816,220816,51063,169753,75,0
4400094,1644,1,4177379,4177379,4400094,222715,222715,52557,170158,95,0
4400419,1807,1,4180399,4180399,4400419,220020,220020,61851,158169,57,0
4401064,1801,1,4178177,4178177,4401064,222887,222887,62496,160391,83,0
4401884,1999,1,4184082,4184082,4401884,217802,217802,62738,155064,48,0
4402007,1106,1,4172555,4172555,4402007,229452,229452,62105,167347,86,0
4404035,1172,1,4173076,4173076,4404035,230959,230959,64024,166935,86,0
4405030,1483,1,4176635,4176635,4405030,228395,228395,63051,165344,83,0
4407809,1456,1,4176480,4176480,4407809,231329,231329,61511,169818,75,0
4408645,1814,1,4180428,4180428,4408645,228217,228217,65675,162542,68,0
4409061,1459,1,4176491,4176491,4409061,232570,232570,62756,169814,84,0
4409548,1108,1,4172568,4172568,4409548,236980,236980,64580,172400,97,0
4414027,1103,1,4172522,4172522,4414027,241505,241505,67032,174473,83,0
4414251,1908,1,4180918,4180918,4414251,233333,233333,63381,169952,51,0
4414656,1809,1,4180405,4180405,4414656,234251,234251,63125,171126,59,0
4415067,1629,1,4177308,4177308,4415067,237759,237759,63274,174485,90,0
4419135,1833,1,4180529,4180529,4419135,238606,238606,67343,171263,70,0
4421733,1934,1,4181034,4181034,4421733,240699,240699,66105,174594,56,0
4424931,1241,1,4173363,4173363,4424931,251568,251568,75537,176031,87,0
4429100,1291,1,4173613,4173613,4429100,255487,255487,73598,181889,94,0
4430786,1310,1,4173697,4173697,4430786,257089,257089,73174,183915,85,0
4431138,1954,1,4181126,4181126,4431138,250012,250012,72902,177110,70,0
4431926,1510,1,4176768,4176768,4431926,255158,255158,73023,182135,90,0
4434313,1955,1,4181136,4181136,4434313,253177,253177,74840,178337,65,0
4435953,1652,1,4177419,4177419,4435953,258534,258534,72932,185602,93,0
4436349,1480,1,4176619,4176619,4436349,259730,259730,73326,186404,94,0
4438135,942,1,3997088,3997088,4438135,441047,441047,76112,364935,12,0
4445747,1267,1,4173483,4173483,4445747,272264,272264,79837,192427,94,0
4466321,944,1,3997209,3997209,4466321,469112,469112,94848,374264,7,0
4467143,1590,1,4177148,4177148,4467143,289995,289995,76082,213913,88,0
4467162,1904,1,4180897,4180897,4467162,286265,286265,76930,209335,74,0
4468215,1245,1,4173381,4173381,4468215,294834,294834,78050,216784,95,0
4468228,1192,1,4173158,4173158,4468228,295070,295070,77172,217898,96,0
4468497,970,1,4062374,4062374,4468497,406123,406123,78303,327820,4,0
4470165,677,1,3935091,3935091,4470165,535074,535074,80019,455055,10,0
4470221,1564,1,4177017,4177017,4470221,293204,293204,79232,213972,85,0
4472443,1912,1,4180935,4180935,4472443,291508,291508,81451,210057,56,0
4473734,940,1,3987637,3987637,4473734,486097,486097,85813,400284,5,0
4474816,974,1,4062435,4062435,4474816,412381,412381,77963,334418,8,0
4475557,1306,1,4173681,4173681,4475557,301876,301876,79050,222826,91,0
4486319,950,1,3998041,3998041,4486319,488278,488278,89497,398781,14,0
4488612,1893,1,4180844,4180844,4488612,307768,307768,78141,229627,58,0
4497263,1287,1,4173594,4173594,4497263,323669,323669,90044,233625,99,0
4499935,682,1,3957014,3957014,4499935,542921,542921,84428,458493,38,0
4501365,1734,1,4177775,4177775,4501365,323590,323590,85501,238089,80,0
4524104,1837,1,4180546,4180546,4524104,343558,343558,115659,227899,70,0
4526086,905,1,3962691,3962691,4526086,563395,563395,88706,474689,56,0
4526346,827,1,3961858,3961858,4526346,564488,564488,96245,468243,37,0
4527173,788,1,3961483,3961483,4527173,565690,565690,96635,469055,30,0
4538201,979,1,4062490,4062490,4538201,475711,475711,128642,347069,10,0
4543538,1516,1,4176794,4176794,4543538,366744,366744,106422,260322,91,0
4549212,1961,1,4181172,4181172,4549212,368040,368040,108046,259994,68,0
4549530,1050,1,4063445,4063445,4549530,486085,486085,102641,383444,6,0
4551871,511,1,3746694,3746694,4551871,805177,805177,104692,700485,39,0
4556609,746,1,3961066,3961066,4556609,595543,595543,94486,501057,56,0
4557116,1375,1,4173995,4173995,4557116,383121,383121,95284,287837,95,0
4562789,662,1,3913630,3913630,4562789,649159,649159,103380,545779,19,0
4567465,1193,1,4173164,4173164,4567465,394301,394301,105632,288669,98,0
4578900,1936,1,4181044,4181044,4578900,397856,397856,105983,291873,65,0
4584257,1031,1,4063212,4063212,4584257,521045,521045,104617,416428,6,0
4589051,199,1,3643016,3643016,4589051,946035,946035,108204,837831,2,0
4593901,240,1,3647317,3647317,4593901,946584,946584,106678,839906,3,0
4600590,1990,1,4181472,4181472,4600590,419118,419118,108549,310569,72,0
4603761,1059,1,4063637,4063637,4603761,540124,540124,117839,422285,9,0
4607552,1511,1,4176771,4176771,4607552,430781,430781,116564,314217,97,0
4608469,1057,1,4063622,4063622,4608469,544847,544847,122548,422299,8,0
4609320,637,1,3833225,3833225,4609320,776095,776095,123243,652852,3,0
4616186,342,1,3742276,3742276,4616186,873910,873910,111798,762112,35,0
4617105,375,1,3745557,3745557,4617105,871548,871548,109410,762138,42,0
4617167,1913,1,4180941,4180941,4617167,436226,436226,108354,327872,59,0
4618287,380,1,3745600,3745600,4618287,872687,872687,110517,762170,38,0
4618525,395,1,3745735,3745735,4618525,872790,872790,109749,763041,42,0
4619272,389,1,3745672,3745672,4619272,873600,873600,110392,763208,46,0
4623325,1924,1,4180992,4180992,4623325,442333,442333,114764,327569,63,0
4624400,1088,1,4170618,4170618,4624400,453782,453782,115758,338024,50,0
4624753,1697,1,4177608,4177608,4624753,447145,447145,114939,332206,86,0
4624871,1784,1,4178019,4178019,4624871,446852,446852,116246,330606,85,0
4637909,1930,1,4181020,4181020,4637909,456889,456889,129347,327542,66,0
4637981,1738,1,4177794,4177794,4637981,460187,460187,122650,337537,82,0
4641027,263,1,3652003,3652003,4641027,989024,989024,111878,877146,5,0
4641935,1748,1,4177855,4177855,4641935,464080,464080,126486,337594,86,0
4643100,433,1,3746033,3746033,4643100,897067,897067,114101,782966,49,0
4644894,366,1,3745475,3745475,4644894,899419,899419,115709,783710,42,0
4646674,1139,1,4172916,4172916,4646674,473758,473758,112920,360838,99,0
4649276,323,1,3725137,3725137,4649276,924139,924139,119593,804546,21,0
4649453,1036,1,4063261,4063261,4649453,586192,586192,119571,466621,9,0
4652312,1872,1,4180703,4180703,4652312,471609,471609,115466,356143,70,0
4652355,1892,1,4180839,4180839,4652355,471516,471516,123921,347595,67,0
4654354,304,1,3679613,3679613,4654354,974741,974741,124476,850265,9,0
4656043,1141,1,4172923,4172923,4656043,483120,483120,121130,361990,93,0
4658407,1041,1,4063345,4063345,4658407,595062,595062,125475,469587,9,0
4659773,1640,1,4177365,4177365,4659773,482408,482408,124899,357509,85,0
4661729,1130,1,4172878,4172878,4661729,488851,488851,127978,360873,110,0
4661988,1984,1,4181395,4181395,4661988,480593,480593,123383,357210,78,0
4665344,530,1,3746863,3746863,4665344,918481,918481,111505,806976,38,0
4695951,934,1,3980576,3980576,4695951,715375,715375,155639,559736,22,0
4697657,1184,1,4173127,4173127,4697657,524530,524530,106378,418152,105,0
4698118,1792,1,4178063,4178063,4698118,520055,520055,108156,411899,85,0
4699683,1935,1,4181043,4181043,4699683,518640,518640,109715,408925,64,0
4700604,1638,1,4177345,4177345,4700604,523259,523259,106115,417144,92,0
4700732,1895,1,4180856,4180856,4700732,519876,519876,106246,413630,67,0
4703420,421,1,3745934,3745934,4703420,957486,957486,109371,848115,38,0
4705005,203,1,3647016,3647016,4705005,1057989,1057989,112651,945338,2,0
4706702,1657,1,4177437,4177437,4706702,529265,529265,116739,412526,102,0
4708994,1647,1,4177392,4177392,4708994,531602,531602,119032,412570,85,0
4713908,1529,1,4176862,4176862,4713908,537046,537046,119570,417476,95,0
4717054,1370,1,4173970,4173970,4717054,543084,543084,126793,416291,88,0
4717674,1400,1,4174109,4174109,4717674,543565,543565,123105,420460,97,0
4718477,1007,1,4063032,4063032,4718477,655445,655445,128312,527133,6,0
4728429,305,1,3679652,3679652,4728429,1048777,1048777,134519,914258,9,0
4728490,1178,1,4173097,4173097,4728490,555393,555393,106748,448645,106,0
4734549,1447,1,4174342,4174342,4734549,560207,560207,140199,420008,88,0
4743898,1179,1,4173102,4173102,4743898,570796,570796,122308,448488,108,0
4744006,1379,1,4174009,4174009,4744006,569997,569997,115949,454048,81,0
4744008,1243,1,4173371,4173371,4744008,570637,570637,115904,454733,90,0
4746868,1229,1,4173305,4173305,4746868,573563,573563,118788,454775,92,0
4747933,1517,1,4176805,4176805,4747933,571128,571128,110461,460667,92,0
4748844,1487,1,4176660,4176660,4748844,572184,572184,111602,460582,90,0
4749078,1270,1,4173508,4173508,4749078,575570,575570,120998,454572,97,0
4750998,1242,1,4173370,4173370,4750998,577628,577628,122894,454734,91,0
4752408,956,8,3999595,3999595,4752408,752813,752813,22081,730732,8,0
4753537,1352,1,4173883,4173883,4753537,579654,579654,125485,454169,99,0
4754208,1046,1,4063414,4063414,4754208,690794,690794,156252,534542,11,0
4754815,1324,1,4173757,4173757,4754815,581058,581058,126707,454351,97,0
4758666,1251,1,4173406,4173406,4758666,585260,585260,130613,454647,94,0
4762699,1288,1,4173601,4173601,4762699,589098,589098,109671,479427,102,0
4763666,964,1,4030872,4030872,4763666,732794,732794,110579,622215,12,0
4764268,975,1,4062437,4062437,4764268,701831,701831,111178,590653,9,0
4765147,943,1,3997158,3997158,4765147,767989,767989,158757,609232,16,0
4765161,1983,1,4181374,4181374,4765161,583787,583787,127843,455944,68,0
4770171,1279,1,4173561,4173561,4770171,596610,596610,117134,479476,103,0
4771119,579,1,3756217,3756217,4771119,1014902,1014902,148302,866600,30,0
4771570,1527,1,4176850,4176850,4771570,594720,594720,159841,434879,97,0
4774292,1867,1,4180681,4180681,4774292,593611,593611,137217,456394,78,0
4777982,1376,1,4173996,4173996,4777982,603986,603986,124949,479037,97,0
4783261,1194,1,4173168,4173168,4783261,610093,610093,130227,479866,98,0
4793722,740,1,3960994,3960994,4793722,832728,832728,170834,661894,56,0
4797503,1448,1,4174342,4174342,4797503,623161,623161,157801,465360,91,0
4802941,262,1,3647974,3647974,4802941,1154967,1154967,161818,993149,4,0
4805085,1442,1,4174318,4174318,4805085,630767,630767,167935,462832,89,0
4809667,502,1,3746628,3746628,4809667,1063039,1063039,181758,881281,38,0
4826216,1897,1,4180868,4180868,4826216,645348,645348,180239,465109,72,0
4834244,726,1,3960873,3960873,4834244,873371,873371,171084,702287,51,0
4834812,175,1,3607083,3607083,4834812,1227729,1227729,181141,1046588,3,0
4841438,1630,1,4177314,4177314,4841438,664124,664124,195458,468666,102,0
4842307,983,1,4062551,4062551,4842307,779756,779756,131050,648706,8,0
4844999,1017,2,4063102,4063102,4844999,781897,781897,75131,706766,3,0
4845461,1191,1,4173153,4173153,4845461,672308,672308,140623,531685,104,0
4847814,1973,1,4181252,4181252,4847814,666562,666562,130862,535700,70,0
4860933,1864,1,4180665,4180665,4860933,680268,680268,155958,524310,80,0
4865807,1169,1,4173054,4173054,4865807,692753,692753,160960,531793,104,0
4868641,719,1,3960827,3960827,4868641,907814,907814,163751,744063,43,0
4872463,1989,1,4181460,4181460,4872463,691003,691003,167474,523529,72,0
4872797,1204,1,4173208,4173208,4872797,699589,699589,160762,538827,110,0
4875238,1974,1,4181255,4181255,4875238,693983,693983,162999,530984,71,0
4877703,1160,1,4173014,4173014,4877703,704689,704689,172852,531837,107,0
4880486,1607,1,4177214,4177214,4880486,703272,703272,168264,535008,88,0
4885917,663,1,3920952,3920952,4885917,964965,964965,149246,815719,18,0
4897447,779,1,3961399,3961399,4897447,936048,936048,160883,775165,54,0
4898034,659,1,3909553,3909553,4898034,988481,988481,161379,827102,22,0
4900813,1207,1,4173222,4173222,4900813,727591,727591,132036,595555,114,0
4904929,1507,1,4176755,4176755,4904929,728174,728174,136240,591934,98,0
4909315,1723,1,4177731,4177731,4909315,731584,731584,137364,594220,83,0
4912793,1887,1,4180805,4180805,4912793,731988,731988,141324,590664,68,0
4917263,1051,1,4063459,4063459,4917263,853804,853804,160673,693131,9,0
4919906,819,1,3961778,3961778,4919906,958128,958128,174021,784107,42,0
4920232,1035,1,4063246,4063246,4920232,856986,856986,163319,693667,12,0
4925005,1001,1,4062849,4062849,4925005,862156,862156,168072,694084,10,0
4925185,1000,1,4062849,4062849,4925185,862336,862336,168252,694084,10,0
4927912,990,1,4062648,4062648,4927912,865264,865264,170872,694392,9,0
4929073,1560,1,4177003,4177003,4929073,752070,752070,160104,591966,94,0
4929204,1885,1,4180792,4180792,4929204,748412,748412,157735,590677,67,0
4930874,854,1,3962090,3962090,4930874,968784,968784,174004,794780,46,0
4932593,610,1,3790016,3790016,4932593,1142577,1142577,146943,995634,11,0
4941625,1838,1,4180552,4180552,4941625,761073,761073,169481,591592,80,0
4942399,1553,1,4176972,4176972,4942399,765427,765427,173660,591767,94,0
4944544,1397,1,4174096,4174096,4944544,770448,770448,133013,637435,101,0
4948814,911,1,3962837,3962837,4948814,985977,985977,150781,835196,52,0
4948954,1796,1,4178080,4178080,4948954,770874,770874,176819,594055,75,0
4949705,732,1,3960919,3960919,4949705,988786,988786,163436,825350,61,0
4950556,722,1,3960841,3960841,4950556,989715,989715,164277,825438,62,0
4953055,850,1,3962053,3962053,4953055,991002,991002,155129,835873,44,0
4957756,1717,1,4177707,4177707,4957756,780049,780049,193867,586182,85,0
4957990,1235,1,4173336,4173336,4957990,784654,784654,174055,610599,97,0
4960608,1774,1,4177968,4177968,4960608,782640,782640,176366,606274,86,0
4960858,847,1,3962025,3962025,4960858,998833,998833,176708,822125,51,0
4963287,1170,1,4173064,4173064,4963287,790223,790223,163329,626894,98,0
4963519,855,1,3962099,3962099,4963519,1001420,1001420,179533,821887,45,0
4965209,1693,1,4177593,4177593,4965209,787616,787616,175700,611916,81,0
4965740,1556,1,4176985,4176985,4965740,788755,788755,178733,610022,97,0
4965903,1572,1,4177059,4177059,4965903,788844,788844,178924,609920,100,0
4966607,1576,1,4177075,4177075,4966607,789532,789532,179594,609938,97,0
4968236,1606,1,4177208,4177208,4968236,791028,791028,181315,609713,94,0
4971883,992,1,4062748,4062748,4971883,909135,909135,164723,744412,11,0
4973351,572,1,3754953,3754953,4973351,1218398,1218398,168659,1049739,40,0
4974852,1133,1,4172892,4172892,4974852,801960,801960,167803,634157,115,0
4974874,1915,1,4180951,4180951,4974874,793923,793923,163329,630594,72,0
4976360,1568,1,4177039,4177039,4976360,799321,799321,165632,633689,90,0
4979000,1408,1,4174142,4174142,4979000,804858,804858,167474,637384,100,0
4979825,701,1,3960640,3960640,4979825,1019185,1019185,164740,854445,63,0
4980695,903,1,3962642,3962642,4980695,1018053,1018053,160598,857455,59,0
4981354,1305,1,4173681,4173681,4981354,807673,807673,179714,627959,97,0
4985953,1125,1,4172679,4172679,4985953,813274,813274,164974,648300,98,0
4987816,1018,1,4063109,4063109,4987816,924707,924707,161906,762801,9,0
4987920,980,1,4062492,4062492,4987920,925428,925428,173185,752243,14,0
4989314,851,1,3962055,3962055,4989314,1027259,1027259,169289,857970,46,0
4990044,1823,1,4180483,4180483,4990044,809561,809561,160828,648733,68,0
4992399,800,1,3961571,3961571,4992399,1030828,1030828,177552,853276,45,0
4993365,1142,1,4172929,4172929,4993365,820436,820436,133747,686689,104,0
4995283,577,1,3756196,3756196,4995283,1239087,1239087,136517,1102570,29,0
5000582,596,1,3786472,3786472,5000582,1214110,1214110,141104,1073006,15,0
5002560,1410,1,4174152,4174152,5002560,828408,828408,174844,653564,96,0
5007102,1484,1,4176637,4176637,5007102,830465,830465,185870,644595,98,0
5007325,1252,1,4173412,4173412,5007325,833913,833913,148070,685843,89,0
5007386,1518,1,4176809,4176809,5007386,830577,830577,179582,650995,94,0
5007540,1789,1,4178047,4178047,5007540,829493,829493,178329,651164,86,0
5008070,1479,1,4176619,4176619,5008070,831451,831451,180383,651068,99,0
5010086,464,1,3746278,3746278,5010086,1263808,1263808,187719,1076089,39,0
5011812,1987,1,4181442,4181442,5011812,830370,830370,188933,641437,68,0
5012537,753,1,3961113,3961113,5012537,1051424,1051424,187954,863470,54,0
5017837,487,1,3746497,3746497,5017837,1271340,1271340,195288,1076052,34,0
5018572,1702,1,4177634,4177634,5018572,840938,840938,186257,654681,85,0
5019380,1525,1,4176839,4176839,5019380,842541,842541,187417,655124,92,0
5020944,1226,1,4173292,4173292,5020944,847652,847652,161486,686166,97,0
5025505,1605,1,4177205,4177205,5025505,848300,848300,193525,654775,100,0
5026082,1689,1,4177580,4177580,5026082,848502,848502,182893,665609,84,0
5026821,1858,1,4180642,4180642,5026821,846179,846179,157011,689168,81,0
5028100,1808,1,4180404,4180404,5028100,847696,847696,158272,689424,66,0
5030299,1230,1,4173311,4173311,5030299,856988,856988,190973,666015,99,0
5031242,483,1,3746460,3746460,5031242,1284782,1284782,187547,1097235,37,0
5034824,254,1,3647500,3647500,5034824,1387324,1387324,191816,1195508,8,0
5036716,550,1,3747026,3747026,5036716,1289690,1289690,191725,1097965,54,0
5037971,1127,1,4172708,4172708,5037971,865263,865263,186097,679166,96,0
5039330,1257,1,4173430,4173430,5039330,865900,865900,187479,678421,99,0
5041150,1681,1,4177542,4177542,5041150,863608,863608,187571,676037,89,0
5041503,1151,1,4172965,4172965,5041503,868538,868538,181886,686652,104,0
5043049,242,1,3647319,3647319,5043049,1395730,1395730,173036,1222694,8,0
5044599,729,1,3960899,3960899,5044599,1083700,1083700,170853,912847,52,0
5047674,204,1,3647020,3647020,5047674,1400654,1400654,177471,1223183,5,0
5051324,1778,1,4177989,4177989,5051324,873335,873335,186798,686537,85,0
5056152,1946,1,4181087,4181087,5056152,875065,875065,186334,688731,78,0
5056632,218,1,3647189,3647189,5056632,1409443,1409443,186655,1222788,7,0
5057033,959,1,4009826,4009826,5057033,1047207,1047207,170100,877107,11,0
5061237,378,1,3745591,3745591,5061237,1315646,1315646,191196,1124450,47,0
5062114,883,1,3962423,3962423,5062114,1099691,1099691,179975,919716,36,0
5063235,866,1,3962220,3962220,5063235,1101015,1101015,181094,919921,56,0
5064898,424,1,3745960,3745960,5064898,1318938,1318938,192514,1126424,39,0
5067226,1918,1,4180964,4180964,5067226,886262,886262,173134,713128,68,0
5070489,890,1,3962465,3962465,5070489,1108024,1108024,183616,924408,47,0
5071734,1941,1,4181071,4181071,5071734,890663,890663,177657,713006,66,0
5071909,1768,1,4177947,4177947,5071909,893962,893962,178990,714972,92,0
5075122,1923,1,4180987,4180987,5075122,894135,894135,181030,713105,75,0
5077950,1964,1,4181193,4181193,5077950,896757,896757,183860,712897,70,0
5078475,1436,1,4174285,4174285,5078475,904190,904190,186489,717701,93,0
5078693,1651,1,4177408,4177408,5078693,901285,901285,185834,715451,95,0
5079575,606,1,3787058,3787058,5079575,1292517,1292517,182928,1109589,16,0
5082972,1752,1,4177875,4177875,5082972,905097,905097,190046,715051,91,0
5087228,1907,1,4180910,4180910,5087228,906318,906318,192906,713412,74,0
5087368,108,1,3510315,3510315,5087368,1577053,1577053,255090,1321963,12,0
5088686,465,1,3746285,3746285,5088686,1342401,1342401,192195,1150206,42,0
5095856,1312,1,4173706,4173706,5095856,922150,922150,190496,731654,94,0
5096782,733,1,3960920,3960920,5096782,1135862,1135862,191511,944351,57,0
5097793,1334,1,4173805,4173805,5097793,923988,923988,192432,731556,91,0
5102176,1911,1,4180934,4180934,5102176,921242,921242,195535,725707,65,0
5117842,630,1,3828002,3828002,5117842,1289840,1289840,220350,1069490,9,0
5118156,184,2,3623909,3623909,5118156,1494247,1494247,156141,1338106,4,0
5118411,534,1,3746901,3746901,5118411,1371510,1371510,192627,1178883,43,0
5122504,482,1,3746435,3746435,5122504,1376069,1376069,212553,1163516,44,0
5124314,1174,1,4173079,4173079,5124314,951235,951235,194375,756860,101,0
5124807,1016,2,4063098,4063098,5124807,1061709,1061709,128648,933061,4,0
5126355,229,1,3647266,3647266,5126355,1479089,1479089,200714,1278375,10,0
5131076,345,1,3743769,3743769,5131076,1387307,1387307,203422,1183885,54,0
5165345,319,4,3719205,3719205,5165345,1446140,1446140,90240,1355900,3,0
5172431,273,1,3655387,3655387,5172431,1517044,1517044,246775,1270269,10,0
5177687,322,1,3724797,3724797,5177687,1452890,1452890,251998,1200892,25,0
5179381,325,1,3726342,3726342,5179381,1453039,1453039,253692,1199347,25,0
5194498,250,1,3647346,3647346,5194498,1547152,1547152,221103,1326049,11,0
5196565,541,1,3746955,3746955,5196565,1449610,1449610,215750,1233860,61,0
5196911,529,1,3746844,3746844,5196911,1450067,1450067,216512,1233555,51,0
5202406,439,1,3746078,3746078,5202406,1456328,1456328,221539,1234789,53,0
5204060,700,1,3960634,3960634,5204060,1243426,1243426,193168,1050258,62,0
5216725,500,1,3746605,3746605,5216725,1470120,1470120,306787,1163333,38,0
5235591,197,1,3640564,3640564,5235591,1595027,1595027,262048,1332979,7,0
5236319,326,1,3730697,3730697,5236319,1505622,1505622,255627,1249995,32,0
5276327,425,1,3745960,3745960,5276327,1530367,1530367,366665,1163702,40,0
5279862,398,1,3745765,3745765,5279862,1534097,1534097,370158,1163939,54,0
5282562,542,1,3746970,3746970,5282562,1535592,1535592,301823,1233769,60,0
5282929,1772,1,4177962,4177962,5282929,1104967,1104967,191930,913037,102,0
5285616,1980,1,4181328,4181328,5285616,1104288,1104288,194994,909294,81,0
5288221,270,1,3654151,3654151,5288221,1634070,1634070,362719,1271351,8,0
5290156,721,1,3960838,3960838,5290156,1329318,1329318,201080,1128238,59,0
5299870,376,1,3745584,3745584,5299870,1554286,1554286,318898,1235388,48,0
5303072,540,1,3746946,3746946,5303072,1556126,1556126,322257,1233869,60,0
5304149,825,1,3961834,3961834,5304149,1342315,1342315,291815,1050500,45,0
5304715,377,1,3745585,3745585,5304715,1559130,1559130,199459,1359671,46,0
5306217,896,1,3962538,3962538,5306217,1343679,1343679,262312,1081367,56,0
5310477,119,1,3554308,3554308,5310477,1756169,1756169,219205,1536964,3,0
5321279,815,1,3961725,3961725,5321279,1359554,1359554,309066,1050488,45,0
5323839,796,1,3961526,3961526,5323839,1362313,1362313,311754,1050559,42,0
5323909,793,1,3961504,3961504,5323909,1362405,1362405,311888,1050517,42,0
5323973,797,1,3961527,3961527,5323973,1362446,1362446,311888,1050558,40,0
5324639,446,1,3746138,3746138,5324639,1578501,1578501,208584,1369917,49,0
5331873,830,1,3961878,3961878,5331873,1369995,1369995,319770,1050225,45,0
5333190,491,1,3746534,3746534,5333190,1586656,1586656,207399,1379257,39,0
5336011,801,1,3961574,3961574,5336011,1374437,1374437,323973,1050464,41,0
5343875,898,1,3962564,3962564,5343875,1381311,1381311,299766,1081545,65,0
5343957,493,1,3746545,3746545,5343957,1597412,1597412,215393,1382019,37,0
5347791,897,1,3962562,3962562,5347791,1385229,1385229,303688,1081541,65,0
5348851,454,1,3746186,3746186,5348851,1602665,1602665,221995,1380670,46,0
5352209,859,1,3962144,3962144,5352209,1390065,1390065,308262,1081803,42,0
5354301,496,1,3746581,3746581,5354301,1607720,1607720,225671,1382049,37,0
5362824,734,1,3960923,3960923,5362824,1401901,1401901,273484,1128417,67,0
5362903,1077,1,4093909,4093909,5362903,1268994,1268994,204967,1064027,9,0
5367620,1052,1,4063582,4063582,5367620,1304038,1304038,210643,1093395,12,0
5368924,780,1,3961402,3961402,5368924,1407522,1407522,279939,1127583,53,0
5369117,1202,1,4173201,4173201,5369117,1195916,1195916,201489,994427,107,0
5371612,1177,1,4173093,4173093,5371612,1198519,1198519,214633,983886,110,0
5373299,1032,1,4063213,4063213,5373299,1310086,1310086,216232,1093854,12,0
5374174,1003,1,4062955,4062955,5374174,1311219,1311219,220818,1090401,12,0
5375579,1343,1,4173844,4173844,5375579,1201735,1201735,196019,1005716,97,0
5377994,1371,1,4173980,4173980,5377994,1204014,1204014,197238,1006776,99,0
5391873,1345,1,4173857,4173857,5391873,1218016,1218016,212313,1005703,99,0
5394592,1338,1,4173826,4173826,5394592,1220766,1220766,216797,1003969,86,0
5396182,1443,1,4174328,4174328,5396182,1221854,1221854,212545,1009309,96,0
5397319,1377,1,4174006,4174006,5397319,1223313,1223313,216102,1007211,84,0
5397355,831,1,3961880,3961880,5397355,1435475,1435475,308262,1127213,61,0
5398035,1439,1,4174303,4174303,5398035,1223732,1223732,215183,1008549,92,0
5400029,1622,1,4177272,4177272,5400029,1222757,1222757,198551,1024206,91,0
5401079,1626,1,4177294,4177294,5401079,1223785,1223785,199258,1024527,91,0
5403011,1724,1,4177731,4177731,5403011,1225280,1225280,197596,1027684,85,0
5404678,1788,1,4178045,4178045,5404678,1226633,1226633,199246,1027387,93,0
5405360,1754,1,4177887,4177887,5405360,1227473,1227473,199633,1027840,95,0
5405637,939,1,3986343,3986343,5405637,1419294,1419294,256848,1162446,17,0
5405991,1123,1,4172668,4172668,5405991,1233323,1233323,248950,984373,99,0
5407935,1890,1,4180825,4180825,5407935,1227110,1227110,200406,1026704,71,0
5408380,1958,1,4181156,4181156,5408380,1227224,1227224,198241,1028983,75,0
5408586,667,1,3922094,3922094,5408586,1486492,1486492,205226,1281266,24,0
5413542,1498,1,4176715,4176715,5413542,1236827,1236827,207674,1029153,98,0
5418327,1022,2,4063151,4063151,5418327,1355176,1355176,111881,1243295,8,0
5419479,1431,1,4174270,4174270,5419479,1245209,1245209,239400,1005809,98,0
5420092,735,1,3960931,3960931,5420092,1459161,1459161,330623,1128538,67,0
5435653,1860,1,4180650,4180650,5435653,1255003,1255003,227648,1027355,80,0
5441796,1478,1,4176609,4176609,5441796,1265187,1265187,235912,1029275,95,0
5443625,1318,1,4173732,4173732,5443625,1269893,1269893,269121,1000772,100,0
5444423,1427,1,4174242,4174242,5444423,1270181,1270181,264038,1006143,93,0
5447441,1198,1,4173183,4173183,5447441,1274258,1274258,288336,985922,105,0
5454002,523,1,3746785,3746785,5454002,1707217,1707217,317399,1389818,40,0
5466946,1884,1,4180780,4180780,5466946,1286166,1286166,259405,1026761,83,0
5469641,1694,1,4177597,4177597,5469641,1292044,1292044,258650,1033394,88,0
5469737,1975,1,4181260,4181260,5469737,1288477,1288477,260053,1028424,75,0
5471726,118,1,3552772,3552772,5471726,1918954,1918954,245195,1673759,3,0
5475513,1839,1,4180554,4180554,5475513,1294959,1294959,267070,1027889,78,0
5478925,510,1,3746692,3746692,5478925,1732233,1732233,204741,1527492,47,0
5480454,1886,1,4180795,4180795,5480454,1299659,1299659,273007,1026652,73,0
5481552,1856,1,4180637,4180637,5481552,1300915,1300915,273547,1027368,83,0
5482953,1769,1,4177949,4177949,5482953,1305004,1305004,271615,1033389,92,0
5484275,415,1,3745895,3745895,5484275,1738380,1738380,223022,1515358,51,0
5484306,1641,1,4177366,4177366,5484306,1306940,1306940,273007,1033933,89,0
5485828,371,1,3745521,3745521,5485828,1740307,1740307,224586,1515721,49,0
5509026,267,1,3653578,3653578,5509026,1855448,1855448,258352,1597096,8,0
5519244,609,1,3789053,3789053,5519244,1730191,1730191,234394,1495797,17,0
5528384,1171,1,4173067,4173067,5528384,1355317,1355317,370550,984767,104,0
5547020,683,1,3960060,3960060,5547020,1586960,1586960,262077,1324883,53,0
5549422,1378,1,4174008,4174008,5549422,1375414,1375414,369009,1006405,84,0
5560394,738,1,3960950,3960950,5560394,1599444,1599444,273204,1326240,62,0
5562761,709,1,3960743,3960743,5562761,1602018,1602018,275732,1326286,56,0
5563657,654,1,3889964,3889964,5563657,1673693,1673693,361008,1312685,13,0
5578258,923,1,3976538,3976538,5578258,1601720,1601720,209449,1392271,39,0
5579560,1325,1,4173769,4173769,5579560,1405791,1405791,374744,1031047,97,0
5593332,930,1,3980499,3980499,5593332,1612833,1612833,224613,1388220,28,0
5596071,1437,1,4174298,4174298,5596071,1421773,1421773,415634,1006139,92,0
5599648,951,1,3998093,3998093,5599648,1601555,1601555,229145,1372410,18,0
5601540,822,1,3961813,3961813,5601540,1639727,1639727,275485,1364242,39,0
5602457,616,1,3807618,3807618,5602457,1794839,1794839,316253,1478586,15,0
5602537,739,1,3960968,3960968,5602537,1641569,1641569,315352,1326217,59,0
5604787,967,1,4031841,4031841,5604787,1572946,1572946,219658,1353288,10,0
5612284,807,1,3961638,3961638,5612284,1650646,1650646,320315,1330331,47,0
5612889,805,1,3961612,3961612,5612889,1651277,1651277,321089,1330188,52,0
5619120,1023,1,4063165,4063165,5619120,1555955,1555955,216928,1339027,12,0
5619478,790,1,3961484,3961484,5619478,1657994,1657994,327704,1330290,38,0
5619764,699,1,3960630,3960630,5619764,1659134,1659134,332478,1326656,63,0
5620391,1359,1,4173919,4173919,5620391,1446472,1446472,194082,1252390,101,0
5620497,1300,1,4173655,4173655,5620497,1446842,1446842,194839,1252003,105,0
5620869,698,1,3960628,3960628,5620869,1660241,1660241,333665,1326576,63,0
5621975,884,1,3962427,3962427,5621975,1659548,1659548,265523,1394025,37,0
5623864,1024,1,4063167,4063167,5623864,1560697,1560697,221870,1338827,12,0
5629855,997,1,4062826,4062826,5629855,1567029,1567029,227951,1339078,15,0
5630566,535,1,3746903,3746903,5630566,1883663,1883663,354244,1529419,60,0
5632248,737,1,3960949,3960949,5632248,1671299,1671299,345057,1326242,67,0
5632796,730,1,3960904,3960904,5632796,1671892,1671892,345752,1326140,56,0
5632951,752,1,3961108,3961108,5632951,1671843,1671843,341922,1329921,54,0
5636361,1384,1,4174035,4174035,5636361,1462326,1462326,210148,1252178,79,0
5639750,1956,1,4181140,4181140,5639750,1458610,1458610,200638,1257972,77,0
5644218,1785,1,4178038,4178038,5644218,1466180,1466180,205773,1260407,88,0
5644767,1440,1,4174315,4174315,5644767,1470452,1470452,218189,1252263,95,0
5645054,565,1,3747310,3747310,5645054,1897744,1897744,202422,1695322,60,0
5651781,1713,1,4177682,4177682,5651781,1474099,1474099,213086,1261013,81,0
5651805,1664,1,4177465,4177465,5651805,1474340,1474340,214787,1259553,94,0
5653280,1625,1,4177291,4177291,5653280,1475989,1475989,216244,1259745,94,0
5669520,963,1,4030861,4030861,5669520,1638659,1638659,285146,1353513,14,0
5671192,1932,1,4181028,4181028,5671192,1490164,1490164,232095,1258069,65,0
5678481,1995,1,4184055,4184055,5678481,1494426,1494426,238610,1255816,61,0
5682150,1286,1,4173592,4173592,5682150,1508558,1508558,256461,1252097,108,0
5684390,1429,1,4174257,4174257,5684390,1510133,1510133,258059,1252074,96,0
5691630,1595,1,4177163,4177163,5691630,1514467,1514467,255405,1259062,109,0
5693734,1302,1,4173658,4173658,5693734,1520076,1520076,267718,1252358,104,0
5694743,1608,1,4177224,4177224,5694743,1517519,1517519,258418,1259101,96,0
5698968,1591,1,4177150,4177150,5698968,1521818,1521818,218826,1302992,101,0
5703195,1467,1,4176533,4176533,5703195,1526662,1526662,276641,1250021,87,0
5707203,1547,1,4176950,4176950,5707203,1530253,1530253,279811,1250442,101,0
5709275,1281,1,4173567,4173567,5709275,1535708,1535708,283586,1252122,102,0
5709573,1268,1,4173497,4173497,5709573,1536076,1536076,283910,1252166,101,0
5714778,693,1,3960585,3960585,5714778,1754193,1754193,418333,1335860,69,0
5726142,1619,1,4177257,4177257,5726142,1548885,1548885,289105,1259780,90,0
5728320,1394,1,4174087,4174087,5728320,1554233,1554233,302046,1252187,100,0
5729164,954,1,3999450,3999450,5729164,1729714,1729714,345127,1384587,14,0
5729487,1813,1,4180423,4180423,5729487,1549064,1549064,239729,1309335,78,0
5730097,1826,1,4180504,4180504,5730097,1549593,1549593,240123,1309470,71,0
5734767,723,1,3960860,3960860,5734767,1773907,1773907,428710,1345197,73,0
5738510,1598,1,4177175,4177175,5738510,1561335,1561335,258110,1303225,106,0
5739258,1555,1,4176981,4176981,5739258,1562277,1562277,258974,1303303,101,0
5745973,1430,1,4174257,4174257,5745973,1571716,1571716,319642,1252074,96,0
5746608,1836,1,4180544,4180544,5746608,1566064,1566064,256840,1309224,86,0
5747031,1827,1,4180504,4180504,5747031,1566527,1566527,257246,1309281,82,0
5751384,438,1,3746077,3746077,5751384,2005307,2005307,382740,1622567,49,0
5752639,489,1,3746505,3746505,5752639,2006134,2006134,376565,1629569,40,0
5757408,1186,1,4173131,4173131,5757408,1584277,1584277,287797,1296480,110,0
5768066,1351,1,4173883,4173883,5768066,1594183,1594183,384779,1209404,99,0
5768706,360,1,3745409,3745409,5768706,2023297,2023297,404055,1619242,47,0
5773683,1228,1,4173305,4173305,5773683,1600378,1600378,293194,1307184,97,0
5780097,1271,1,4173510,4173510,5780097,1606587,1606587,299563,1307024,96,0
5783663,1656,1,4177433,4177433,5783663,1606230,1606230,303126,1303104,101,0
5784059,1386,1,4174044,4174044,5784059,1610015,1610015,357857,1252158,92,0
5786839,1332,1,4173794,4173794,5786839,1613045,1613045,405105,1207940,100,0
5791122,1888,1,4180809,4180809,5791122,1610313,1610313,409294,1201019,74,0
5791422,475,1,3746351,3746351,5791422,2045071,2045071,415401,1629670,39,0
5798696,1794,1,4178072,4178072,5798696,1620624,1620624,318131,1302493,87,0
5799073,1485,1,4176646,4176646,5799073,1622427,1622427,371877,1250550,98,0
5801221,1489,1,4176662,4176662,5801221,1624559,1624559,374027,1250532,90,0
5810836,786,1,3961457,3961457,5810836,1849379,1849379,425781,1423598,43,0
5817821,958,1,4004715,4004715,5817821,1813106,1813106,422087,1391019,20,0
5828728,835,1,3961920,3961920,5828728,1866808,1866808,433656,1433152,62,0
5828960,1549,1,4176958,4176958,5828960,1652002,1652002,348939,1303063,98,0
5829210,1645,1,4177380,4177380,5829210,1651830,1651830,349082,1302748,110,0
5832909,1009,1,4063065,4063065,5832909,1769844,1769844,389981,1379863,12,0
5834609,1750,1,4177866,4177866,5834609,1656743,1656743,396206,1260537,88,0
5836410,1781,1,4178006,4178006,5836410,1658404,1658404,356107,1302297,90,0
5840130,539,1,3746938,3746938,5840130,2093192,2093192,363777,1729415,64,0
5844633,1536,1,4176899,4176899,5844633,1667734,1667734,356824,1310910,100,0
5849893,1157,1,4173001,4173001,5849893,1676892,1676892,382469,1294423,109,0
5850257,463,1,3746263,3746263,5850257,2103994,2103994,480847,1623147,42,0
5850928,393,1,3745712,3745712,5850928,2105216,2105216,385404,1719812,53,0
5853487,499,1,3746602,3746602,5853487,2106885,2106885,477511,1629374,47,0
5853661,351,1,3745325,3745325,5853661,2108336,2108336,388103,1720233,48,0
5855803,1616,1,4177245,4177245,5855803,1678558,1678558,419478,1259080,97,0
5856372,937,1,3985686,3985686,5856372,1870686,1870686,371556,1499130,22,0
5859943,916,8,3963547,3963547,5859943,1896396,1896396,50399,1845997,18,0
5862745,448,1,3746146,3746146,5862745,2116599,2116599,493375,1623224,52,0
5862785,895,1,3962536,3962536,5862785,1900249,1900249,380271,1519978,56,0
5867302,1390,1,4174069,4174069,5867302,1693233,1693233,440368,1252865,95,0
5867419,1072,8,4068815,4068815,5867419,1798604,1798604,57943,1740661,5,0
5870134,935,4,3980652,3980652,5870134,1889482,1889482,130423,1759059,18,0
5874285,1683,1,4177555,4177555,5874285,1696730,1696730,386499,1310231,85,0
5875890,1165,1,4173040,4173040,5875890,1702850,1702850,406275,1296575,110,0
5882139,1504,1,4176742,4176742,5882139,1705397,1705397,394344,1311053,94,0
5882427,548,1,3747002,3747002,5882427,2135425,2135425,530175,1605250,65,0
5882755,858,1,3962124,3962124,5882755,1920631,1920631,402081,1518550,39,0
5884081,1162,1,4173027,4173027,5884081,1711054,1711054,414966,1296088,110,0
5887221,993,1,4062754,4062754,5887221,1824467,1824467,399310,1425157,16,0
5892241,1552,1,4176970,4176970,5892241,1715271,1715271,411957,1303314,99,0
5896437,872,1,3962289,3962289,5896437,1934148,1934148,413899,1520249,66,0
5897947,1528,1,4176862,4176862,5897947,1721085,1721085,417807,1303278,100,0
5899948,1780,1,4178000,4178000,5899948,1721948,1721948,419645,1302303,92,0
5908111,1374,1,4173993,4173993,5908111,1734118,1734118,481146,1252972,101,0
5911217,408,1,3745840,3745840,5911217,2165377,2165377,332029,1833348,56,0
5934979,1991,1,4181474,4181474,5934979,1753505,1753505,348939,1404566,83,0
5943738,1381,1,4174022,4174022,5943738,1769716,1769716,516743,1252973,82,0
5946852,152,1,3575019,3575019,5946852,2371833,2371833,376366,1995467,5,0
5959524,1013,2,4063082,4063082,5959524,1896442,1896442,153225,1743217,8,0
5965577,509,1,3746686,3746686,5965577,2218891,2218891,356734,1862157,47,0
5976261,531,1,3746867,3746867,5976261,2229394,2229394,366992,1862402,45,0
5976347,1509,1,4176765,4176765,5976347,1799582,1799582,285680,1513902,105,0
5976538,526,1,3746827,3746827,5976538,2229711,2229711,367349,1862362,48,0
5977163,567,1,3747311,3747311,5977163,2229852,2229852,391399,1838453,50,0
5977870,516,1,3746740,3746740,5977870,2231130,2231130,368807,1862323,47,0
5980587,506,1,3746664,3746664,5980587,2233923,2233923,371744,1862179,47,0
5986151,1569,1,4177048,4177048,5986151,1809103,1809103,284759,1524344,103,0
5987208,1557,1,4176990,4176990,5987208,1810218,1810218,285961,1524257,102,0
5991533,1798,1,4178110,4178110,5991533,1813423,1813423,279193,1534230,85,0
5993918,1339,1,4173830,4173830,5993918,1820088,1820088,309711,1510377,97,0
5994333,664,1,3921076,3921076,5994333,2073257,2073257,372683,1700574,22,0
6000222,910,1,3962830,3962830,6000222,2037392,2037392,515362,1522030,57,0
6002841,838,1,3961953,3961953,6002841,2040888,2040888,377452,1663436,59,0
6007381,832,1,3961887,3961887,6007381,2045494,2045494,421639,1623855,66,0
6007660,1254,1,4173419,4173419,6007660,1834241,1834241,322881,1511360,101,0
6011344,364,1,3745448,3745448,6011344,2265896,2265896,403420,1862476,62,0
6017667,1996,1,4184064,4184064,6017667,1833603,1833603,284914,1548689,58,0
6018099,899,1,3962565,3962565,6018099,2055534,2055534,392665,1662869,64,0
6020455,852,1,3962075,3962075,6020455,2058380,2058380,395890,1662490,45,0
6028025,671,1,3927740,3927740,6028025,2100285,2100285,405408,1694877,19,0
6034454,1493,1,4176677,4176677,6034454,1857777,1857777,343460,1514317,102,0
6034780,1219,1,4173265,4173265,6034780,1861515,1861515,362415,1499100,110,0
6040535,712,1,3960771,3960771,6040535,2079764,2079764,416038,1663726,60,0
6041053,1952,1,4181115,4181115,6041053,1859938,1859938,312809,1547129,76,0
6044594,1209,1,4173229,4173229,6044594,1871365,1871365,375604,1495761,117,0
6061473,1470,1,4176564,4176564,6061473,1884909,1884909,376964,1507945,102,0
6068439,976,1,4062444,4062444,6068439,2005995,2005995,408578,1597417,18,0
6069057,1851,1,4180612,4180612,6069057,1888445,1888445,349656,1538789,85,0
6073579,625,1,3816384,3816384,6073579,2257195,2257195,461166,1796029,17,0
6074952,1901,1,4180885,4180885,6074952,1894067,1894067,349799,1544268,81,0
6080598,1340,1,4173832,4173832,6080598,1906766,1906766,396391,1510375,96,0
6085984,1863,1,4180662,4180662,6085984,1905322,1905322,366572,1538750,82,0
6088396,1154,1,4172988,4172988,6088396,1915408,1915408,419616,1495792,115,0
6091504,1585,1,4177125,4177125,6091504,1914379,1914379,389653,1524726,103,0
6095593,1471,1,4176572,4176572,6095593,1919021,1919021,405031,1513990,97,0
6099692,1653,1,4177420,4177420,6099692,1922272,1922272,393667,1528605,105,0
6104793,171,1,3587805,3587805,6104793,2516988,2516988,527089,1989899,5,0
6114449,949,1,3998040,3998040,6114449,2116409,2116409,478335,1638074,23,0
6128414,863,1,3962197,3962197,6128414,2166217,2166217,542661,1623556,44,0
6132802,1567,1,4177033,4177033,6132802,1955769,1955769,431845,1523924,99,0
6138259,1988,1,4181446,4181446,6138259,1956813,1956813,405440,1551373,76,0
6139497,1972,1,4181246,4181246,6139497,1958251,1958251,411790,1546461,79,0
6142186,592,2,3778068,3778068,6142186,2364118,2364118,395719,1968399,23,0
6148225,1545,1,4176937,4176937,6148225,1971288,1971288,447220,1524068,97,0
6153246,984,1,4062582,4062582,6153246,2090664,2090664,585981,1504683,15,0
6239102,1812,1,4180417,4180417,6239102,2058685,2058685,522549,1536136,75,0
6251798,1753,1,4177878,4177878,6251798,2073920,2073920,540141,1533779,94,0
6282854,820,1,3961796,3961796,6282854,2321058,2321058,548794,1772264,48,0
6283366,474,1,3746345,3746345,6283366,2537021,2537021,477973,2059048,45,0
6288702,180,2,3612767,3612767,6288702,2675935,2675935,387831,2288104,8,0
6295974,1712,1,4177676,4177676,6295974,2118298,2118298,589943,1528355,98,0
6301766,1783,1,4178019,4178019,6301766,2123747,2123747,567769,1555978,93,0
6308612,828,1,3961863,3961863,6308612,2346749,2346749,574580,1772169,49,0
6362059,804,1,3961609,3961609,6362059,2400450,2400450,551970,1848480,51,0
6370311,478,1,3746383,3746383,6370311,2623928,2623928,564915,2059013,46,0
6372627,628,1,3823198,3823198,6372627,2549429,2549429,760241,1789188,11,0
6428241,449,1,3746173,3746173,6428241,2682068,2682068,694054,1988014,52,0
6483880,479,1,3746400,3746400,6483880,2737480,2737480,678487,2058993,48,0
6503400,917,8,3963785,3963785,6503400,2539615,2539615,146131,2393484,24,0
6643186,1584,1,4177117,4177117,6643186,2466069,2466069,941161,1524908,102,0
6662694,1203,1,4173203,4173203,6662694,2489491,2489491,778160,1711331,114,0
6677717,120,1,3555137,3555137,6677717,3122580,3122580,433526,2689054,7,0
6706482,644,1,3873972,3873972,6706482,2832510,2832510,902212,1930298,10,0
6712799,86,1,3175183,3175183,6712799,3537616,3537616,937782,2599834,15,0
6736740,823,1,3961816,3961816,6736740,2774924,2774924,1002879,1772045,51,0
6740884,307,1,3679668,3679668,6740884,3061216,3061216,452723,2608493,19,0
6764109,904,1,3962658,3962658,6764109,2801451,2801451,952390,1849061,62,0
6788430,968,1,4062357,4062357,6788430,2726073,2726073,1053990,1672083,14,0
6803191,792,1,3961499,3961499,6803191,2841692,2841692,996973,1844719,41,0
6806424,129,1,3566016,3566016,6806424,3240408,3240408,563406,2677002,6,0
6815566,714,1,3960798,3960798,6815566,2854768,2854768,1009512,1845256,68,0
6824619,545,1,3746995,3746995,6824619,3077624,3077624,1018629,2058995,61,0
6849801,271,1,3654677,3654677,6849801,3195124,3195124,561884,2633240,10,0
6857574,349,1,3745310,3745310,6857574,3112264,3112264,487671,2624593,56,0
6858110,972,1,4062379,4062379,6858110,2795731,2795731,972707,1823024,11,0
6866877,705,1,3960677,3960677,6866877,2906200,2906200,1060759,1845441,71,0
6880213,397,1,3745759,3745759,6880213,3134454,3134454,483204,2651250,54,0
6886677,320,1,3724197,3724197,6886677,3162480,3162480,598632,2563848,30,0
6895885,365,1,3745454,3745454,6895885,3150431,3150431,500749,2649682,49,0
6905194,578,1,3756214,3756214,6905194,3148980,3148980,437356,2711624,41,0
6911859,466,1,3746290,3746290,6911859,3165569,3165569,473499,2692070,42,0
6916861,455,1,3746202,3746202,6916861,3170659,3170659,477616,2693043,48,0
6919170,428,1,3745987,3745987,6919170,3173183,3173183,480148,2693035,42,0
6919890,422,1,3745937,3745937,6919890,3173953,3173953,480859,2693094,52,0
6925645,574,1,3756157,3756157,6925645,3169488,3169488,457673,2711815,41,0
6926500,718,1,3960819,3960819,6926500,2965681,2965681,428004,2537677,51,0
6930619,456,1,3746209,3746209,6930619,3184410,3184410,491371,2693039,49,0
6932886,442,1,3746109,3746109,6932886,3186777,3186777,493889,2692888,53,0
6938889,423,1,3745941,3745941,6938889,3192948,3192948,499884,2693064,43,0
6946150,672,1,3927747,3927747,6946150,3018403,3018403,479515,2538888,21,0
6947527,669,1,3927598,3927598,6947527,3019929,3019929,479232,2540697,17,0
6948760,557,1,3747093,3747093,6948760,3201667,3201667,480622,2721045,52,0
6952467,453,1,3746186,3746186,6952467,3206281,3206281,513222,2693059,48,0
6954426,437,1,3746060,3746060,6954426,3208366,3208366,515072,2693294,50,0
7000844,115,1,3551250,3551250,7000844,3449594,3449594,757753,2691841,7,0
7030976,646,1,3874036,3874036,7030976,3156940,3156940,563705,2593235,9,0
7034870,763,1,3961202,3961202,7034870,3073668,3073668,423456,2650212,53,0
7041601,686,1,3960546,3960546,7041601,3081055,3081055,565288,2515767,69,0
7056321,691,1,3960580,3960580,7056321,3095741,3095741,569688,2526053,66,0
7065317,720,1,3960836,3960836,7065317,3104481,3104481,565254,2539227,59,0
7072953,537,1,3746922,3746922,7072953,3326031,3326031,633391,2692640,66,0
7074853,368,1,3745498,3745498,7074853,3329355,3329355,677375,2651980,56,0
7079587,381,1,3745608,3745608,7079587,3333979,3333979,682892,2651087,45,0
7083733,420,1,3745919,3745919,7083733,3337814,3337814,652518,2685296,48,0
7091886,435,1,3746035,3746035,7091886,3345851,3345851,652501,2693350,52,0
7101900,544,1,3746982,3746982,7101900,3354918,3354918,634240,2720678,54,0
7137713,434,1,3746034,3746034,7137713,3391679,3391679,698328,2693351,53,0
7196497,765,1,3961223,3961223,7196497,3235274,3235274,585180,2650094,51,0
7201915,798,1,3961544,3961544,7201915,3240371,3240371,545746,2694625,45,0
7203218,776,1,3961356,3961356,7203218,3241862,3241862,557338,2684524,52,0
7210928,276,1,3659789,3659789,7210928,3551139,3551139,925025,2626114,11,0
7212970,845,1,3962022,3962022,7212970,3250948,3250948,421812,2829136,57,0
7218730,645,1,3874024,3874024,7218730,3344706,3344706,751447,2593259,9,0
7258130,586,1,3769658,3769658,7258130,3488472,3488472,790408,2698064,31,0
7261661,588,1,3769662,3769662,7261661,3491999,3491999,793976,2698023,31,0
7268716,839,1,3961958,3961958,7268716,3306758,3306758,586420,2720338,62,0
7278060,155,1,3575294,3575294,7278060,3702766,3702766,1034815,2667951,7,0
7341984,107,1,3509664,3509664,7341984,3832320,3832320,1099280,2733040,14,0
7349469,846,1,3962023,3962023,7349469,3387446,3387446,555667,2831779,57,0
7351373,1232,1,4173317,4173317,7351373,3178056,3178056,421650,2756406,103,0
7367020,615,1,3806182,3806182,7367020,3560838,3560838,898923,2661915,16,0
7367226,1238,1,4173349,4173349,7367226,3193877,3193877,435856,2758021,103,0
7371352,848,1,3962030,3962030,7371352,3409322,3409322,571794,2837528,55,0
7378419,590,1,3769670,3769670,7378419,3608749,3608749,910352,2698397,29,0
7379260,1882,1,4180765,4180765,7379260,3198495,3198495,431511,2766984,76,0
7381984,336,1,3740084,3740084,7381984,3641900,3641900,1065508,2576392,40,0
7392301,1260,1,4173442,4173442,7392301,3218859,3218859,444713,2774146,106,0
7399391,1971,1,4181233,4181233,7399391,3218158,3218158,448557,2769601,83,0
7400125,1968,1,4181221,4181221,7400125,3218904,3218904,449291,2769613,76,0
7407512,1795,1,4178073,4178073,7407512,3229439,3229439,459420,2770019,87,0
7409519,1393,1,4174073,4174073,7409519,3235446,3235446,460924,2774522,98,0
7410989,1278,1,4173556,4173556,7410989,3237433,3237433,463484,2773949,101,0
7411506,1222,1,4173278,4173278,7411506,3238228,3238228,489001,2749227,103,0
7419146,1358,1,4173917,4173917,7419146,3245229,3245229,470450,2774779,103,0
7451144,1104,1,4172552,4172552,7451144,3278592,3278592,528426,2750166,97,0
7487707,902,1,3962591,3962591,7487707,3525116,3525116,566213,2958903,61,0
7503235,1115,1,4172623,4172623,7503235,3330612,3330612,580417,2750195,107,0
7510316,1066,1,4063948,4063948,7510316,3446368,3446368,586610,2859758,16,0
7512228,527,1,3746837,3746837,7512228,3765391,3765391,1073570,2691821,56,0
7513167,727,1,3960881,3960881,7513167,3552286,3552286,1007665,2544621,63,0
7540223,518,1,3746756,3746756,7540223,3793467,3793467,1120819,2672648,51,0
7549739,694,1,3960605,3960605,7549739,3589134,3589134,1062879,2526255,53,0
7560698,538,1,3746934,3746934,7560698,3813764,3813764,1112369,2701395,67,0
7572605,179,1,3612318,3612318,7572605,3960287,3960287,1119942,2840345,11,0
7573391,987,1,4062626,4062626,7573391,3510765,3510765,651186,2859579,15,0
7573984,459,1,3746238,3746238,7573984,3827746,3827746,1106402,2721344,46,0
7574560,985,1,4062586,4062586,7574560,3511974,3511974,652848,2859126,15,0
7575236,495,1,3746573,3746573,7575236,3828663,3828663,1115064,2713599,46,0
7576198,181,1,3615055,3615055,7576198,3961143,3961143,1118320,2842823,15,0
7590511,467,1,3746294,3746294,7590511,3844217,3844217,1127664,2716553,50,0
7630031,773,1,3961318,3961318,7630031,3668713,3668713,992672,2676041,56,0
7636132,811,1,3961691,3961691,7636132,3674441,3674441,975833,2698608,42,0
7653616,764,1,3961210,3961210,7653616,3692406,3692406,1042162,2650244,50,0
7658225,770,1,3961291,3961291,7658225,3696934,3696934,1035590,2661344,63,0
7668668,127,1,3565275,3565275,7668668,4103393,4103393,1149894,2953499,11,0
7680078,443,1,3746113,3746113,7680078,3933965,3933965,1158951,2775014,57,0
7695252,361,1,3745423,3745423,7695252,3949829,3949829,1181697,2768132,56,0
7714464,469,1,3746320,3746320,7714464,3968144,3968144,1179153,2788991,45,0
7727839,842,1,3961992,3961992,7727839,3765847,3765847,950755,2815092,60,0
7767627,1551,1,4176964,4176964,7767627,3590663,3590663,820534,2770129,97,0
7774141,369,1,3745500,3745500,7774141,4028641,4028641,1188057,2840584,54,0
7798377,145,1,3572960,3572960,7798377,4225417,4225417,1209932,3015485,12,0
7826351,1062,1,4063859,4063859,7826351,3762492,3762492,903608,2858884,17,0
7828213,458,1,3746232,3746232,7828213,4081981,4081981,1210561,2871420,55,0
7831846,576,1,3756179,3756179,7831846,4075667,4075667,1216744,2858923,45,0
7837798,1030,1,4063202,4063202,7837798,3774596,3774596,914038,2860558,15,0
7871473,1982,1,4181366,4181366,7871473,3690107,3690107,912919,2777188,75,0
7899099,906,1,3962692,3962692,7899099,3936407,3936407,977862,2958545,61,0
7908494,636,1,3833006,3833006,7908494,4075488,4075488,1248535,2826953,12,0
7911332,1876,1,4180721,4180721,7911332,3730611,3730611,1242362,2488249,80,0
8003067,908,1,3962748,3962748,8003067,4040319,4040319,1341650,2698669,62,0
8020829,337,1,3740191,3740191,8020829,4280638,4280638,1271263,3009375,54,0
8145844,1083,1,4093968,4093968,8145844,4051876,4051876,1223481,2828395,13,0
8309422,1012,1,4063081,4063081,8309422,4246341,4246341,1386952,2859389,13,0
8338877,864,1,3962200,3962200,8338877,4376677,4376677,1365973,3010704,52,0
8380548,991,1,4062716,4062716,8380548,4317832,4317832,1429377,2888455,15,0
8385963,886,1,3962436,3962436,8385963,4423527,4423527,302540,4120987,41,0
8386266,1670,1,4177492,4177492,8386266,4208774,4208774,298052,3910722,96,0
8393068,111,4,3538206,3538206,8393068,4854862,4854862,86816,4768046,1,0
8401460,881,1,3962399,3962399,8401460,4439061,4439061,318041,4121020,38,0
8408167,562,1,3747308,3747308,8408167,4660859,4660859,324918,4335941,62,0
8427691,1671,1,4177500,4177500,8427691,4250191,4250191,339477,3910714,95,0
8439461,581,1,3756219,3756219,8439461,4683242,4683242,356710,4326532,40,0
8448002,1303,1,4173667,4173667,8448002,4274335,4274335,359261,3915074,102,0
8452643,517,1,3746744,3746744,8452643,4705899,4705899,369210,4336689,48,0
8454130,386,1,3745650,3745650,8454130,4708480,4708480,371287,4337193,62,0
8461984,818,1,3961771,3961771,8461984,4500213,4500213,1419974,3080239,50,0
8464158,414,1,3745890,3745890,8464158,4718268,4718268,380742,4337526,46,0
8468366,411,1,3745866,3745866,8468366,4722500,4722500,384959,4337541,55,0
8479607,1730,1,4177761,4177761,8479607,4301846,4301846,390800,3911046,100,0
8481676,1082,1,4093966,4093966,8481676,4387710,4387710,392947,3994763,13,0
8486555,879,1,3962384,3962384,8486555,4524171,4524171,403751,4120420,37,0
8487263,1632,1,4177320,4177320,8487263,4309943,4309943,398755,3911188,100,0
8489839,947,8,3997335,3997335,8489839,4492504,4492504,141062,4351442,12,0
8496685,834,1,3961916,3961916,8496685,4534769,4534769,413951,4120818,58,0
8499222,814,1,3961723,3961723,8499222,4537499,4537499,416006,4121493,47,0
8537380,1144,1,4172936,4172936,8537380,4364444,4364444,448718,3915726,102,0
8550491,340,1,3741326,3741326,8550491,4809165,4809165,1435962,3373203,51,0
8589227,717,1,3960809,3960809,8589227,4628418,4628418,1461814,3166604,83,0
8594898,803,1,3961596,3961596,8594898,4633302,4633302,1428272,3205030,66,0
8598982,417,1,3745905,3745905,8598982,4853077,4853077,515547,4337530,53,0
8602059,876,1,3962325,3962325,8602059,4639734,4639734,519252,4120482,46,0
8610458,1825,1,4180495,4180495,8610458,4429963,4429963,521688,3908275,78,0
8619541,857,1,3962122,3962122,8619541,4657419,4657419,536764,4120655,47,0
8623926,1056,1,4063608,4063608,8623926,4560318,4560318,535316,4025002,15,0
8628389,870,1,3962266,3962266,8628389,4666123,4666123,545719,4120404,59,0
8644922,821,1,3961810,3961810,8644922,4683112,4683112,561644,4121468,38,0
8647687,849,1,3962047,3962047,8647687,4685640,4685640,564422,4121218,53,0
8670287,1704,1,4177642,4177642,8670287,4492645,4492645,581470,3911175,91,0
8676012,1064,1,4063930,4063930,8676012,4612082,4612082,587245,4024837,16,0
8696864,690,1,3960562,3960562,8696864,4736302,4736302,1472395,3263907,61,0
8701590,1817,1,4180449,4180449,8701590,4521141,4521141,612839,3908302,82,0
8714700,441,1,3746100,3746100,8714700,4968600,4968600,631641,4336959,48,0
8726549,998,1,4062828,4062828,8726549,4663721,4663721,643120,4020601,15,0
8741521,388,1,3745663,3745663,8741521,4995858,4995858,658651,4337207,51,0
8743298,710,1,3960755,3960755,8743298,4782543,4782543,1465283,3317260,72,0
8749932,707,1,3960727,3960727,8749932,4789205,4789205,1470727,3318478,76,0
8750102,1672,1,4177505,4177505,8750102,4572597,4572597,661522,3911075,96,0
8751891,689,1,3960557,3960557,8751891,4791334,4791334,1474195,3317139,73,0
8766240,419,1,3745914,3745914,8766240,5020326,5020326,682807,4337519,43,0
8779613,957,1,4003381,4003381,8779613,4776232,4776232,1484827,3291405,27,0
8779851,413,1,3745887,3745887,8779851,5033964,5033964,696435,4337529,45,0
8845634,139,1,3569055,3569055,8845634,5276579,5276579,1557250,3719329,21,0
8878668,1055,1,4063607,4063607,8878668,4815061,4815061,790059,4025002,14,0
8903145,1049,1,4063430,4063430,8903145,4839715,4839715,814473,4025242,17,0
8933932,64,1,2949862,2949862,8933932,5984070,5984070,1523820,4460250,11,0
8956448,901,1,3962586,3962586,8956448,4993862,4993862,1528021,3465841,63,0
8961748,986,1,4062608,4062608,8961748,4899140,4899140,878304,4020836,17,0
8977905,1071,1,4064340,4064340,8977905,4913565,4913565,889304,4024261,13,0
9003328,1021,1,4063146,4063146,9003328,4940182,4940182,920063,4020119,14,0
9010687,123,1,3564060,3564060,9010687,5446627,5446627,927297,4519330,13,0
9013745,1080,1,4093944,4093944,9013745,4919801,4919801,924925,3994876,13,0
9020307,841,1,3961981,3961981,9020307,5058326,5058326,1547086,3511240,67,0
9020662,1004,1,4062976,4062976,9020662,4957686,4957686,937204,4020482,14,0
9040928,1058,1,4063637,4063637,9040928,4977291,4977291,952318,4024973,16,0
9078508,18,1,2025050,2025050,9078508,7053458,7053458,1592046,5461412,2,0
9082311,536,1,3746910,3746910,9082311,5335401,5335401,1565383,3770018,79,0
9109132,802,1,3961590,3961590,9109132,5147542,5147542,1589713,3557829,60,0
9120777,888,1,3962450,3962450,9120777,5158327,5158327,1037356,4120971,39,0
9223877,430,1,3746009,3746009,9223877,5477868,5477868,1688401,3789467,62,0
9242691,769,1,3961273,3961273,9242691,5281418,5281418,1605845,3675573,77,0
9245068,41,1,2595254,2595254,9245068,6649814,6649814,1595683,5054131,19,0
9281220,564,1,3747309,3747309,9281220,5533911,5533911,1634268,3899643,80,0
9284649,546,1,3746998,3746998,9284649,5537651,5537651,1634838,3902813,70,0
9287122,791,1,3961490,3961490,9287122,5325632,5325632,1594895,3730737,59,0
9288587,789,1,3961483,3961483,9288587,5327104,5327104,1596850,3730254,54,0
9288939,772,1,3961312,3961312,9288939,5327627,5327627,1597437,3730190,65,0
9299858,754,1,3961119,3961119,9299858,5338739,5338739,1607654,3731085,69,0
9305922,387,1,3745654,3745654,9305922,5560268,5560268,1223100,4337168,52,0
9307575,742,1,3961024,3961024,9307575,5346551,5346551,1617039,3729512,79,0
9313114,379,1,3745595,3745595,9313114,5567519,5567519,1230278,4337241,46,0
9317636,359,1,3745399,3745399,9317636,5572237,5572237,1234367,4337870,44,0
9394275,58,1,2740512,2740512,9394275,6653763,6653763,1722430,4931333,25,0
9439571,631,1,3828327,3828327,9439571,5611244,5611244,1670356,3940888,33,0
9465546,1033,1,4063214,4063214,9465546,5402332,5402332,1376805,4025527,14,0
9475414,1008,1,4063064,4063064,9475414,5412350,5412350,1392026,4020324,14,0
9497935,403,1,3745808,3745808,9497935,5752127,5752127,1717816,4034311,67,0
9542493,1063,1,4063930,4063930,9542493,5478563,5478563,1722333,3756230,27,0
9556526,869,1,3962260,3962260,9556526,5594266,5594266,1473662,4120604,60,0
9619017,882,1,3962406,3962406,9619017,5656611,5656611,1535598,4121013,37,0
9653015,867,1,3962222,3962222,9653015,5690793,5690793,1570208,4120585,67,0
9688425,66,1,2950505,2950505,9688425,6737920,6737920,1799318,4938602,22,0
9711091,362,1,3745431,3745431,9711091,5965660,5965660,1787447,4178213,83,0
9788469,1005,1,4062995,4062995,9788469,5725474,5725474,1857092,3868382,38,0
9792777,358,1,3745392,3745392,9792777,6047385,6047385,1792672,4254713,78,0
9822924,485,1,3746473,3746473,9822924,6076451,6076451,1823917,4252534,62,0
9836827,508,1,3746679,3746679,9836827,6090148,6090148,1829099,4261049,69,0
9871933,486,1,3746489,3746489,9871933,6125444,6125444,1858918,4266526,62,0
9885194,519,1,3746775,3746775,9885194,6138419,6138419,1801724,4336695,50,0
9890599,1045,1,4063413,4063413,9890599,5827186,5827186,1801754,4025432,13,0
9927458,1002,1,4062889,4062889,9927458,5864569,5864569,1844046,4020523,14,0
9928506,488,1,3746504,3746504,9928506,6182002,6182002,1860776,4321226,66,0
9938802,452,1,3746184,3746184,9938802,6192618,6192618,1867962,4324656,78,0
9952100,427,1,3745986,3745986,9952100,6206114,6206114,1879694,4326420,61,0
9973869,611,4,3790542,3790542,9973869,6183327,6183327,488003,5695324,34,0
9976571,373,1,3745546,3745546,9976571,6231025,6231025,1888591,4342434,72,0
9998426,994,1,4062762,4062762,9998426,5935664,5935664,1894509,4041155,34,0
10053523,971,1,4062375,4062375,10053523,5991148,5991148,1946979,4044169,39,0
10124572,580,1,3756218,3756218,10124572,6368354,6368354,1977332,4391022,61,0
10297535,1038,1,4063292,4063292,10297535,6234243,6234243,2120120,4114123,38,0
10321751,112,4,3538257,3538257,10321751,6783494,6783494,515407,6268087,4,0
10334688,1054,1,4063600,4063600,10334688,6271088,6271088,1991101,4279987,17,0
10443229,1047,1,4063422,4063422,10443229,6379807,6379807,2099397,4280410,19,0
10509410,1060,1,4063638,4063638,10509410,6445772,6445772,2057282,4388490,20,0
10530208,626,1,3819993,3819993,10530208,6710215,6710215,2132617,4577598,45,0
10552038,1043,1,4063379,4063379,10552038,6488659,6488659,2099731,4388928,18,0
10554157,1042,1,4063361,4063361,10554157,6490796,6490796,2101904,4388892,19,0
10589729,334,1,3739980,3739980,10589729,6849749,6849749,2183581,4666168,69,0
10604972,889,1,3962457,3962457,10604972,6642515,6642515,2174144,4468371,62,0
10626924,744,1,3961053,3961053,10626924,6665871,6665871,2178553,4487318,91,0
10641573,743,1,3961039,3961039,10641573,6680534,6680534,2177237,4503297,97,0
10664069,706,1,3960680,3960680,10664069,6703389,6703389,2199940,4503449,100,0
10670362,862,1,3962197,3962197,10670362,6708165,6708165,2203165,4505000,55,0
10671818,688,1,3960553,3960553,10671818,6711265,6711265,2207442,4503823,77,0
10696024,1074,1,4082659,4082659,10696024,6613365,6613365,2227827,4385538,17,0
10763303,140,1,3569099,3569099,10763303,7194204,7194204,2302879,4891325,35,0
10776013,473,1,3746339,3746339,10776013,7029674,7029674,2247320,4782354,76,0
10801167,844,1,3962002,3962002,10801167,6839165,6839165,2262216,4576949,84,0
10805767,877,1,3962331,3962331,10805767,6843436,6843436,2260710,4582726,51,0
10847465,840,1,3961969,3961969,10847465,6885496,6885496,2311490,4574006,65,0
10853260,594,8,3784160,3784160,10853260,7069100,7069100,292505,6776595,27,0
10863571,731,1,3960909,3960909,10863571,6902662,6902662,2289633,4613029,81,0
10882546,589,1,3769663,3769663,10882546,7112883,7112883,2308390,4804493,65,0
11049355,116,1,3551333,3551333,11049355,7498022,7498022,2489792,5008230,37,0
11063616,549,1,3747023,3747023,11063616,7316593,7316593,2322822,4993771,88,0
11108677,751,1,3961091,3961091,11108677,7147586,7147586,2368222,4779364,84,0
11116039,481,1,3746422,3746422,11116039,7369617,7369617,2374247,4995370,81,0
11133248,55,2,2678400,2678400,11133248,8454848,8454848,1212966,7241882,11,0
11174880,566,1,3747311,3747311,11174880,7427569,7427569,2437352,4990217,90,0
11199531,533,1,3746899,3746899,11199531,7452632,7452632,2461582,4991050,80,0
11212911,750,1,3961082,3961082,11212911,7251829,7251829,2471575,4780254,83,0
11215343,892,1,3962498,3962498,11215343,7252845,7252845,2445471,4807374,88,0
11237935,767,1,3961236,3961236,11237935,7276699,7276699,2475448,4801251,75,0
11263915,829,1,3961866,3961866,11263915,7302049,7302049,2494567,4807482,85,0
11274072,813,1,3961718,3961718,11274072,7312354,7312354,2508330,4804024,65,0
11471817,315,4,3709672,3709672,11471817,7762145,7762145,831400,6930745,16,0
11481214,684,1,3960355,3960355,11481214,7520859,7520859,2531744,4989115,79,0
11483543,784,1,3961439,3961439,11483543,7522104,7522104,2512350,5009754,87,0
11484683,806,1,3961614,3961614,11484683,7523069,7523069,2513742,5009327,90,0
11487912,432,1,3746025,3746025,11487912,7741887,7741887,2527651,5214236,81,0
11490547,795,1,3961526,3961526,11490547,7529021,7529021,2519618,5009403,75,0
11491084,391,1,3745694,3745694,11491084,7745390,7745390,2542062,5203328,52,0
11492080,799,1,3961550,3961550,11492080,7530530,7530530,2521628,5008902,76,0
11502131,585,1,3769636,3769636,11502131,7732495,7732495,2553135,5179360,59,0
11503221,400,1,3745779,3745779,11503221,7757442,7757442,2544563,5212879,54,0
11507935,778,1,3961394,3961394,11507935,7546541,7546541,2539643,5006898,86,0
11534200,431,1,3746016,3746016,11534200,7788184,7788184,2573978,5214206,72,0
11534413,687,1,3960550,3960550,11534413,7573863,7573863,2586343,4987520,98,0
11535975,1087,4,4143882,4143882,11535975,7392093,7392093,660443,6731650,21,0
11556110,492,1,3746536,3746536,11556110,7809574,7809574,2606486,5203088,81,0
11558316,865,1,3962202,3962202,11558316,7596114,7596114,2590595,5005519,50,0
11575154,817,1,3961771,3961771,11575154,7613383,7613383,2604203,5009180,79,0
11577841,447,1,3746144,3746144,11577841,7831697,7831697,2630110,5201587,83,0
11603044,503,1,3746629,3746629,11603044,7856415,7856415,2655258,5201157,83,0
11610788,392,1,3745699,3745699,11610788,7865089,7865089,2663013,5202076,83,0
11639403,747,1,3961070,3961070,11639403,7678333,7678333,2681675,4996658,84,0
11642443,512,1,3746704,3746704,11642443,7895739,7895739,2684521,5211218,55,0
11713141,416,1,3745895,3745895,11713141,7967246,7967246,2752156,5215090,79,0
11713491,436,1,3746057,3746057,11713491,7967434,7967434,2752514,5214920,81,0
11735863,399,1,3745776,3745776,11735863,7990087,7990087,2777187,5212900,54,0
11757655,149,1,3574639,3574639,11757655,8183016,8183016,2806327,5376689,40,0
11854054,494,1,3746555,3746555,11854054,8107499,8107499,2874427,5233072,81,0
12005029,919,4,3968653,3968653,12005029,8036376,8036376,850215,7186161,27,0
12051695,24,1,2100304,2100304,12051695,9951391,9951391,2935599,7015792,24,0
12087154,521,1,3746777,3746777,12087154,8340377,8340377,2955997,5384380,84,0
12100617,53,1,2669418,2669418,12100617,9431199,9431199,2960191,6471008,37,0
12153564,374,1,3745556,3745556,12153564,8408008,8408008,3009810,5398198,81,0
12207066,355,1,3745366,3745366,12207066,8461700,8461700,3022413,5439287,88,0
12214244,350,1,3745314,3745314,12214244,8468930,8468930,3025506,5443424,86,0
12300651,418,1,3745914,3745914,12300651,8554737,8554737,3116122,5438615,69,0
12414847,1075,1,4085427,4085427,12414847,8329420,8329420,3162333,5167087,45,0
12423111,390,1,3745678,3745678,12423111,8677433,8677433,3124936,5552497,65,0
12455565,352,1,3745338,3745338,12455565,8710227,8710227,3156172,5554055,94,0
12585318,907,1,3962699,3962699,12585318,8622619,8622619,3301353,5321266,96,0
12599818,30,1,2454620,2454620,12599818,10145198,10145198,3238759,6906439,36,0
13100097,109,1,3510998,3510998,13100097,9589099,9589099,3803420,5785679,57,0
13106871,310,4,3702039,3702039,13106871,9404832,9404832,839295,8565537,22,0
13133824,873,1,3962292,3962292,13133824,9171532,9171532,3335573,5835959,76,0
13151421,563,1,3747308,3747308,13151421,9404113,9404113,3329744,6074369,107,0
13235070,945,1,3997223,3997223,13235070,9237847,9237847,3436404,5801443,57,0
13263068,543,1,3746977,3746977,13263068,9516091,9516091,3441797,6074294,110,0
13285931,843,1,3961996,3961996,13285931,9323935,9323935,3475586,5848349,95,0
13323551,643,1,3846746,3846746,13323551,9476805,9476805,3511935,5964870,47,0
13436479,696,1,3960615,3960615,13436479,9475864,9475864,3624774,5851090,100,0
13453764,836,1,3961935,3961935,13453764,9491829,9491829,3644205,5847624,99,0
13473890,332,1,3739856,3739856,13473890,9734034,9734034,3714077,6019957,79,0
13564152,121,1,3556468,3556468,13564152,10007684,10007684,3933612,6074072,27,0
14004056,460,1,3746251,3746251,14004056,10257805,10257805,4291802,5966003,89,0
14040753,952,8,3998825,3998825,14040753,10041928,10041928,537132,9504796,20,0
14069611,173,1,3598054,3598054,14069611,10471557,10471557,3978620,6492937,48,0
14130614,593,4,3778324,3778324,14130614,10352290,10352290,1096738,9255552,42,0
14144766,497,1,3746594,3746594,14144766,10398172,10398172,4053123,6345049,86,0
14239618,412,1,3745874,3745874,14239618,10493744,10493744,4150171,6343573,70,0
14408087,440,1,3746090,3746090,14408087,10661997,10661997,4319438,6342559,87,0
14456492,396,1,3745737,3745737,14456492,10710755,10710755,4365209,6345546,92,0
14751899,760,1,3961180,3961180,14751899,10790719,10790719,4718567,6072152,98,0
14790326,913,8,3963501,3963501,14790326,10826825,10826825,582783,10244042,26,0
14821138,522,1,3746783,3746783,14821138,11074355,11074355,4559007,6515348,91,0
15092436,853,1,3962087,3962087,15092436,11130349,11130349,4765160,6365189,76,0
15106175,762,1,3961187,3961187,15106175,11144988,11144988,4731613,6413375,94,0
15188512,634,1,3831777,3831777,15188512,11356735,11356735,4926221,6430514,57,0
15278580,92,1,3284451,3284451,15278580,11994129,11994129,5055027,6939102,19,0
15333192,758,1,3961161,3961161,15333192,11372031,11372031,4955829,6416202,96,0
15339833,748,1,3961071,3961071,15339833,11378762,11378762,4967871,6410891,96,0
15351134,573,1,3755066,3755066,15351134,11596068,11596068,5034821,6561247,50,0
15372888,728,1,3960899,3960899,15372888,11411989,11411989,4995253,6416736,105,0
15539901,1085,1,4094141,4094141,15539901,11445760,11445760,5165708,6280052,42,0
15622746,498,1,3746598,3746598,15622746,11876148,11876148,5306919,6569229,87,0
15669201,900,1,3962569,3962569,15669201,11706632,11706632,5261863,6444769,97,0
15755346,147,1,3574004,3574004,15755346,12181342,12181342,5363879,6817463,53,0
15801748,554,1,3747063,3747063,15801748,12054685,12054685,5362686,6691999,114,0
15976804,745,1,3961056,3961056,15976804,12015748,12015748,5527254,6488494,108,0
15979645,833,1,3961899,3961899,15979645,12017746,12017746,5386703,6631043,105,0
15987732,785,1,3961453,3961453,15987732,12026279,12026279,5393723,6632556,93,0
16098238,450,1,3746173,3746173,16098238,12352065,12352065,5501459,6850606,91,0
16129668,333,1,3739943,3739943,16129668,12389725,12389725,5564967,6824758,89,0
16160313,383,1,3745624,3745624,16160313,12414689,12414689,5563964,6850725,92,0
16161809,1076,1,4093902,4093902,16161809,12067907,12067907,5567546,6500361,54,0
16162854,948,1,3997939,3997939,16162854,12164915,12164915,5556738,6608177,58,0
16212447,824,1,3961825,3961825,16212447,12250622,12250622,5621845,6628777,90,0
16224923,72,1,3031681,3031681,16224923,13193242,13193242,5740552,7452690,47,0
16425385,704,1,3960669,3960669,16425385,12464716,12464716,5845623,6619093,114,0
16547116,591,4,3773175,3773175,16547116,12773941,12773941,1563902,11210039,45,0
16572432,357,1,3745374,3745374,16572432,12827058,12827058,5853553,6973505,98,0
16668078,528,1,3746843,3746843,16668078,12921235,12921235,5937373,6983862,106,0
16718705,559,1,3747107,3747107,16718705,12971598,12971598,5947234,7024364,82,0
16890080,571,1,3747840,3747840,16890080,13142240,13142240,6118487,7023753,75,0
16923030,74,1,3046805,3046805,16923030,13876225,13876225,6142703,7733522,45,0
16949503,501,1,3746618,3746618,16949503,13202885,13202885,6151123,7051762,86,0
16957419,471,1,3746330,3746330,16957419,13211089,13211089,6198586,7012503,99,0
16960760,468,1,3746306,3746306,16960760,13214454,13214454,6235855,6978599,87,0
16972690,558,1,3747098,3747098,16972690,13225592,13225592,6168003,7057589,82,0
17065926,547,1,3746999,3746999,17065926,13318927,13318927,6260589,7058338,108,0
17078018,172,1,3591558,3591558,17078018,13486460,13486460,6282639,7203821,55,0
17106215,461,1,3746260,3746260,17106215,13359955,13359955,6387769,6972186,95,0
17152152,444,1,3746127,3746127,17152152,13406025,13406025,6385263,7020762,75,0
17197861,405,1,3745817,3745817,17197861,13452044,13452044,6458295,6993749,78,0
17217943,1028,2,4063199,4063199,17217943,13154744,13154744,3227307,9927437,40,0
17276454,370,1,3745515,3745515,17276454,13530939,13530939,6478851,7052088,96,0
17310734,2,1,266566,266566,17310734,17044168,17044168,6619155,10425013,6,0
17418159,96,1,3366387,3366387,17418159,14051772,14051772,6721372,7330400,58,0
17455863,555,1,3747065,3747065,17455863,13708798,13708798,6509936,7198862,115,0
17614658,462,1,3746261,3746261,17614658,13868397,13868397,6669204,7199193,96,0
17764704,633,1,3831552,3831552,17764704,13933152,13933152,6818206,7114946,59,0
17905513,570,1,3747524,3747524,17905513,14157989,14157989,6959246,7198743,82,0
18038685,1019,2,4063114,4063114,18038685,13975571,13975571,3586885,10388686,48,0
18491617,182,4,3621198,3621198,18491617,14870419,14870419,2225474,12644945,24,0
19096489,32,4,2532635,2532635,19096489,16563854,16563854,2489323,14074531,13,0
19316855,920,1,3968929,3968929,19316855,15347926,15347926,7947946,7399980,86,0
19532779,137,1,3568406,3568406,19532779,15964373,15964373,7998041,7966332,57,0
19726187,135,1,3568044,3568044,19726187,16158143,16158143,8191889,7966254,35,0
19741859,1020,2,4063139,4063139,19741859,15678720,15678720,4422015,11256705,52,0
19942682,38,1,2592367,2592367,19942682,17350315,17350315,8845740,8504575,50,0
20239862,22,1,2084777,2084777,20239862,18155085,18155085,9158609,8996476,37,0
20394262,190,2,3630424,3630424,20394262,16763838,16763838,4772405,11991433,40,0
20464844,63,1,2948117,2948117,20464844,17516727,17516727,8991194,8525533,60,0
20551723,100,1,3383194,3383194,20551723,17168529,17168529,9159471,8009058,32,0
20667265,49,1,2635460,2635460,20667265,18031805,18031805,9701440,8330365,48,0
20963157,106,1,3509374,3509374,20963157,17453783,17453783,9435787,8017996,59,0
21026543,312,4,3704512,3704512,21026543,17322031,17322031,2521919,14800112,25,0
21470999,68,1,2987445,2987445,21470999,18483554,18483554,10130145,8353409,62,0
22047379,105,1,3509351,3509351,22047379,18538028,18538028,10650047,7887981,56,0
22051969,104,1,3502061,3502061,22051969,18549908,18549908,10657175,7892733,54,0
22101417,101,1,3389517,3389517,22101417,18711900,18711900,10709053,8002847,32,0
22739249,308,1,3679672,3679672,22739249,19059577,19059577,11324452,7735125,65,0
23275604,4,1,290070,290070,23275604,22985534,22985534,12267015,10718519,10,0
24275106,114,4,3539025,3539025,24275106,20736081,20736081,4038664,16697417,20,0
24726090,85,1,3148396,3148396,24726090,21577694,21577694,13373082,8204612,55,0
24761326,324,1,3726225,3726225,24761326,21035101,21035101,13374102,7660999,77,0
25110401,1073,8,4077849,4077849,25110401,21032552,21032552,1887957,19144595,38,0
25154552,265,1,3652759,3652759,25154552,21501793,21501793,13466854,8034939,60,0
25631150,76,1,3086290,3086290,25631150,22544860,22544860,14246308,8298552,53,0
25675415,62,1,2890966,2890966,25675415,22784449,22784449,14201269,8583180,65,0
25843883,21,1,2083781,2083781,25843883,23760102,23760102,14324958,9435144,41,0
26409194,1086,4,4138938,4138938,26409194,22270256,22270256,4435976,17834280,25,0
26415898,47,1,2631213,2631213,26415898,23784685,23784685,14699880,9084805,51,0
26735285,673,1,3927772,3927772,26735285,22807513,22807513,14347924,8459589,74,0
26826012,914,8,3963533,3963533,26826012,22862479,22862479,2070167,20792312,35,0
27160955,941,1,3987760,3987760,27160955,23173195,23173195,15230730,7942465,67,0
27538576,612,1,3790927,3790927,27538576,23747649,23747649,15142608,8605041,68,0
28222333,70,1,3000822,3000822,28222333,25221511,25221511,16842906,8378605,50,0
28542609,138,1,3568584,3568584,28542609,24974025,24974025,17014238,7959787,57,0
29098949,1027,2,4063194,4063194,29098949,25035755,25035755,9348874,15686881,50,0
29242926,306,1,3679667,3679667,29242926,25563259,25563259,17864343,7698916,67,0
30520915,91,1,3267762,3267762,30520915,27253153,27253153,19023661,8229492,57,0
30631505,921,2,3973578,3973578,30631505,26657927,26657927,9978370,16679557,73,0
30949570,89,1,3210667,3210667,30949570,27738903,27738903,19584888,8154015,50,0
31299399,639,1,3846677,3846677,31299399,27452722,27452722,18948178,8504544,62,0
31308767,73,1,3033601,3033601,31308767,28275166,28275166,19925489,8349677,58,0
32164791,640,1,3846717,3846717,32164791,28318074,28318074,19769446,8548628,62,0
32268665,0,1,0,0,32268665,32268665,32268665,20851471,11417194,9,0
33042601,329,1,3739720,3739720,33042601,29302881,29302881,21656673,7646208,85,0
33212912,624,1,3815608,3815608,33212912,29397304,29397304,20813720,8583584,71,0
33463758,623,1,3815527,3815527,33463758,29648231,29648231,21096071,8552160,70,0
34041609,97,2,3367379,3367379,34041609,30674230,30674230,14967382,15706848,47,0
34211141,102,1,3416286,3416286,34211141,30794855,30794855,22818842,7976013,37,0
34794235,7,1,1243820,1243820,34794235,33550415,33550415,23349695,10200720,18,0
34991858,56,1,2680341,2680341,34991858,32311517,32311517,23264406,9047111,58,0
35121621,8,1,1279491,1279491,35121621,33842130,33842130,24063917,9778213,19,0
35137069,25,1,2100307,2100307,35137069,33036762,33036762,24053628,8983134,41,0
35406609,71,1,3009876,3009876,35406609,32396733,32396733,24015404,8381329,50,0
36667741,54,1,2675408,2675408,36667741,33992333,33992333,24941724,9050609,55,0
37026814,98,1,3367585,3367585,37026814,33659229,33659229,25521013,8138216,34,0
37343034,330,1,3739756,3739756,37343034,33603278,33603278,24918138,8685140,91,0
37819834,1025,2,4063180,4063180,37819834,33756654,33756654,15549847,18206807,49,0
37974261,955,8,3999587,3999587,37974261,33974674,33974674,4819990,29154684,36,0
39346270,953,1,3999448,3999448,39346270,35346822,35346822,27421923,7924899,53,0
39534663,922,2,3973590,3973590,39534663,35561073,35561073,18108489,17452584,65,0
40440889,79,2,3110214,3110214,40440889,37330675,37330675,21276037,16054638,46,0
42032429,27,1,2274866,2274866,42032429,39757563,39757563,30947134,8810429,40,0
42800248,188,4,3630214,3630214,42800248,39170034,39170034,14850290,24319744,32,0
44829389,193,4,3637273,3637273,44829389,41192116,41192116,15323561,25868555,35,0
45700038,39,1,2593223,2593223,45700038,43106815,43106815,34066477,9040338,56,0
45860409,192,4,3637262,3637262,45860409,42223147,42223147,15969284,26253863,36,0
47169391,37,1,2592337,2592337,47169391,44577054,44577054,35546585,9030469,53,0
47931806,915,8,3963544,3963544,47931806,43968262,43968262,6976286,36991976,36,0
48930576,929,4,3980461,3980461,48930576,44950115,44950115,11243997,33706118,64,0
49472640,668,1,3927597,3927597,49472640,45545043,45545043,37085599,8459444,67,0
49701748,65,1,2950237,2950237,49701748,46751511,46751511,38227956,8523555,54,0
50639451,45,1,2597371,2597371,50639451,48042080,48042080,39018929,9023151,51,0
51161725,335,1,3740001,3740001,51161725,47421724,47421724,38771690,8650034,91,0
53586214,144,1,3572850,3572850,53586214,50013364,50013364,42050306,7963058,58,0
53677670,670,1,3927628,3927628,53677670,49750042,49750042,41290267,8459775,69,0
54165712,183,4,3622101,3622101,54165712,50543611,50543611,26818432,23725179,39,0
54982217,29,1,2449642,2449642,54982217,52532575,52532575,43898982,8633593,47,0
57317043,317,4,3710144,3710144,57317043,53606899,53606899,24415708,29191191,35,0
57371114,113,4,3539024,3539024,57371114,53832090,53832090,30125232,23706858,25,0
58718233,42,1,2595255,2595255,58718233,56122978,56122978,47101362,9021616,47,0
62423112,67,1,2964979,2964979,62423112,59458133,59458133,50949097,8509036,53,0
63973259,83,1,3147031,3147031,63973259,60826228,60826228,52621431,8204797,58,0
66588903,93,1,3348382,3348382,66588903,63240521,63240521,55085201,8155320,27,0
66625174,87,2,3197839,3197839,66625174,63427335,63427335,47258441,16168894,52,0
66837109,17,1,2003517,2003517,66837109,64833592,64833592,55311644,9521948,33,0
67543841,331,1,3739855,3739855,67543841,63803986,63803986,55161071,8642915,95,0
69715870,9,1,1362192,1362192,69715870,68353678,68353678,58660185,9693493,22,0
70233813,13,2,1537172,1537172,70233813,68696641,68696641,51092453,17604188,20,0
72989167,60,1,2777576,2777576,72989167,70211591,70211591,61262659,8948932,56,0
74883208,189,4,3630251,3630251,74883208,71252957,71252957,46517912,24735045,31,0
75036550,16,1,1896806,1896806,75036550,73139744,73139744,63540043,9599701,33,0
75066865,946,1,3997242,3997242,75066865,71069623,71069623,63143163,7926460,63,0
77102149,11,4,1487280,1487280,77102149,75614869,75614869,48789993,26824876,9,0
77637881,28,1,2449488,2449488,77637881,75188393,75188393,66554558,8633835,47,0
79742875,95,1,3360721,3360721,79742875,76382154,76382154,68245545,8136609,57,0
82377447,78,1,3106680,3106680,82377447,79270767,79270767,71028127,8242640,56,0
83467898,33,4,2532663,2532663,83467898,80935235,80935235,55542144,25393091,20,0
93548113,99,1,3376792,3376792,93548113,90171321,90171321,82041974,8129347,34,0
95341980,187,2,3629169,3629169,95341980,91712811,91712811,76079183,15633628,49,0
98592632,191,2,3633062,3633062,98592632,94959570,94959570,78684797,16274773,52,0
99206232,15,1,1559948,1559948,99206232,97646284,97646284,87716702,9929582,28,0
101378962,26,1,2113144,2113144,101378962,99265818,99265818,90290365,8975453,38,0
105756059,82,1,3129852,3129852,105756059,102626207,102626207,94404880,8221327,52,0
109015874,19,1,2026073,2026073,109015874,106989801,106989801,97520495,9469306,35,0
113947970,77,1,3086292,3086292,113947970,110861678,110861678,102601637,8260041,54,0
114217456,94,1,3360689,3360689,114217456,110856767,110856767,102720220,8136547,60,0
125417366,48,1,2635455,2635455,125417366,122781911,122781911,113704439,9077472,53,0
126774160,316,4,3709729,3709729,126774160,123064431,123064431,96902015,26162416,36,0
134090674,642,1,3846744,3846744,134090674,130243930,130243930,121733215,8510715,58,0
135485132,311,4,3704458,3704458,135485132,131780674,131780674,105992662,25788012,32,0
138054960,264,1,3652672,3652672,138054960,134402288,134402288,126521608,7880680,62,0
138268757,20,1,2026383,2026383,138268757,136242374,136242374,126772861,9469513,39,0
140108288,167,1,3579062,3579062,140108288,136529226,136529226,128579847,7949379,57,0
141668721,69,1,3000159,3000159,141668721,138668562,138668562,130289127,8379435,57,0
153174549,84,1,3148287,3148287,153174549,150026262,150026262,141823156,8203106,60,0
154847383,635,1,3831780,3831780,154847383,151015603,151015603,142447209,8568394,60,0
155657564,31,1,2486553,2486553,155657564,153171011,153171011,144569977,8601034,54,0
155709053,75,1,3046811,3046811,155709053,152662242,152662242,144321031,8341211,59,0
159555996,103,2,3473876,3473876,159555996,156082120,156082120,139962127,16119993,63,0
168697670,36,1,2592271,2592271,168697670,166105399,166105399,157115098,8990301,53,0
169903877,608,4,3787189,3787189,169903877,166116688,166116688,135004602,31112086,55,0
174231224,59,1,2770101,2770101,174231224,171461123,171461123,162504186,8956937,53,0
219565731,40,1,2593602,2593602,219565731,216972129,216972129,207940934,9031195,50,0
224644759,641,1,3846742,3846742,224644759,220798017,220798017,212286957,8511060,60,0
236845970,23,1,2097261,2097261,236845970,234748709,234748709,225766185,8982524,40,0
238757292,90,1,3257189,3257189,238757292,235500103,235500103,227417078,8083025,51,0
243367285,52,1,2669417,2669417,243367285,240697868,240697868,231657976,9039892,50,0
268302536,61,1,2877615,2877615,268302536,265424921,265424921,256828057,8596864,61,0
292637125,88,1,3210601,3210601,292637125,289426524,289426524,281284023,8142501,50,0
295090157,3,1,289185,289185,295090157,294800972,294800972,283640190,11160782,10,0
322088284,80,1,3129585,3129585,322088284,318958699,318958699,310738356,8220343,53,0
355605581,134,1,3567705,3567705,355605581,352037876,352037876,344216784,7821092,55,0
355683309,136,1,3568314,3568314,355683309,352114995,352114995,344160338,7954657,59,0
361856307,35,1,2580746,2580746,361856307,359275561,359275561,350760341,8515220,55,0
365067689,12,4,1494845,1494845,365067689,363572844,363572844,337686832,25886012,10,0
378554080,51,1,2663374,2663374,378554080,375890706,375890706,366808851,9081855,48,0
482293626,81,1,3129645,3129645,482293626,479163981,479163981,470937339,8226642,53,0
523695480,50,1,2663373,2663373,523695480,521032107,521032107,511974172,9057935,47,0
571324938,43,1,2595591,2595591,571324938,568729347,568729347,559707889,9021458,49,0
627866686,5,1,291876,291876,627866686,627574810,627574810,616413219,11161591,10,0
700669124,46,1,2614324,2614324,700669124,698054800,698054800,689045246,9009554,50,0
762383295,6,4,786808,786808,762383295,761596487,761596487,735215900,26380587,7,0
765711212,14,4,1537243,1537243,765711212,764173969,764173969,738323272,25850697,11,0
815924322,44,1,2597361,2597361,815924322,813326961,813326961,804303821,9023140,51,0
865741509,10,2,1452854,1452854,865741509,864288655,864288655,846515712,17772943,23,0
877948087,34,1,2532908,2532908,877948087,875415179,875415179,866864591,8550588,47,0
