time,job_id,num_gpu,submit_time,start_time,end_time,executed_time,JCT,duration,pending_time,preempt,promote
2621825,41,1,1945408,1945408,2621825,676417,676417,676417,0,0,0
2875091,58,1,2326954,2326954,2875091,548137,548137,548137,0,0,0
2895433,1,8,201694,201694,2895433,2693739,2693739,2693739,0,0,0
2932576,32,1,1943942,1943942,2932576,988634,988634,988634,0,0,0
3105119,55,8,2094682,2094682,3105119,1010437,1010437,1010437,0,0,0
3112940,24,1,1943873,1943873,3112940,1169067,1169067,1169067,0,0,0
3120200,57,1,2324998,2324998,3120200,795202,795202,795202,0,0,0
3141941,30,1,1943932,1943932,3141941,1198009,1198009,1198009,0,0,0
3184635,18,1,1943813,1943813,3184635,1240822,1240822,1240822,0,0,0
3219858,53,1,1945550,1945550,3219858,1274308,1274308,1274308,0,0,0
3278061,66,1,2348780,2348780,3278061,929281,929281,929281,0,0,0
3288611,86,1,2372731,2372731,3288611,915880,915880,915880,0,0,0
3301380,111,8,3236670,3253439,3301380,47941,64710,47941,16769,0,0
3356416,110,8,3235945,3235945,3356416,120471,120471,120471,0,0,0
3368457,64,1,2341345,2341345,3368457,1027112,1027112,1027112,0,0,0
3514168,116,8,3251613,3301380,3514168,212788,262555,212788,49767,0,0
3523350,122,8,3390490,3514168,3523350,9182,132860,9182,123678,0,0
3562103,126,8,3407887,3523350,3562103,38753,154216,38753,115463,0,0
3638762,112,8,3237153,3356416,3638762,282346,401609,282346,119263,0,0
3640074,133,8,3572938,3638762,3640074,1312,67136,1312,65824,0,0
3647030,140,8,3586358,3640074,3647030,6956,60672,6956,53716,0,0
3685767,124,8,3391008,3562103,3685767,123664,294759,123664,171095,0,0
3708663,144,8,3668447,3685767,3708663,22896,40216,22896,17320,0,0
3711539,141,8,3587038,3647030,3711539,64509,124501,64509,59992,0,0
3772206,148,8,3672188,3708663,3772206,63543,100018,63543,36475,0,0
3781653,147,8,3670526,3711539,3781653,70114,111127,70114,41013,0,0
3807895,156,8,3775871,3781653,3807895,26242,32024,26242,5782,0,0
3845886,151,8,3771896,3772206,3845886,73680,73990,73680,310,0,0
3912392,162,8,3831486,3845388,3912392,67004,80906,67004,13902,0,0
3915959,165,8,3852752,3912392,3915959,3567,63207,3567,59640,0,0
3948070,164,8,3845388,3845886,3948070,102184,102682,102184,498,0,0
3949882,130,8,3514096,3807895,3949882,141987,435786,141987,293799,0,0
3989856,174,8,3922206,3948070,3989856,41786,67650,41786,25864,0,0
4000881,170,4,3887819,3915959,4000881,84922,113062,84922,28140,0,0
4020260,177,4,3960923,3979177,4020260,41083,59337,41083,18254,0,0
4053823,195,4,4022105,4022238,4053823,31585,31718,31585,133,0,0
4055540,199,4,4038772,4053823,4055540,1717,16768,1717,15051,0,0
4061522,171,8,3892069,3949882,4061522,111640,169453,111640,57813,0,0
4104706,193,8,4011623,4061522,4104706,43184,93083,43184,49899,0,0
4159642,202,4,4072703,4104706,4159642,54936,86939,54936,32003,0,0
4195931,142,8,3602731,3989856,4195931,206075,593200,206075,387125,0,0
4232596,223,1,4225248,4225248,4232596,7348,7348,7348,0,0,0
4241015,188,8,3996027,4195931,4241015,45084,244988,45084,199904,0,0
4248009,256,4,4245994,4245994,4248009,2015,2015,2015,0,0,0
4262067,226,1,4225258,4225258,4262067,36809,36809,36809,0,0,0
4264351,257,4,4246023,4248009,4264351,16342,18328,16342,1986,0,0
4273073,259,4,4251434,4264351,4273073,8722,21639,8722,12917,0,0
4299989,224,1,4225252,4225252,4299989,74737,74737,74737,0,0,0
4316935,212,1,4099912,4099912,4316935,217023,217023,217023,0,0,0
4327923,251,1,4238583,4238583,4327923,89340,89340,89340,0,0,0
4347769,214,1,4100924,4100924,4347769,246845,246845,246845,0,0,0
4352030,194,8,4017576,4238576,4352030,113454,334454,113454,221000,0,0
4353617,225,1,4225255,4225255,4353617,128362,128362,128362,0,0,0
4353732,263,4,4302753,4352030,4353732,1702,50979,1702,49277,0,0
4364297,266,4,4305079,4352030,4364297,12267,59218,12267,46951,0,0
4364581,181,8,3993309,4241015,4364581,123566,371272,123566,247706,0,0
4365106,269,4,4363768,4364297,4365106,809,1338,809,529,0,0
4377895,265,4,4304374,4353732,4377895,24163,73521,24163,49358,0,0
4378951,258,4,4251430,4273073,4378951,105878,127521,105878,21643,0,0
4408015,264,1,4302787,4302787,4408015,105228,105228,105228,0,0,0
4439395,268,4,4322941,4364581,4439395,74814,116454,74814,41640,0,0
4447084,272,4,4394242,4439395,4447084,7689,52842,7689,45153,0,0
4455796,186,4,3994633,4000881,4455796,454915,461163,454915,6248,0,0
4471450,260,4,4253391,4364581,4471450,106869,218059,106869,111190,0,0
4486215,233,1,4238523,4238523,4486215,247692,247692,247692,0,0,0
4486226,238,1,4238539,4238539,4486226,247687,247687,247687,0,0,0
4486257,247,1,4238569,4238569,4486257,247688,247688,247688,0,0,0
4525198,275,8,4436304,4471450,4525198,53748,88894,53748,35146,0,0
4528525,286,4,4522984,4523905,4528525,4620,5541,4620,921,0,0
4531288,232,1,4238519,4238519,4531288,292769,292769,292769,0,0,0
4549375,235,1,4238529,4238529,4549375,310846,310846,310846,0,0,0
4556581,252,1,4238586,4238586,4556581,317995,317995,317995,0,0,0
4559841,283,4,4521634,4525198,4559841,34643,38207,34643,3564,0,0
4560737,228,1,4238506,4238506,4560737,322231,322231,322231,0,0,0
4606447,296,4,4531335,4556581,4606447,49866,75112,49866,25246,0,0
4611249,273,4,4414052,4447084,4611249,164165,197197,164165,33032,0,0
4611894,222,1,4225244,4225244,4611894,386650,386650,386650,0,0,0
4620925,198,4,4022238,4022238,4620925,598687,598687,598687,0,0,0
4630547,267,4,4308027,4365106,4630547,265441,322520,265441,57079,0,0
4630609,287,4,4523016,4525198,4630609,105411,107593,105411,2182,0,0
4634968,280,4,4507993,4528525,4634968,106443,126975,106443,20532,0,0
4649850,301,4,4570131,4606447,4649850,43403,79719,43403,36316,0,0
4689146,200,4,4072661,4104706,4689146,584440,616485,584440,32045,0,0
4700564,285,4,4522932,4559841,4700564,140723,177632,140723,36909,0,0
4753659,315,4,4748327,4751993,4753659,1666,5332,1666,3666,0,0
4794100,221,1,4225241,4225241,4794100,568859,568859,568859,0,0,0
4810394,310,4,4710506,4753084,4810394,57310,99888,57310,42578,0,0
4885739,305,4,4710424,4753659,4885739,132080,175315,132080,43235,0,0
4899620,289,4,4523905,4611249,4899620,288371,375715,288371,87344,0,0
4967655,290,4,4524134,4620925,4967655,346730,443521,346730,96791,0,0
4992014,309,4,4710499,4810394,4992014,181620,281515,181620,99895,0,0
5080229,341,1,5078427,5078427,5080229,1802,1802,1802,0,0,0
5081034,347,1,5078631,5078631,5081034,2403,2403,2403,0,0,0
5081855,343,1,5078491,5078491,5081855,3364,3364,3364,0,0,0
5106865,332,1,5060944,5060944,5106865,45921,45921,45921,0,0,0
5108605,299,4,4570061,4630547,5108605,478058,538544,478058,60486,0,0
5108805,346,1,5078599,5078599,5108805,30206,30206,30206,0,0,0
5127616,339,1,5078331,5078331,5127616,49285,49285,49285,0,0,0
5147367,300,4,4570110,4630609,5147367,516758,577257,516758,60499,0,0
5151552,354,1,5147893,5147893,5151552,3659,3659,3659,0,0,0
5151610,356,1,5147961,5147961,5151610,3649,3649,3649,0,0,0
5151763,353,1,5147866,5147866,5151763,3897,3897,3897,0,0,0
5160717,344,1,5078533,5078533,5160717,82184,82184,82184,0,0,0
5177593,304,8,4688734,5176435,5177593,1158,488859,1158,487701,0,0
5177902,363,1,5176427,5176427,5177902,1475,1475,1475,0,0,0
5190267,321,8,4856485,5177593,5190267,12674,333782,12674,321108,0,0
5218899,288,4,4523114,4634968,5218899,583931,695785,583931,111854,0,0
5221474,364,1,5176435,5176435,5221474,45039,45039,45039,0,0,0
5223216,328,8,4974958,5190267,5223216,32949,248258,32949,215309,0,0
5274303,367,8,5214587,5223216,5274303,51087,59716,51087,8629,0,0
5308493,394,1,5306114,5306114,5308493,2379,2379,2379,0,0,0
5309685,361,1,5176420,5176420,5309685,133265,133265,133265,0,0,0
5319183,389,1,5305167,5305167,5319183,14016,14016,14016,0,0,0
5320503,395,1,5306185,5306185,5320503,14318,14318,14318,0,0,0
5323908,342,1,5078461,5078461,5323908,245447,245447,245447,0,0,0
5334222,404,1,5331943,5331943,5334222,2279,2279,2279,0,0,0
5334799,384,4,5303127,5304303,5334799,30496,31672,30496,1176,0,0
5335968,382,4,5303075,5304384,5335968,31584,32893,31584,1309,0,0
5341717,307,4,4710486,4885739,5341717,455978,631231,455978,175253,0,0
5343826,359,1,5148078,5148078,5343826,195748,195748,195748,0,0,0
5353054,360,1,5172053,5172053,5353054,181001,181001,181001,0,0,0
5353429,386,1,5304384,5304384,5353429,49045,49045,49045,0,0,0
5362889,313,8,4721206,5274303,5362889,88586,641683,88586,553097,0,0
5365711,335,1,5066231,5066231,5365711,299480,299480,299480,0,0,0
5368166,398,1,5309936,5309936,5368166,58230,58230,58230,0,0,0
5377458,362,1,5176424,5176424,5377458,201034,201034,201034,0,0,0
5379816,385,4,5304303,5304384,5379816,75432,75513,75432,81,0,0
5382654,397,1,5309886,5309886,5382654,72768,72768,72768,0,0,0
5390949,407,4,5365237,5379816,5390949,11133,25712,11133,14579,0,0
5392566,369,1,5219928,5219928,5392566,172638,172638,172638,0,0,0
5409996,314,8,4721246,5288603,5409996,121393,688750,121393,567357,0,0
5418728,406,4,5363283,5363283,5418728,55445,55445,55445,0,0,0
5423111,409,4,5367404,5390949,5423111,32162,55707,32162,23545,0,0
5429226,38,1,1945158,1945158,5429226,3484068,3484068,3484068,0,0,0
5432107,358,1,5148051,5148051,5432107,284056,284056,284056,0,0,0
5437921,270,8,4388907,5304995,5437921,132926,1049014,132926,916088,0,0
5447738,189,8,3996109,5306114,5447738,141624,1451629,141624,1310005,0,0
5458855,387,1,5304995,5304995,5458855,153860,153860,153860,0,0,0
5463279,388,1,5305025,5305025,5463279,158254,158254,158254,0,0,0
5469586,426,1,5448992,5448992,5469586,20594,20594,20594,0,0,0
5485422,329,8,4974991,5335968,5485422,149454,510431,149454,360977,0,0
5489275,345,1,5078566,5078566,5489275,410709,410709,410709,0,0,0
5493130,415,4,5381638,5409996,5493130,83134,111492,83134,28358,0,0
5501267,413,1,5379404,5379404,5501267,121863,121863,121863,0,0,0
5510765,255,4,4243885,4377895,5510765,1132870,1266880,1132870,134010,0,0
5532205,372,8,5281861,5362889,5532205,169316,250344,169316,81028,0,0
5545288,375,4,5284972,5284972,5545288,260316,260316,260316,0,0,0
5556523,414,4,5381592,5409996,5556523,146527,174931,146527,28404,0,0
5558313,320,4,4753084,4899620,5558313,658693,805229,658693,146536,0,0
5563294,429,4,5539973,5545288,5563294,18006,23321,18006,5315,0,0
5580720,410,4,5367428,5418728,5580720,161992,213292,161992,51300,0,0
5601392,295,4,4531328,4649850,5601392,951542,1070064,951542,118522,0,0
5638976,352,1,5137187,5137187,5638976,501789,501789,501789,0,0,0
5657451,435,4,5569206,5580720,5657451,76731,88245,76731,11514,0,0
5666685,191,8,4002150,5447738,5666685,218947,1664535,218947,1445588,0,0
5668970,340,1,5078371,5078371,5668970,590599,590599,590599,0,0,0
5674647,376,4,5284976,5284986,5674647,389661,389671,389661,10,0,0
5681018,454,1,5661691,5661691,5681018,19327,19327,19327,0,0,0
5684769,403,1,5330994,5330994,5684769,353775,353775,353775,0,0,0
5685740,355,1,5147921,5147921,5685740,537819,537819,537819,0,0,0
5687508,445,4,5652948,5657451,5687508,30057,34560,30057,4503,0,0
5687588,451,8,5655938,5666685,5687588,20903,31650,20903,10747,0,0
5689332,433,4,5565210,5601392,5689332,87940,124122,87940,36182,0,0
5699600,408,4,5365278,5423111,5699600,276489,334322,276489,57833,0,0
5705457,421,4,5427880,5437921,5705457,267536,277577,267536,10041,0,0
5707201,243,1,4238556,4238556,5707201,1468645,1468645,1468645,0,0,0
5718341,338,8,5078194,5485422,5718341,232919,640147,232919,407228,0,0
5729940,443,8,5628790,5687508,5729940,42432,101150,42432,58718,0,0
5730480,476,1,5729137,5729137,5730480,1343,1343,1343,0,0,0
5730973,477,1,5729215,5729215,5730973,1758,1758,1758,0,0,0
5735974,484,1,5735206,5735206,5735974,768,768,768,0,0,0
5741381,470,4,5709256,5709293,5741381,32088,32125,32088,37,0,0
5742977,434,8,5569193,5687588,5742977,55389,173784,55389,118395,0,0
5747758,457,4,5690742,5699600,5747758,48158,57016,48158,8858,0,0
5750628,475,1,5726501,5726501,5750628,24127,24127,24127,0,0,0
5757142,479,1,5729899,5729899,5757142,27243,27243,27243,0,0,0
5762795,459,1,5699161,5699161,5762795,63634,63634,63634,0,0,0
5777073,366,8,5214473,5532205,5777073,244868,562600,244868,317732,0,0
5787439,474,1,5718484,5718484,5787439,68955,68955,68955,0,0,0
5787448,478,1,5729250,5729250,5787448,58198,58198,58198,0,0,0
5793378,399,1,5309965,5309965,5793378,483413,483413,483413,0,0,0
5804579,480,4,5735148,5741381,5804579,63198,69431,63198,6233,0,0
5807111,467,1,5704346,5704346,5807111,102765,102765,102765,0,0,0
5815158,432,8,5562718,5729940,5815158,85218,252440,85218,167222,0,0
5846309,318,4,4748606,4967655,5846309,878654,1097703,878654,219049,0,0
5848154,504,4,5820527,5832079,5848154,16075,27627,16075,11552,0,0
5850512,396,1,5306224,5306224,5850512,544288,544288,544288,0,0,0
5856682,490,4,5789711,5804579,5856682,52103,66971,52103,14868,0,0
5867785,513,1,5865216,5865216,5867785,2569,2569,2569,0,0,0
5872600,507,1,5832079,5832079,5872600,40521,40521,40521,0,0,0
5873420,423,4,5427893,5437921,5873420,435499,445527,435499,10028,0,0
5875066,472,4,5709293,5718341,5875066,156725,165773,156725,9048,0,0
5875085,486,8,5758806,5777073,5875085,98012,116279,98012,18267,0,0
5876617,505,8,5826341,5875085,5876617,1532,50276,1532,48744,0,0
5878368,520,1,5872774,5872774,5878368,5594,5594,5594,0,0,0
5882568,303,4,4680987,4689146,5882568,1193422,1201581,1193422,8159,0,0
5886544,515,4,5865263,5865263,5886544,21281,21281,21281,0,0,0
5890138,380,4,5284995,5284995,5890138,605143,605143,605143,0,0,0
5898854,523,4,5875152,5876617,5898854,22237,23702,22237,1465,0,0
5902852,514,4,5865253,5873420,5902852,29432,37599,29432,8167,0,0
5903232,493,4,5799377,5815158,5903232,88074,103855,88074,15781,0,0
5908199,500,4,5809095,5815158,5908199,93041,99104,93041,6063,0,0
5910789,530,4,5904197,5906942,5910789,3847,6592,3847,2745,0,0
5922129,516,4,5868672,5875066,5922129,47063,53457,47063,6394,0,0
5960135,529,4,5904192,5906977,5960135,53158,55943,53158,2785,0,0
5961241,512,1,5865204,5865204,5961241,96037,96037,96037,0,0,0
5975388,179,4,3979177,4002172,5975388,1973216,1996211,1973216,22995,0,0
5981006,424,4,5428226,5489275,5981006,491731,552780,491731,61049,0,0
5983810,551,1,5971016,5971016,5983810,12794,12794,12794,0,0,0
5987065,196,4,4022127,4055540,5987065,1931525,1964938,1931525,33413,1,0
6002546,532,8,5906977,5960135,6002546,42411,95569,42411,53158,0,0
6011320,552,1,5975373,5975373,6011320,35947,35947,35947,0,0,0
6015302,556,1,5983209,5983209,6015302,32093,32093,32093,0,0,0
6016243,496,4,5799681,5839200,6016243,177043,216562,177043,39519,0,0
6036178,495,4,5799426,5846215,6036178,189963,236752,189963,46789,0,0
6043604,416,4,5390064,5493130,6043604,550474,653540,550474,103066,0,0
6045549,531,8,5906942,5981006,6045549,64543,138607,64543,74064,0,0
6051120,487,4,5778243,5846309,6051120,204811,272877,204811,68066,0,0
6053443,468,1,5704825,5704825,6053443,348618,348618,348618,0,0,0
6056359,456,4,5690721,5690721,6056359,365638,365638,365638,0,0,0
6063690,511,1,5846215,5846215,6063690,217475,217475,217475,0,0,0
6079919,560,4,6045036,6045549,6079919,34370,34883,34370,513,0,0
6081057,569,1,6057618,6057618,6081057,23439,23439,23439,0,0,0
6082230,541,1,5920902,5920902,6082230,161328,161328,161328,0,0,0
6084793,544,1,5966578,5966578,6084793,118215,118215,118215,0,0,0
6085213,565,1,6050552,6050552,6085213,34661,34661,34661,0,0,0
6093618,419,4,5399324,5510765,6093618,582853,694294,582853,111441,0,0
6097683,553,1,5983198,5983198,6097683,114485,114485,114485,0,0,0
6121607,568,1,6050566,6050566,6121607,71041,71041,71041,0,0,0
6126702,525,4,5879609,5882568,6126702,244134,247093,244134,2959,0,0
6129038,357,1,5148023,5148023,6129038,981015,981015,981015,0,0,0
6146523,464,4,5702763,5705457,6146523,441066,443760,441066,2694,0,0
6160286,483,4,5735159,5742977,6160286,417309,425127,417309,7818,0,0
6160603,567,1,6050559,6050559,6160603,110044,110044,110044,0,0,0
6167523,561,1,6050364,6050364,6167523,117159,117159,117159,0,0,0
6191472,528,4,5904060,5908199,6191472,283273,287412,283273,4139,0,0
6194793,542,1,5930372,5930372,6194793,264421,264421,264421,0,0,0
6197456,550,1,5971012,5971012,6197456,226444,226444,226444,0,0,0
6202026,465,4,5703486,5707201,6202026,494825,498540,494825,3715,0,0
6209541,524,4,5877516,5886544,6209541,322997,332025,322997,9028,0,0
6215732,535,4,5918849,5918849,6215732,296883,296883,296883,0,0,0
6220641,444,8,5628842,6002546,6220641,218095,591799,218095,373704,0,0
6229575,446,4,5652958,5674647,6229575,554928,576617,554928,21689,0,0
6257532,549,1,5970067,5970067,6257532,287465,287465,287465,0,0,0
6268227,337,8,5078173,6016243,6268227,251984,1190054,251984,938070,0,0
6272657,557,1,6011425,6011425,6272657,261232,261232,261232,0,0,0
6272855,577,4,6243133,6246689,6272855,26166,29722,26166,3556,0,0
6295940,583,1,6294558,6294558,6295940,1382,1382,1382,0,0,0
6296534,510,1,5844749,5844749,6296534,451785,451785,451785,0,0,0
6307705,312,8,4721038,6043604,6307705,264101,1586667,264101,1322566,0,0
6323308,584,1,6297078,6297078,6323308,26230,26230,26230,0,0,0
6323600,587,1,6297090,6297090,6323600,26510,26510,26510,0,0,0
6326177,205,8,4098808,6056359,6326177,269818,2227369,269818,1957551,0,0
6330739,592,1,6302344,6302344,6330739,28395,28395,28395,0,0,0
6330918,412,1,5379332,5379332,6330918,951586,951586,951586,0,0,0
6347200,579,4,6246704,6247024,6347200,100176,100496,100176,320,0,0
6350249,597,1,6307819,6307819,6350249,42430,42430,42430,0,0,0
6352176,497,4,5800140,5848154,6352176,504022,552036,504022,48014,0,0
6363335,582,4,6247207,6268227,6363335,95108,116128,95108,21020,0,0
6386501,425,4,5428233,5556523,6386501,829978,958268,829978,128290,0,0
6386561,581,4,6247024,6268227,6386561,118334,139537,118334,21203,0,0
6396385,575,8,6135933,6160286,6396385,236099,260452,236099,24353,0,0
6422043,117,8,3253439,6126702,6422043,295341,3168604,295341,2873263,0,0
6454965,519,4,5871041,5876617,6454965,578348,583924,578348,5576,0,0
6491584,636,1,6489790,6489790,6491584,1794,1794,1794,0,0,0
6496678,570,1,6058023,6058023,6496678,438655,438655,438655,0,0,0
6502236,411,4,5367449,5558313,6502236,943923,1134787,943923,190864,1,0
6505297,522,4,5875152,5890138,6505297,615159,630145,615159,14986,0,0
6532707,566,1,6050556,6050556,6532707,482151,482151,482151,0,0,0
6533794,401,8,5321027,6215732,6533794,318062,1212767,318062,894705,0,0
6536994,665,1,6534521,6534521,6536994,2473,2473,2473,0,0,0
6538731,644,1,6495804,6495804,6538731,42927,42927,42927,0,0,0
6543323,656,4,6510635,6510635,6543323,32688,32688,32688,0,0,0
6543592,640,1,6495588,6495588,6543592,48004,48004,48004,0,0,0
6546223,591,1,6302340,6302340,6546223,243883,243883,243883,0,0,0
6551071,159,8,3817978,6220641,6551071,330430,2733093,330430,2402663,0,0
6556119,578,4,6246689,6272855,6556119,283264,309430,283264,26166,0,0
6563504,586,1,6297086,6297086,6563504,266418,266418,266418,0,0,0
6574640,428,4,5475741,5563294,6574640,1011346,1098899,944478,154421,8,0
6575394,509,1,5840101,5840101,6575394,735293,735293,735293,0,0,0
6581045,622,1,6482589,6482589,6581045,98456,98456,98456,0,0,0
6582273,620,1,6482580,6482580,6582273,99693,99693,99693,0,0,0
6585497,639,1,6495516,6495516,6585497,89981,89981,89981,0,0,0
6589776,506,1,5831497,5831497,6589776,758279,758279,758279,0,0,0
6594585,521,1,5873137,5873137,6594585,721448,721448,721448,0,0,0
6597177,649,4,6509153,6533794,6597177,63383,88024,63383,24641,0,0
6597816,660,4,6510883,6533794,6597816,64022,86933,64022,22911,0,0
6616196,675,4,6597402,6597816,6616196,18380,18794,18380,414,0,0
6628837,671,4,6596579,6597177,6628837,31660,32258,31660,598,0,0
6629232,603,1,6435044,6435044,6629232,194188,194188,194188,0,0,0
6633403,590,1,6302336,6302336,6633403,331067,331067,331067,0,0,0
6645349,192,8,4002172,6307705,6645349,337644,2643177,337644,2305533,0,0
6647007,645,1,6495809,6495809,6647007,151198,151198,151198,0,0,0
6651498,613,1,6477896,6477896,6651498,173602,173602,173602,0,0,0
6652785,669,4,6588893,6616196,6652785,36589,63892,36589,27303,0,0
6656493,617,1,6477916,6477916,6656493,178577,178577,178577,0,0,0
6667508,672,4,6596586,6628837,6667508,38671,70922,38671,32251,0,0
6686995,638,1,6495511,6495511,6686995,191484,191484,191484,0,0,0
6692421,650,4,6509168,6543323,6692421,149098,183253,149098,34155,0,0
6697272,427,1,5449015,5449015,6697272,1248257,1248257,1248257,0,0,0
6704821,215,8,4117439,6326177,6704821,378644,2587382,378644,2208738,0,0
6732656,637,1,6489880,6489880,6732656,242776,242776,242776,0,0,0
6738766,125,8,3407881,6352176,6738766,386590,3330885,386590,2944295,0,0
6755619,482,4,5735156,5747758,6755619,1007861,1020463,854323,166140,21,0
6761515,676,4,6605282,6645349,6761515,116166,156233,116166,40067,0,0
6773349,621,1,6482584,6482584,6773349,290765,290765,290765,0,0,0
6776720,237,1,4238536,4238536,6776720,2538184,2538184,2538184,0,0,0
6799837,348,8,5078919,6386501,6799837,413336,1720918,413336,1307582,0,0
6813281,635,1,6489786,6489786,6813281,323495,323495,323495,0,0,0
6847767,576,1,6177711,6177711,6847767,670056,670056,670056,0,0,0
6946895,670,8,6590711,6704821,6946895,242074,356184,242074,114110,0,0
6973870,674,4,6597372,6645349,6973870,328521,376498,328521,47977,0,0
7006332,588,1,6297659,6297659,7006332,708673,708673,708673,0,0,0
7008397,652,4,6509211,6551071,7008397,457326,499186,457326,41860,0,0
7023797,627,1,6482616,6482616,7023797,541181,541181,541181,0,0,0
7029739,489,4,5784307,6093618,7029739,936121,1245432,885114,360318,4,0
7053860,598,1,6307824,6307824,7053860,746036,746036,746036,0,0,0
7056989,680,4,6636543,6652785,7056989,404204,420446,404204,16242,0,0
7060422,589,1,6302332,6302332,7060422,758090,758090,758090,0,0,0
7069741,651,4,6509186,6551071,7069741,518670,560555,518670,41885,0,0
7093951,402,8,5321274,6396385,7093951,697566,1772677,454388,1318289,1,0
7122199,653,4,6509232,6556119,7122199,566080,612967,566080,46887,0,0
7145035,658,4,6510870,6574640,7145035,570395,634165,570395,63770,0,0
7173039,373,1,5284155,5284155,7173039,1888884,1888884,1888884,0,0,0
7199045,585,1,6297083,6297083,7199045,901962,901962,901962,0,0,0
7203324,614,1,6477901,6477901,7203324,725423,725423,725423,0,0,0
7209870,615,1,6477905,6477905,7209870,731965,731965,731965,0,0,0
7214602,629,1,6483616,6483616,7214602,730986,730986,730986,0,0,0
7215210,679,4,6636534,6667508,7215210,547702,578676,547702,30974,0,0
7253868,106,8,3182305,6422043,7253868,831825,4071563,467075,3604488,1,0
7268948,697,4,7221212,7253868,7268948,15080,47736,15080,32656,0,0
7273105,711,4,7244608,7253868,7273105,19237,28497,19237,9260,0,0
7276919,548,1,5968127,5968127,7276919,1308792,1308792,1308792,0,0,0
7290458,713,4,7247378,7268948,7290458,21510,43080,21510,21570,0,0
7291887,716,4,7278253,7290458,7291887,1429,13634,1429,12205,0,0
7294933,715,4,7256318,7273105,7294933,21828,38615,21828,16787,0,0
7314517,708,1,7229878,7229878,7314517,84639,84639,84639,0,0,0
7319837,702,1,7229858,7229858,7319837,89979,89979,89979,0,0,0
7320220,703,1,7229861,7229861,7320220,90359,90359,90359,0,0,0
7372682,725,4,7363664,7370217,7372682,2465,9018,2465,6553,0,0
7375780,724,4,7363367,7372682,7375780,3098,12413,3098,9315,0,0
7377411,717,4,7282240,7291887,7377411,85524,95171,85524,9647,0,0
7397411,719,4,7359724,7375780,7397411,21631,37687,21631,16056,0,0
7406699,721,4,7361616,7377411,7406699,29288,45083,29288,15795,0,0
7439429,726,4,7365656,7397411,7439429,42018,73773,42018,31755,0,0
7448699,438,8,5577140,6946895,7448699,501804,1871559,501804,1369755,0,0
7449632,729,4,7369089,7406699,7449632,42933,80543,42933,37610,0,0
7452093,641,1,6495592,6495592,7452093,956501,956501,956501,0,0,0
7455776,630,1,6483622,6483622,7455776,972154,972154,972154,0,0,0
7468345,231,1,4238516,4238516,7468345,3229829,3229829,3229829,0,0,0
7484894,685,8,6996605,7093951,7484894,390943,488289,390943,97346,0,0
7510270,722,4,7361741,7439429,7510270,70841,148529,70841,77688,0,0
7521518,466,4,5703986,6202026,7521518,1319492,1817532,1011021,806511,8,0
7525323,723,4,7363337,7448699,7525323,76624,161986,76624,85362,0,0
7531932,730,4,7369337,7448699,7531932,83233,162595,83233,79362,0,0
7550078,720,4,7359778,7449632,7550078,100446,190300,100446,89854,0,0
7631053,738,1,7619099,7619099,7631053,11954,11954,11954,0,0,0
7653638,595,1,6307812,6307812,7653638,1345826,1345826,1345826,0,0,0
7682973,736,1,7556319,7556319,7682973,126654,126654,126654,0,0,0
7686423,700,4,7223190,7294933,7686423,391490,463233,391490,71743,0,0
7714793,377,4,5284981,5284990,7714793,2429803,2429812,1077411,1352401,23,0
7743852,727,4,7365942,7484894,7743852,258958,377910,258958,118952,0,0
7753173,47,1,1945499,1945499,7753173,5807674,5807674,5807674,0,0,0
7798666,22,1,1943851,1943851,7798666,5854815,5854815,5854815,0,0,0
7859339,463,4,5702741,6761515,7859339,1097824,2156598,1097824,1058774,0,0
7878804,753,1,7869565,7869565,7878804,9239,9239,9239,0,0,0
7927167,712,4,7244616,7484894,7927167,442273,682551,442273,240278,0,0
7927669,741,8,7651115,7927167,7927669,502,276554,502,276052,0,0
7929049,756,8,7912457,7927669,7929049,1380,16592,1380,15212,0,0
7931307,749,8,7794273,7929049,7931307,2258,137034,2258,134776,0,0
7938168,740,8,7651017,7931307,7938168,6861,287151,6861,280290,0,0
7945749,746,8,7788414,7938168,7945749,7581,157335,7581,149754,0,0
7955543,701,1,7229854,7229854,7955543,725689,725689,725689,0,0,0
7972036,755,8,7911435,7945749,7972036,26287,60601,26287,34314,0,0
8000548,739,8,7651010,7972036,8000548,28512,349538,28512,321026,0,0
8006964,761,8,7989607,8000548,8006964,6416,17357,6416,10941,0,0
8034090,698,4,7221218,7510270,8034090,523820,812872,523820,289052,0,0
8038937,759,8,7967407,8006964,8038937,31973,71530,31973,39557,0,0
8075731,731,4,7370217,7521518,8075731,554213,705514,554213,151301,0,0
8081327,752,8,7819776,8038937,8081327,42390,261551,42390,219161,0,0
8107793,623,1,6482594,6482594,8107793,1625199,1625199,1625199,0,0,0
8130839,422,4,5427889,6973870,8130839,1156969,2702950,1156969,1545981,0,0
8134932,757,8,7914914,8075731,8134932,59201,220018,59201,160817,0,0
8136103,699,4,7223150,7525323,8136103,610780,912953,610780,302173,0,0
8154798,775,8,8123816,8130839,8154798,23959,30982,23959,7023,0,0
8159647,777,8,8143698,8154798,8159647,4849,15949,4849,11100,0,0
8165849,771,8,8083275,8134932,8165849,30917,82574,30917,51657,0,0
8166702,782,8,8152202,8159647,8166702,7055,14500,7055,7445,0,0
8175231,648,4,6509134,7008397,8175231,1166834,1666097,1166834,499263,0,0
8179192,781,8,8151887,8165849,8179192,13343,27305,13343,13962,0,0
8194588,783,8,8167016,8175231,8194588,19357,27572,19357,8215,0,0
8225655,779,8,8148661,8166702,8225655,58953,76994,58953,18041,0,0
8225877,742,8,7651118,8081327,8225877,144550,574759,144550,430209,0,0
8236738,185,4,3994609,4017576,8236738,4219162,4242129,2494418,1747711,1,0
8241532,780,8,8151835,8179192,8241532,62340,89697,62340,27357,0,0
8245963,647,1,6505672,6505672,8245963,1740291,1740291,1740291,0,0,0
8251010,787,8,8242117,8245963,8251010,5047,8893,5047,3846,0,0
8272221,788,8,8242131,8251010,8272221,21211,30090,21211,8879,0,0
8279907,681,4,6707833,7056989,8279907,1222918,1572074,1222918,349156,0,0
8282594,607,1,6435097,6435097,8282594,1847497,1847497,1847497,0,0,0
8315576,417,4,5399276,7069741,8315576,1245835,2916300,1245835,1670465,0,0
8356574,768,8,8055044,8194588,8356574,161986,301530,161986,139544,0,0
8366010,786,8,8242114,8272221,8366010,93789,123896,93789,30107,0,0
8371397,633,1,6486730,6486730,8371397,1884667,1884667,1884667,0,0,0
8371610,661,4,6510890,7122199,8371610,1249411,1860720,1249411,611309,0,0
8373013,374,1,5284184,5284184,8373013,3088829,3088829,3088829,0,13,0
8404272,378,4,5284986,7145035,8404272,1259237,3119286,1259237,1860049,0,0
8405523,600,1,6314498,6314498,8405523,2091025,2091025,2091025,0,0,0
8426248,766,8,8051903,8225655,8426248,200593,374345,200593,173752,0,0
8430690,747,8,7789076,8225877,8430690,204813,641614,204813,436801,0,0
8441716,709,1,7233791,7233791,8441716,1207925,1207925,1207925,0,0,0
8453173,695,8,7217520,8241532,8453173,211641,1235653,211641,1024012,0,0
8453950,643,1,6495756,6495756,8453950,1958194,1958194,1958194,0,0,0
8468170,593,1,6307598,6307598,8468170,2160572,2160572,2160572,0,0,0
8469670,673,4,6596601,7209870,8469670,1259800,1873069,1259800,613269,0,0
8473082,562,1,6050367,6050367,8473082,2422715,2422715,2422715,0,1,0
8487115,246,1,4238566,4238566,8487115,4248549,4248549,4248549,0,35,0
8504476,790,8,8398984,8426248,8504476,78228,105492,78228,27264,0,0
8520713,793,8,8434461,8453173,8520713,67540,86252,67540,18712,0,0
8534444,743,8,7670655,8315576,8534444,218868,863789,218868,644921,0,0
8581365,744,8,7670658,8356574,8581365,224791,910707,224791,685916,0,0
8608368,765,8,8051849,8366010,8608368,242358,556519,242358,314161,0,0
8620129,798,8,8493846,8493852,8620129,126277,126283,126277,6,0,0
8650647,692,8,7186665,8371610,8650647,279037,1463982,279037,1184945,0,0
8676635,659,4,6510876,7215210,8676635,1461425,2165759,1299710,866049,1,0
8686578,792,8,8434457,8473082,8686578,213496,252121,213496,38625,0,0
8689018,808,8,8680077,8686578,8689018,2440,8941,2440,6501,0,0
8717841,748,8,7792122,8430690,8717841,287151,925719,287151,638568,0,0
8718638,810,8,8689418,8717841,8718638,797,29220,797,28423,0,0
8723173,812,8,8690431,8718638,8723173,4535,32742,4535,28207,0,0
8739110,728,4,7365955,7550078,8739110,1189032,1373155,1189032,184123,0,0
8801624,751,8,7819773,8504476,8801624,297148,981851,297148,684703,0,0
8801696,4,1,966542,966542,8801696,7835154,7835154,7835151,3,127,0
8821596,814,8,8690456,8723173,8821596,98423,131140,98423,32717,0,0
8821831,773,8,8084950,8520713,8821831,301118,736881,301118,435763,0,0
8827101,809,1,8689233,8689233,8827101,137868,137868,137868,0,0,0
8875845,750,8,7794276,8534444,8875845,341401,1081569,341401,740168,0,0
8950025,815,8,8844933,8875845,8950025,74180,105092,74180,30912,0,0
8954380,816,8,8931250,8950025,8954380,4355,23130,4355,18775,0,0
8962857,791,8,8398988,8581365,8962857,381492,563869,381492,182377,0,0
8970199,819,1,8959230,8959230,8970199,10969,10969,10969,0,0,0
9005357,298,4,4570030,4700564,9005357,4304793,4435327,1922754,2512573,1,0
9012043,820,1,8964394,8964394,9012043,47649,47649,47649,0,0,0
9031385,811,8,8690423,8801624,9031385,229761,340962,229761,111201,0,0
9033047,826,8,9023473,9031385,9033047,1662,9574,1662,7912,0,0
9040998,827,8,9023477,9033047,9040998,7951,17521,7951,9570,0,0
9048554,580,4,6246733,7714793,9048554,1333761,2801821,1333761,1468060,0,0
9066152,818,1,8958896,8958896,9066152,107256,107256,107256,0,0,0
9090512,772,8,8084946,8608368,9090512,482144,1005566,482144,523422,0,0
9113090,605,1,6435087,6435087,9113090,2678003,2678003,2678003,0,0,0
9122224,420,4,5399341,7743852,9122224,1378372,3722883,1378372,2344511,8,0
9129022,105,8,3181760,8620129,9129022,508893,5947262,508893,5438369,0,0
9131683,830,1,9089233,9089233,9131683,42450,42450,42450,0,0,0
9165948,274,8,4431116,8650647,9165948,515301,4734832,515301,4219531,0,0
9169431,837,8,9142149,9165948,9169431,3483,27282,3483,23799,0,0
9190632,227,1,4238503,4238503,9190632,4952129,4952129,4937645,14484,187,0
9216831,143,8,3664267,8689018,9216831,527813,5552564,527813,5024751,0,0
9232955,838,8,9142856,9169431,9232955,63524,90099,63524,26575,0,0
9268131,831,8,9128320,9129022,9268131,139109,139811,139109,702,0,0
9274060,508,1,5839200,5839200,9274060,3434860,3434860,3391975,42885,96,0
9285036,825,1,8999938,8999938,9285036,285098,285098,285098,0,0,0
9327141,861,1,9320231,9320231,9327141,6910,6910,6910,0,0,0
9327297,856,1,9318625,9318625,9327297,8672,8672,8672,0,0,0
9344802,860,1,9320228,9320228,9344802,24574,24574,24574,0,0,0
9350772,834,8,9131722,9216831,9350772,133941,219050,133941,85109,0,0
9358351,770,8,8083271,8821596,9358351,536755,1275080,536755,738325,0,0
9367536,875,8,9353239,9358351,9367536,9185,14297,9185,5112,0,0
9369591,302,8,4620804,8821831,9369591,547760,4748787,547760,4201027,0,0
9389397,850,1,9318601,9318601,9389397,70796,70796,70796,0,0,0
9395913,880,1,9391141,9391141,9395913,4772,4772,4772,0,0,0
9397177,851,1,9318604,9318604,9397177,78573,78573,78573,0,0,0
9397202,854,1,9318613,9318613,9397202,78589,78589,78589,0,0,0
9397211,855,1,9318617,9318617,9397211,78594,78594,78594,0,0,0
9401679,847,1,9318591,9318591,9401679,83088,83088,83088,0,0,0
9405488,832,8,9128323,9232955,9405488,172533,277165,172533,104632,0,0
9413419,878,1,9388849,9388849,9413419,24570,24570,24570,0,0,0
9429419,234,1,4238526,4238526,9429419,5190893,5190893,5119517,71376,222,0
9444052,835,8,9131726,9268131,9444052,175921,312326,175921,136405,0,0
9457927,859,1,9320225,9320225,9457927,137702,137702,137702,0,0,0
9472306,883,1,9393712,9393712,9472306,78594,78594,78594,0,0,0
9498275,852,1,9318607,9318607,9498275,179668,179668,179668,0,0,0
9503587,845,1,9318584,9318584,9503587,185003,185003,185003,0,0,0
9505236,858,1,9320221,9320221,9505236,185015,185015,185015,0,0,0
9517869,799,8,8493852,8954380,9517869,563489,1024017,563489,460528,0,0
9525570,884,1,9407056,9407056,9525570,118514,118514,118514,0,0,0
9529132,881,1,9391363,9391363,9529132,137769,137769,137769,0,0,0
9546941,153,8,3773359,8962857,9546941,584084,5773582,584084,5189498,0,0
9563229,848,1,9318594,9318594,9563229,244635,244635,244635,0,0,0
9563249,849,1,9318597,9318597,9563249,244652,244652,244652,0,0,0
9564753,863,1,9320237,9320237,9564753,244516,244516,244516,0,0,0
9565424,887,1,9560361,9560361,9565424,5063,5063,5063,0,0,0
9565925,928,1,9562316,9562316,9565925,3609,3609,3609,0,0,0
9566045,927,1,9562310,9562310,9566045,3735,3735,3735,0,0,0
9568656,846,1,9318587,9318587,9568656,250069,250069,250069,0,0,0
9568790,909,1,9561036,9561036,9568790,7754,7754,7754,0,0,0
9568853,857,1,9318628,9318628,9568853,250225,250225,250225,0,0,0
9568900,931,1,9562340,9562340,9568900,6560,6560,6560,0,0,0
9570345,894,1,9560938,9560938,9570345,9407,9407,9407,0,0,0
9570617,912,1,9562206,9562206,9570617,8411,8411,8411,0,0,0
9571869,916,1,9562229,9562229,9571869,9640,9640,9640,0,0,0
9575778,879,1,9390865,9390865,9575778,184913,184913,184913,0,0,0
9585383,918,1,9562241,9562241,9585383,23142,23142,23142,0,0,0
9588309,917,1,9562235,9562235,9588309,26074,26074,26074,0,0,0
9591712,893,1,9560933,9560933,9591712,30779,30779,30779,0,0,0
9592189,891,1,9560917,9560917,9592189,31272,31272,31272,0,0,0
9602066,905,1,9561013,9561013,9602066,41053,41053,41053,0,0,0
9615819,876,1,9371269,9371269,9615819,244550,244550,244550,0,0,0
9629654,903,1,9560997,9560997,9629654,68657,68657,68657,0,0,0
9629878,920,1,9562253,9562253,9629878,67625,67625,67625,0,0,0
9633403,813,8,8690449,9040998,9633403,592405,942954,592405,350549,0,0
9640631,911,1,9562201,9562201,9640631,78430,78430,78430,0,0,0
9650800,868,8,9352340,9367536,9650800,283264,298460,283264,15196,0,0
9651629,778,8,8143701,9048554,9651629,603075,1507928,603075,904853,0,0
9661088,890,1,9560906,9560906,9661088,100182,100182,100182,0,0,0
9662722,914,1,9562217,9562217,9662722,100505,100505,100505,0,0,0
9680519,921,1,9562260,9562260,9680519,118259,118259,118259,0,0,0
9681714,913,1,9562212,9562212,9681714,119502,119502,119502,0,0,0
9690493,925,1,9562292,9562292,9690493,128201,128201,128201,0,0,0
9697839,817,8,8931256,9090512,9697839,607327,766583,607327,159256,1,0
9698133,896,1,9560955,9560955,9698133,137178,137178,137178,0,0,0
9705475,897,1,9560962,9560962,9705475,144513,144513,144513,0,0,0
9714326,926,1,9562304,9562304,9714326,152022,152022,152022,0,0,0
9735554,898,1,9560967,9560967,9735554,174587,174587,174587,0,0,0
9740193,922,1,9562271,9562271,9740193,177922,177922,177922,0,0,0
9752939,899,1,9560974,9560974,9752939,191965,191965,191965,0,0,0
9762443,842,1,9317096,9317096,9762443,445347,445347,445347,0,0,0
9772706,924,1,9562284,9562284,9772706,210422,210422,210422,0,0,0
9781519,895,1,9560944,9560944,9781519,220575,220575,220575,0,0,0
9796017,871,8,9352949,9369591,9796017,426426,443068,426426,16642,0,0
9799943,943,8,9780306,9796017,9799943,3926,19637,3926,15711,0,0
9816655,941,8,9778827,9799943,9816655,16712,37828,16712,21116,0,0
9817493,919,1,9562246,9562246,9817493,255247,255247,255247,0,0,0
9818821,944,8,9812781,9816655,9818821,2166,6040,2166,3874,0,0
9819283,910,1,9561041,9561041,9819283,258242,258242,258242,0,0,0
9835097,430,4,5547539,7859339,9835097,1975758,4287558,1446097,2841461,38,0
9853886,915,1,9562223,9562223,9853886,291663,291663,291663,0,0,0
9860015,874,8,9353218,9405488,9860015,454527,506797,454527,52270,1,0
9875025,634,1,6486734,6486734,9875025,3388291,3388291,3386462,1829,26,0
9884154,902,1,9560991,9560991,9884154,323163,323163,323163,0,0,0
9902459,945,8,9812818,9818821,9902459,83638,89641,83638,6003,0,0
9910579,950,8,9879334,9902459,9910579,8120,31245,8120,23125,0,0
9917216,954,8,9904351,9910579,9917216,6637,12865,6637,6228,0,0
9952321,864,1,9320241,9320241,9952321,632080,632080,632080,0,0,0
9975041,948,8,9867954,9917216,9975041,57825,107087,57825,49262,0,0
9986294,929,1,9562322,9562322,9986294,423972,423972,423972,0,0,0
9992932,904,1,9561002,9561002,9992932,431930,431930,431930,0,0,0
9995467,599,1,6314494,6330918,9995467,3664549,3680973,3655431,25542,29,0
10003336,906,1,9561018,9561018,10003336,442318,442318,442318,0,0,0
10012979,936,8,9649809,9650800,10012979,362179,363170,362179,991,0,0
10036206,942,8,9780149,9835097,10036206,201109,256057,201109,54948,0,0
10042475,951,8,9886114,9975041,10042475,67434,156361,67434,88927,0,0
10078670,932,8,9618714,9651629,10078670,427041,459956,427041,32915,0,0
10079486,956,8,10048690,10078670,10079486,816,30796,816,29980,0,0
10086881,957,8,10050687,10079486,10086881,7395,36194,7395,28799,0,0
10096127,882,1,9392244,9392244,10096127,703883,703883,703883,0,0,0
10162778,947,8,9867948,10012979,10162778,149799,294830,149799,145031,0,0
10196709,940,8,9723284,9860015,10196709,336694,473425,336694,136731,0,0
10204459,776,8,8125796,9457927,10204459,746532,2078663,610916,1467747,11,0
10238212,949,8,9879329,10036206,10238212,202006,358883,202006,156877,0,0
10268029,862,1,9320234,9320234,10268029,947795,947795,947795,0,0,0
10280459,655,4,6509275,8469670,10280459,1810789,3771184,1449892,2321292,20,0
10292095,958,8,10064333,10086881,10292095,205214,227762,205214,22548,0,0
10301774,684,1,6880435,6880435,10301774,3421339,3421339,3421339,0,0,0
10314852,961,1,10287315,10287315,10314852,27537,27537,27537,0,0,0
10320123,908,1,9561030,9561030,10320123,759093,759093,759093,0,0,0
10343145,959,8,10216368,10238212,10343145,104933,126777,104933,21844,0,0
10351176,844,1,9318580,9318580,10351176,1032596,1032596,1032596,0,0,0
10356241,962,2,10288864,10288864,10356241,67377,67377,67377,0,0,0
10412530,946,8,9822965,10042475,10412530,370055,589565,370055,219510,0,0
10412951,807,1,8678070,8678070,10412951,1734881,1734881,1734881,0,0,0
10456888,92,1,2372766,2372766,10456888,8084122,8084122,7937697,146425,357,0
10503570,901,1,9560986,9560986,10503570,942584,942584,942584,0,0,0
10521325,889,1,9560896,9560896,10521325,960429,960429,960429,0,0,0
10522319,624,1,6482599,6482599,10522319,4039720,4039720,4016668,23052,30,0
10527765,964,1,10291099,10291099,10527765,236666,236666,236666,0,0,0
10590237,938,8,9718865,10162778,10590237,427459,871372,427459,443913,0,0
10717767,74,1,2353471,2353471,10717767,8364296,8364296,8115009,249287,352,0
10759746,933,8,9621946,10196709,10759746,563037,1137800,563037,574763,0,0
10760636,72,1,2353435,2353435,10760636,8407201,8407201,8115649,291552,351,0
10767565,966,8,10729202,10759746,10767565,7819,38363,7819,30544,0,0
10808052,892,1,9560923,9560923,10808052,1247129,1247129,1247129,0,0,0
10810290,135,8,3575927,9546941,10810290,1263349,7234363,619807,6614556,1,0
10834518,503,4,5820504,9005357,10834518,1829161,5014014,1453969,3560045,32,0
10865924,969,1,10817213,10817213,10865924,48711,48711,48711,0,0,0
10870312,963,2,10288886,10288886,10870312,581426,581426,581426,0,0,0
10872421,843,1,9318577,9318577,10872421,1553844,1553844,1553844,0,0,0
10920300,760,8,7989604,10292095,10920300,628205,2930696,628205,2302491,0,0
10948725,56,1,2323019,2323019,10948725,8625706,8625706,8264266,361440,340,0
10992824,502,8,5818950,10343145,10992824,649679,5173874,649679,4524195,0,0
11020107,970,8,10817519,10920300,11020107,99807,202588,99807,102781,0,0
11041784,965,1,10646927,10646927,11041784,394857,394857,394857,0,0,0
11050723,241,1,4238549,4238549,11050723,6812174,6812174,6437804,374370,341,0
11069872,322,8,4857727,10412530,11069872,657342,6212145,657342,5554803,0,0
11139264,907,1,9561023,9561023,11139264,1578241,1578241,1578241,0,0,0
11148653,829,1,9089228,9089228,11148653,2059425,2059425,2059425,0,0,0
11162249,494,4,5799387,9560917,11162249,1601332,5362862,1471813,3891049,21,0
11248548,534,8,5910762,10590237,11248548,658311,5337786,658311,4679475,0,0
11381854,853,1,9318610,9318610,11381854,2063244,2063244,2063244,0,0,0
11427426,930,1,9562335,9562335,11427426,1865091,1865091,1865091,0,0,0
11434084,291,8,4525610,10767565,11434084,666519,6908474,666519,6241955,0,0
11451071,381,4,5288603,9817493,11451071,1633578,6162468,1475743,4686725,5,0
11491609,336,8,5077256,10810290,11491609,681319,6414353,681319,5733034,0,0
11631400,923,1,9562278,9562278,11631400,2069122,2069122,2069122,0,0,0
11684681,953,8,9904293,10992824,11684681,691857,1780388,691857,1088531,0,0
11707756,70,1,2353402,2353402,11707756,9354354,9354354,8911092,443262,335,0
11716568,705,1,7229868,7229868,11716568,4486700,4486700,4486700,0,0,0
11752042,101,8,3077111,3105119,11752042,8646923,8674931,2915419,5759512,1,0
11762046,657,4,6510828,10280459,11762046,1481587,5251218,1481587,3769631,0,0
11772173,604,1,6435049,6546223,11772173,5225950,5337124,5225950,111174,47,0
11855865,63,1,2341283,2341283,11855865,9514582,9514582,8977195,537387,313,0
11980477,71,1,2353425,2353425,11980477,9627052,9627052,9006748,620304,282,0
11989151,455,4,5690674,10503570,11989151,1485581,6298477,1485581,4812896,0,0
12011106,714,4,7251689,10521325,12011106,1489781,4759417,1489781,3269636,0,0
12065449,128,8,3513854,11248548,12065449,816901,8551595,816901,7734694,0,0
12109696,888,1,9560890,9560890,12109696,2548806,2548806,2548806,0,5,0
12268695,955,8,9983541,11434084,12268695,834611,2285154,834611,1450543,0,0
12361821,118,8,3288962,11491609,12361821,870212,9072859,870212,8202647,0,0
12414921,666,4,6554555,10834518,12414921,1580403,5860366,1580403,4279963,0,0
12565403,784,8,8167020,11684681,12565403,880722,4398383,880722,3517661,0,0
12651016,536,4,5918858,11069872,12651016,1581144,6732158,1581144,5151014,0,0
12678790,49,1,1945509,1945509,12678790,10733281,10733281,10021787,711494,334,0
12682773,499,8,5808930,11752042,12682773,930731,6873843,930731,5943112,0,0
12688869,900,1,9560979,9560979,12688869,3127890,3127890,3127871,19,13,0
12693736,379,4,5284990,11069872,12693736,1623864,7408746,1623864,5784882,0,0
12693826,601,1,6435016,6582273,12693826,6111553,6258810,6110639,148171,138,0
12799774,21,1,1943846,1943846,12799774,10855928,10855928,10092765,763163,345,0
12810702,281,4,4508009,4992014,12810702,7818688,8302693,1964410,6338283,2,0
12902958,25,1,1943885,1943885,12902958,10959073,10959073,10119920,839153,343,0
13000233,971,1,10817570,10817570,13000233,2182663,2182663,2182663,0,0,0
13001988,517,4,5870152,11162249,13001988,1839739,7131836,1839739,5292097,0,0
13003438,886,1,9498086,9498086,13003438,3505352,3505352,3502212,3140,16,0
13015289,596,1,6307815,6594585,13015289,6420704,6707474,6410151,297323,211,0
13058816,137,8,3581378,12011106,13058816,1047710,9477438,1047710,8429728,0,0
13123270,540,8,5920134,12065449,13123270,1057821,7203136,1057821,6145315,0,0
13335365,806,8,8666263,12268695,13335365,1066670,4669102,1066670,3602432,0,0
13343824,351,4,5088196,5108605,13343824,8235219,8255628,2026656,6228972,5,0
13433791,967,8,10730007,12361821,13433791,1071970,2703784,1071970,1631814,0,0
13640095,449,8,5655926,12565403,13640095,1074692,7984169,1074692,6909477,0,0
13671199,824,1,8998764,8998764,13671199,4672435,4672435,4659385,13050,53,0
13701173,571,4,6083344,11631400,13701173,2069773,7617829,2069773,5548056,0,0
13729507,631,1,6483706,6629232,13729507,7100275,7245801,7064354,181447,326,0
13763497,707,1,7229875,7229875,13763497,6533622,6533622,6489085,44537,259,0
13798445,836,8,9142146,12682773,13798445,1115672,4656299,1115672,3540627,0,0
13801407,612,1,6477889,6633403,13801407,7168004,7323518,7123158,200360,329,0
13946404,319,4,4751993,5147367,13946404,8799037,9194411,2213426,6980985,15,0
14171212,248,1,4238572,4238572,14171212,9932640,9932640,8962735,969905,533,0
14194846,437,8,5576137,13058816,14194846,1136030,8618709,1136030,7482679,0,0
14238638,239,1,4238543,4238543,14238638,10000095,10000095,8965879,1034216,535,0
14262499,365,8,5214469,13123270,14262499,1139229,9048030,1139229,7908801,0,0
14311813,240,1,4238546,4238546,14311813,10073267,10073267,8965914,1107353,519,0
14515231,960,8,10224956,13335365,14515231,1179866,4290275,1179866,3110409,0,0
14708336,448,8,5654290,13433791,14708336,1274545,9054046,1274545,7779501,0,0
14896010,54,1,1945555,1945555,14896010,12950455,12950455,11776992,1173463,553,0
14946447,539,8,5920105,13640095,14946447,1306352,9026342,1306352,7719990,0,0
14965289,935,16,9647037,14946447,14965289,18842,5318252,18842,5299410,0,0
14993238,608,4,6440206,11989151,14993238,3004087,8553032,2600272,5952760,1,0
14996229,794,16,8462235,14965289,14996229,30940,6533994,30940,6503054,0,0
15030304,885,16,9484002,14996229,15030304,34075,5546302,34075,5512227,0,0
15184589,774,16,8095109,14996229,15184589,188360,7089480,188360,6901120,0,0
15222647,102,8,3173969,13798445,15222647,1424202,12048678,1424202,10624476,0,0
15267241,492,4,5799365,12651016,15267241,2616225,9467876,2616225,6851651,0,0
15344821,279,4,4505268,12693736,15344821,2651085,10839553,2651085,8188468,0,0
15460016,458,4,5691065,12799774,15460016,2660242,9768951,2660242,7108709,0,0
15502160,796,16,8463334,15030304,15502160,471856,7038826,471856,6566970,0,0
15575284,545,4,5967213,12810702,15575284,2764582,9608071,2764582,6843489,0,0
15652053,368,8,5214593,14194846,15652053,1457207,10437460,1457207,8980253,0,0
15657512,732,16,7407929,15184589,15657512,472923,8249583,472923,7776660,0,0
15729024,114,8,3245414,14262499,15729024,1466525,12483610,1466525,11017085,0,0
15806477,97,1,2530524,2530524,15806477,13275953,13275953,11984760,1291193,563,0
15811733,537,4,5918952,13001988,15811733,2809745,9892781,2809745,7083036,0,0
15975136,797,16,8463342,15502160,15975136,472976,7511794,472976,7038818,0,0
16070565,104,8,3180113,14515231,16070565,1555334,12890452,1555334,11335118,0,0
16227095,491,4,5790362,13343824,16227095,2883271,10436733,2883271,7553462,0,0
16242592,733,16,7409520,15652053,16242592,590539,8833072,590539,8242533,0,0
16252116,823,16,8968659,15657512,16252116,594604,7283457,594604,6688853,0,0
16280207,8,1,1245386,1245386,16280207,15034821,15034821,13480812,1554009,517,0
16598930,518,4,5871027,13701173,16598930,2897757,10727903,2897757,7830146,0,0
16714916,469,4,5709221,13729507,16714916,2985409,11005695,2985409,8020286,0,0
16720644,554,1,5983202,6773349,16720644,9947295,10737442,9614472,1122970,403,0
16822346,800,16,8505702,15975136,16822346,847210,8316644,847210,7469434,0,0
16837122,668,4,6588873,13801407,16837122,3035715,10248249,3035715,7212534,0,0
16908692,166,8,3852784,14896010,16908692,2012682,13055908,1617299,11438609,3,0
17339584,706,1,7229871,7229871,17339584,10109713,10109713,9536387,573326,336,0
17349039,178,4,3976270,4020260,17349039,13328779,13372769,3843225,9529544,1,0
17549724,453,8,5659730,15811733,17549724,1737991,11889994,1737991,10152003,0,0
17694154,710,4,7244582,14311813,17694154,3382341,10449572,3155923,7293649,1,0
17838631,734,16,7409860,16822346,17838631,1016285,10428771,1016285,9412486,0,0
18071867,123,8,3390490,16227095,18071867,1844772,14681377,1844772,12836605,1,0
18094365,678,4,6636526,14708336,18094365,3386029,11457839,3159611,8298228,5,0
18108969,208,8,4098825,16242592,18108969,1866377,14010144,1866377,12143767,0,0
18121742,76,1,2353494,2353494,18121742,15768248,15768248,13585270,2182978,444,0
18232521,785,8,8173466,16252116,18232521,1980405,10059055,1980405,8078650,0,0
18299943,968,8,10805328,16252116,18299943,2047827,7494615,2047827,5446788,1,0
19062963,431,8,5549352,16908692,19062963,2154271,13513611,2154271,11359340,0,0
19106792,555,1,5983205,6813281,19106792,12293511,13123587,11207425,1916162,348,0
19354359,745,1,7785948,7785948,19354359,11568411,11568411,10507682,1060729,239,0
19456902,0,1,0,0,19456902,19456902,19456902,16553419,2903483,381,0
19586978,498,4,5805669,14708336,19586978,4878642,13781309,3863565,9917744,4,0
19729530,103,8,3179744,17549724,19729530,2179806,16549786,2179806,14369980,0,0
20088688,176,4,3960108,4159642,20088688,15929046,16128580,4233932,11894648,5,0
20148436,952,8,9904218,17838631,20148436,2309805,10244218,2309805,7934413,0,0
20269627,7,1,1245348,1245348,20269627,19024279,19024279,15819506,3204773,350,0
20296958,546,4,5967229,16242592,20296958,4054366,14329729,4054366,10275363,2,0
20346643,139,8,3585839,17838631,20346643,2508012,16760804,2508012,14252792,1,0
20704123,173,8,3910611,18108969,20704123,2595154,16793512,2595154,14198358,1,0
20709919,317,4,4748477,16598930,20709919,4110989,15961442,4110989,11850453,1,0
20879206,937,8,9717883,18232521,20879206,2646685,11161323,2646685,8514638,1,0
20937653,294,4,4531321,16714916,20937653,4222737,16406332,4222737,12183595,2,0
20985440,325,8,4952491,18299943,20985440,2685497,16032949,2685497,13347452,0,0
21282221,618,1,6477920,7053860,21282221,14228361,14804301,12614956,2189345,269,0
21348042,284,4,4522057,16837122,21348042,4510920,16825985,4510920,12315065,1,0
22009824,65,1,2345983,2345983,22009824,19663841,19663841,16162395,3501446,346,0
22106298,277,4,4488504,17349039,22106298,4757259,17617794,4757259,12860535,2,0
22422942,68,1,2353317,2353317,22422942,20069625,20069625,16199856,3869769,302,0
22486997,866,8,9323676,19729530,22486997,2757467,13163321,2757467,10405854,0,0
22577244,190,4,3999219,4238572,22577244,18338672,18578025,4898751,13679274,4,0
22775781,45,1,1945474,1945474,22775781,20830307,20830307,16801373,4028934,285,0
22916088,152,8,3772318,20148436,22916088,2767652,19143770,2767652,16376118,0,0
23096200,527,4,5888974,18071867,23096200,5024333,17207226,5024333,12182893,2,0
23269184,488,4,5779955,18071867,23269184,5197317,17489229,5197317,12291912,4,0
23292356,330,8,5030414,20346643,23292356,2945713,18261942,2945713,15316229,0,0
23339675,526,4,5884574,18094365,23339675,5245310,17455101,5245310,12209791,4,0
23405855,626,1,6482611,7203324,23405855,16202531,16923244,13877799,3045445,169,0
23697144,157,8,3780272,20704123,23697144,2993021,19916872,2993021,16923851,1,0
23907760,138,8,3583341,20879206,23907760,3028554,20324419,3028554,17295865,1,0
24018967,371,8,5281775,20985440,24018967,3033527,18737192,3033527,15703665,0,0
24204663,619,1,6477925,8136103,24204663,16068560,17726738,14487804,3238934,143,0
24254015,350,1,5088087,5088087,24254015,19165928,19165928,14730119,4435809,188,0
24316405,244,1,4238559,4238559,24316405,20077846,20077846,15629291,4448555,268,0
24544467,184,4,3994590,19062963,24544467,5481504,20549877,5481504,15068373,0,0
24696429,696,1,7219983,9762443,24696429,14933986,17476446,14932196,2544250,138,0
25162208,460,4,5699331,19586978,25162208,5575230,19462877,5575230,13887647,0,0
25567032,219,8,4207092,22486997,25567032,3080035,21359940,3080035,18279905,0,0
25715612,297,4,4534242,20088688,25715612,5626924,21181370,5626924,15554446,0,0
26143206,37,1,1943971,1943971,26143206,24199235,24199235,19683845,4515390,313,0
26186541,654,4,6509257,20296958,26186541,5889583,19677284,5889583,13787701,0,0
26325796,132,8,3572883,23096200,26325796,3229596,22752913,3229596,19523317,0,0
26575009,160,8,3828965,23292356,26575009,3282653,22746044,3282653,19463391,0,0
26632003,155,8,3775315,23339675,26632003,3292328,22856688,3292328,19564360,0,0
26663287,42,1,1945418,1945418,26663287,24717869,24717869,20157236,4560633,323,0
26698649,481,4,5735152,20709919,26698649,5988730,20963497,5988730,14974767,0,0
26977339,13,1,1943781,1943781,26977339,25033558,25033558,20418941,4614617,321,0
27197344,418,4,5399317,20937653,27197344,6259691,21798027,6259691,15538336,2,0
27304127,89,1,2372749,2372749,27304127,24931378,24931378,20133364,4798014,315,0
27397390,119,8,3307318,23907760,27397390,3489630,24090072,3489630,20600442,0,0
27593967,210,8,4099456,24018967,27593967,3575000,23494511,3575000,19919511,0,0
27685444,763,16,8040988,26325796,27685444,1359648,19644456,1359648,18284808,0,0
27980127,436,4,5574140,21348042,27980127,6632085,22405987,6632085,15773902,0,0
28079780,79,1,2353535,2353535,28079780,25726245,25726245,20586017,5140228,303,0
28126261,737,16,7557853,26632003,28126261,1494258,20568408,1494258,19074150,0,0
28472263,62,1,2341233,2341233,28472263,26131030,26131030,20740797,5390233,291,0
28771463,872,8,9352960,25162208,28771463,3609255,19418503,3609255,15809248,0,0
28783375,663,4,6510903,22106298,28783375,6677077,22272472,6677077,15595395,3,0
29205392,764,16,8041056,27685444,29205392,1519948,21164336,1519948,19644388,0,0
29235564,182,8,3993416,25567032,29235564,3668532,25242148,3668532,21573616,0,0
29237467,85,1,2357366,2357366,29237467,26880101,26880101,20919234,5960867,275,0
29301751,452,4,5659723,22577244,29301751,6724507,23642028,6724507,16917521,2,0
29458780,11,1,1714609,1714609,29458780,27744171,27744171,21737258,6006913,276,0
29657001,801,16,8513322,28126261,29657001,1530740,21143679,1530740,19612939,0,0
29765163,83,1,2353718,2353718,29765163,27411445,27411445,21195801,6215644,274,0
30300368,538,8,5920075,26143206,30300368,4157162,24380293,3841303,20538990,3,0
30596430,662,4,6510898,22916088,30596430,7680342,24085532,7149889,16935643,3,0
30812298,805,16,8517527,29205392,30812298,1606906,22294771,1606906,20687865,0,0
31310232,683,8,6713307,27397390,31310232,3912842,24596925,3912842,20684083,0,0
31314085,691,16,7142056,29657001,31314085,1657084,24172029,1657084,22514945,0,0
31499763,867,1,9350020,11041784,31499763,20457979,22149743,19664052,2485691,69,0
31535369,131,8,3556332,27593967,31535369,3941402,27979037,3941402,24037635,1,0
31708886,682,4,6711622,23697144,31708886,8011742,24997264,8011742,16985522,5,0
32784775,939,8,9722372,28771463,32784775,4013312,23062403,4013312,19049091,0,0
33511004,129,8,3514079,29235564,33511004,4275440,29996925,4275440,25721485,0,0
33582111,271,8,4389136,29301751,33582111,4280360,29192975,4280360,24912615,0,0
33816584,602,1,6435021,11050723,33816584,22765861,27381563,21426459,5955104,63,0
34581013,803,8,8516889,30300368,34581013,4280645,26064124,4280645,21783479,0,0
34849341,245,1,4238563,4238563,34849341,30610778,30610778,22655711,7955067,254,0
34873606,197,4,4022175,24544467,34873606,10329139,30851431,9233705,21617726,9,0
35150160,2,8,724670,724670,35150160,34425490,34425490,7635430,26790060,1,0
35317806,292,8,4525638,30812298,35317806,4505508,30792168,4505508,26286660,0,0
35818455,735,8,7537843,31310232,35818455,4508223,28280612,4508223,23772389,0,0
35840246,677,8,6619673,31314085,35840246,4526161,29220573,4526161,24694412,0,0
35849764,828,8,9041075,31314085,35849764,4535679,26808689,4535679,22273010,0,0
36226637,485,8,5746918,31535369,36226637,4691268,30479719,4691268,25788451,0,0
36397652,632,1,6483711,11980477,36397652,24417175,29913941,22592541,7321400,52,0
37305916,461,4,5702448,27980127,37305916,9325789,31603468,9325789,22277679,5,0
37646570,323,8,4951959,32784775,37646570,4861795,32694611,4861795,27832816,0,0
38014321,610,1,6472782,12109696,38014321,25904625,31541539,22876854,8664685,42,0
38383632,802,8,8516854,33511004,38383632,4872628,29866778,4872628,24994150,0,0
39646998,146,8,3670480,34581013,39646998,5065985,35976518,5065985,30910533,0,0
39851474,16,1,1943802,1943802,39851474,37907672,37907672,26455762,11451910,238,0
39912064,471,4,5709282,28783375,39912064,11128689,34202782,9834010,24368772,5,0
40756953,754,8,7911064,35317806,40756953,5439147,32845889,5439147,27406742,0,0
40904936,28,1,1943923,1943923,40904936,38961013,38961013,26460528,12500485,234,0
41049667,91,1,2372761,2372761,41049667,38676906,38676906,26061094,12615812,228,0
41323287,163,8,3832267,35818455,41323287,5504832,37491020,5504832,31986188,0,0
41391436,100,8,2918990,35840246,41391436,5551190,38472446,5551190,32921256,0,0
41417086,107,8,3211674,35849764,41417086,5567322,38205412,5567322,32638090,0,0
41646642,203,4,4072721,31708886,41646642,9937756,37573921,9937756,27636165,0,0
41804175,769,8,8055147,36226637,41804175,5577538,33749028,5577538,28171490,0,0
42336591,804,16,8517361,39646998,42336591,2689593,33819230,2689593,31129637,0,0
42843170,704,1,7229865,13015289,42843170,29827881,35613305,24786659,10826646,19,0
43641402,462,4,5702462,33582111,43641402,10059291,37938940,10059291,27879649,0,0
44014164,447,8,5654281,37646570,44014164,6367594,38359883,6367594,31992289,1,0
44036495,73,1,2353463,2353463,44036495,41683032,41683032,28030793,13652239,230,0
44061379,690,16,7063550,41323287,44061379,2738092,36997829,2738092,34259737,0,0
44220469,642,1,6495752,19106792,44220469,25113677,37724717,25113677,12611040,11,0
45154442,172,4,3910570,3915959,45154442,41238483,41243872,10367049,30876823,1,0
45575050,216,8,4117554,38383632,45575050,7191418,41457496,6926352,34531144,1,0
45669000,262,4,4265546,35150160,45669000,10518840,41403454,10518840,30884614,0,0
45739492,175,4,3959858,35150160,45739492,10589332,41779634,10589332,31190302,0,0
46532512,877,1,9375612,19354359,46532512,27178153,37156900,27178153,9978747,17,0
47822886,213,8,4100763,40756953,47822886,7065933,43722123,6997784,36724339,4,0
47907565,611,1,6472830,19456902,47907565,28450663,41434735,28450663,12984072,21,0
48425237,108,8,3221514,41417086,48425237,7008151,45203723,7008151,38195572,2,0
48921217,168,8,3854783,41804175,48921217,7117042,45066434,7117042,37949392,1,0
49188408,564,1,6050374,20269627,49188408,28918781,43138034,28918781,14219253,18,0
49701542,767,8,8054934,42336591,49701542,7364951,41646608,7364951,34281657,0,0
50069589,383,4,5303101,37305916,50069589,12763673,44766488,12763673,32002815,3,0
51458818,331,8,5030418,44014164,51458818,7444654,46428400,7444654,38983746,0,0
52505954,261,8,4257328,44061379,52505954,8444575,48248626,8444575,39804051,0,0
52927706,27,1,1943907,1943907,52927706,50983799,50983799,34985762,15998037,241,0
53662381,15,1,1943792,1943792,53662381,51718589,51718589,34989907,16728682,246,0
54072304,533,8,5907010,45575050,54072304,8497254,48165294,8497254,39668040,0,0
54186949,17,1,1943808,1943808,54186949,52243141,52243141,34993152,17249989,237,0
54445202,758,8,7967236,45739492,54445202,8705710,46477966,8705710,37772256,0,0
55800066,236,1,4238533,4238533,55800066,51561533,51561533,33958617,17602916,208,0
56484812,547,4,5967243,41646642,56484812,14838170,50517569,14838170,35679399,2,0
56630382,450,8,5655933,47822886,56630382,8807496,50974449,8807496,42166953,0,0
57178939,558,4,6045015,42336591,57178939,14842348,51133924,14842348,36291576,0,0
57296792,201,8,4072683,48425237,57296792,8871555,53224109,8871555,44352554,0,0
57398187,625,1,6482605,22916088,57398187,34482099,50915582,34482099,16433483,25,0
57512685,39,1,1945383,1945383,57512685,55567302,55567302,37823894,17743408,254,0
57646317,33,1,1943947,1943947,57646317,55702370,55702370,37943981,17758389,256,0
57715762,220,1,4211443,4211443,57715762,53504319,53504319,35733717,17770602,219,0
58540571,559,4,6045026,43641402,58540571,14899169,52495545,14899169,37596376,0,0
58753959,686,8,6997386,49701542,58753959,9052417,51756573,9052417,42704156,0,0
59529068,253,1,4238590,4238590,59529068,55290478,55290478,37010449,18280029,176,0
59666012,316,4,4748470,44061379,59666012,15604633,54917542,15604633,39312909,0,0
60338760,230,1,4238513,4238513,60338760,56100247,56100247,37013175,19087072,190,0
60612116,718,8,7314985,51458818,60612116,9153298,53297131,9153298,44143833,0,0
60638295,667,4,6554564,44061379,60638295,16576916,54083731,16576916,37506815,0,0
61693607,870,8,9352373,52505954,61693607,9187653,52341234,9187653,43153581,0,0
62915423,664,4,6510910,45154442,62915423,17760981,56404513,17760981,38643532,0,0
63406208,109,8,3232960,54072304,63406208,9333904,60173248,9333904,50839344,0,0
63846715,249,1,4238576,4238576,63846715,59608139,59608139,39898625,19709514,157,0
64288382,439,8,5609800,54445202,64288382,9843180,58678582,9843180,48835402,0,0
65592161,217,1,4126763,4126763,65592161,61465398,61465398,41317767,20147631,181,0
66779853,543,4,5961299,45669000,66779853,21110853,60818554,17929128,42889426,1,0
66901894,616,1,6477911,24696429,66901894,42205465,60423983,41044544,19379439,23,0
66914718,308,4,4710494,48921217,66914718,17993501,62204224,17993501,44210723,0,0
67085525,693,8,7188172,56630382,67085525,10455143,59897353,10455143,49442210,0,0
68028966,161,8,3829332,57296792,68028966,10732174,64199634,10732174,53467460,0,0
69787757,306,4,4710459,50069589,69787757,19718168,65077298,19718168,45359130,0,0
70362137,154,8,3774084,58753959,70362137,11608178,66588053,11608178,54979875,0,0
72435190,594,1,6307606,28079780,72435190,44355410,66127584,44355410,21772174,20,0
72796179,349,8,5079170,59666012,72796179,13130167,67717009,13130167,54586842,0,0
73501344,628,1,6483527,28472263,73501344,45029081,67017817,45029081,21988736,20,0
73845454,115,8,3251335,60612116,73845454,13233338,70594119,13233338,57360781,0,0
75204725,606,1,6435092,29237467,75204725,45967258,68769633,45967258,22802375,15,0
75722316,87,1,2372737,2372737,75722316,73349579,73349579,48879883,24469696,203,0
75848506,136,8,3575962,61693607,75848506,14154899,72272544,14154899,58117645,0,0
76586092,82,1,2353661,2353661,76586092,74232431,74232431,49436446,24795985,200,0
78089672,278,4,4494277,56484812,78089672,21604860,73595395,21056303,52539092,1,0
78529452,169,8,3855623,63406208,78529452,15123244,74673829,15123244,59550585,0,0
80789931,441,8,5611975,64288382,80789931,16501549,75177956,16501549,58676407,0,0
81896897,60,1,2341107,2341107,81896897,79555790,79555790,53019317,26536473,203,0
83502987,334,8,5061663,66914718,83502987,16588269,78441324,16588269,61853055,0,0
83680958,183,8,3993843,67085525,83680958,16595433,79687115,16595433,63091682,0,0
84109753,19,1,1943819,1943819,84109753,82165934,82165934,53480615,28685319,190,0
84789055,646,1,6495875,33582111,84789055,51206944,78293180,51206944,27086236,15,0
84863357,187,8,3994883,68028966,84863357,16834391,80868474,16834391,64034083,0,0
87278626,393,8,5305810,70362137,87278626,16916489,81972816,16916489,65056327,0,0
89982430,609,1,6472517,33582111,89982430,56400319,83509913,56400319,27109594,23,0
90539621,442,8,5611979,72796179,90539621,17743442,84927642,17743442,67184200,0,0
91774808,158,8,3817947,73845454,91774808,17929354,87956861,17929354,70027507,0,0
93114510,29,1,1943927,1943927,93114510,91170583,91170583,62359670,28810913,198,0
93641711,36,1,1943965,1943965,93641711,91697746,91697746,62385505,29312241,183,0
93913312,145,8,3668737,75848506,93913312,18064806,90244575,18064806,72179769,0,0
94111494,572,4,6083370,58540571,94111494,35570923,88028124,34598640,53429484,3,0
97196142,400,8,5321019,78529452,97196142,18666690,91875123,18666690,73208433,0,0
98696378,688,16,6998093,93913312,98696378,4783066,91698285,4783066,86915219,0,0
98872879,473,4,5709310,62915423,98872879,35957456,93163569,35957456,57206113,3,0
100648236,207,8,4098822,80789931,100648236,19858305,96549414,19858305,76691109,0,0
104568368,93,1,2372773,2372773,104568368,102195595,102195595,70853534,31342061,180,0
104656061,501,8,5818917,83502987,104656061,21153074,98837144,21153074,77684070,0,0
107289866,121,8,3336253,83680958,107289866,23608908,103953613,23608908,80344705,0,0
108385202,689,16,7063496,98696378,108385202,9688824,101321706,9688824,91632882,0,0
108481572,390,8,5305183,84863357,108481572,23618215,103176389,23618215,79558174,0,0
108830544,563,1,6050371,36397652,108830544,72432892,102780173,71295289,31484884,17,0
111686447,694,8,7188203,87278626,111686447,24407821,104498244,24407821,80090423,0,0
114253196,242,1,4238553,4238553,114253196,110014643,110014643,73979759,36034884,47,0
115632897,869,8,9352358,90539621,115632897,25093276,106280539,25093276,81187263,0,0
115731316,276,4,4483075,66779853,115731316,48951463,111248241,45504044,65744197,9,0
116975152,333,8,5061660,91774808,116975152,25200344,111913492,25200344,86713148,0,0
120245461,67,1,2352468,2352468,120245461,117892993,117892993,79862770,38030223,117,0
121105259,78,1,2353524,2353524,121105259,118751735,118751735,80653716,38098019,121,0
121123729,77,1,2353516,2353516,121123729,118770213,118770213,80672194,38098019,124,0
122369486,327,8,4968494,93114510,122369486,29254976,117400992,25972146,91428846,2,0
122406862,795,16,8462645,108385202,122406862,14021660,113944217,14021660,99922557,0,0
125826016,9,8,1429823,1429823,125826016,124396193,124396193,28776753,95619440,1,0
129083745,250,1,4238580,42843170,129083745,86240575,124845165,86240575,38604590,20,0
130281022,229,1,4238510,4238510,130281022,126042512,126042512,86244586,39797926,36,0
131524828,40,1,1945403,1945403,131524828,129579425,129579425,89597522,39981903,130,0
131872634,873,8,9352975,104656061,131872634,27216573,122519659,27216573,95303086,0,0
134421639,20,1,1943835,1943835,134421639,132477804,132477804,90183855,42293949,131,0
134619570,134,8,3573973,107289866,134619570,27329704,131045597,27329704,103715893,0,0
136016544,26,1,1943901,1943901,136016544,134072643,134072643,90403637,43669006,136,0
137230358,206,8,4098818,108481572,137230358,28748786,133131540,28748786,104382754,0,0
139235373,405,1,5343745,49188408,139235373,90046965,133891628,90046965,43844663,12,0
142870113,574,8,6135603,111686447,142870113,31183666,136734510,31183666,105550844,0,0
147617878,120,8,3336208,115632897,147617878,31984981,144281670,31984981,112296689,0,0
147751480,211,8,4099614,115731316,147751480,32020164,143651866,32020164,111631702,0,0
148728089,762,16,8040909,131524828,148728089,17203261,140687180,17203261,123483919,1,0
148751092,821,32,8967286,148728089,148751092,23003,139783806,23003,139760803,0,0
148831518,839,32,9308070,148751092,148831518,80426,139523448,80426,139443022,0,0
148996147,209,8,4099352,116975152,148996147,32020995,144896795,32020995,112875800,0,0
148998442,822,32,8967975,148831518,148998442,166924,140030467,166924,139863543,0,0
149807132,841,32,9313816,148998442,149807132,808690,140493316,808690,139684626,0,0
150383109,52,1,1945545,1945545,150383109,148437564,148437564,99748414,48689150,134,0
150882877,789,32,8334448,149807132,150882877,1075745,142548429,1075745,141472684,0,0
152063115,31,1,1943937,1943937,152063115,150119178,150119178,100695350,49423828,136,0
155077209,865,8,9323577,122369486,155077209,32707723,145753632,32707723,113045909,1,0
155675410,840,32,9312655,150882877,155675410,4792533,146362755,4792533,141570222,0,0
156220165,96,8,2471567,2895433,156220165,153324732,153748598,34153815,119594783,1,0
159925965,99,8,2918986,122406862,159925965,37519103,157006979,37519103,119487876,1,0
160711121,254,1,4242644,54186949,160711121,106524172,156468477,106524172,49944305,8,0
163717731,934,32,9632785,155675410,163717731,8042321,154084946,8042321,146042625,0,0
167401476,167,8,3854780,125826016,167401476,41575460,163546696,41227654,122319042,5,0
171039344,69,1,2353391,2353391,171039344,168685953,168685953,117124436,51561517,138,0
176290541,687,8,6997579,134619570,176290541,41670971,169292962,41670971,127621991,3,0
179882828,282,8,4513730,137230358,179882828,42652470,175369098,42652470,132716628,2,0
183002941,59,1,2326970,2326970,183002941,180675971,180675971,128284135,52391836,140,0
186565554,370,8,5232515,142870113,186565554,43695441,181333039,43695441,137637598,5,0
188624988,48,1,1945503,1945503,188624988,186679485,186679485,134287646,52391839,141,0
189107704,833,16,9129154,163717731,189107704,25389973,179978550,25389973,154588577,0,0
192490696,440,8,5609804,147617878,192490696,44872818,186880892,44604760,142276132,4,0
199546151,113,8,3244307,147751480,199546151,51794671,196301844,45445551,150856293,1,0
202112303,12,1,1943248,1943248,202112303,200169055,200169055,147777212,52391843,152,0
209134960,218,8,4207065,156220165,209134960,52914795,204927895,52914795,152013100,0,0
212100683,51,1,1945520,1945520,212100683,210155163,210155163,157763317,52391846,160,0
224387256,149,8,3675831,159925965,224387256,64461291,220711425,64461291,156250134,2,0
229749571,90,1,2372756,2372756,229749571,227376815,227376815,174217161,53159654,162,0
229865033,88,1,2372744,2372744,229865033,227492289,227492289,174218133,53274156,163,0
230775023,180,8,3991832,163717731,230775023,67057292,226783191,67057292,159725899,0,0
231892245,84,1,2354619,2354619,231892245,229537626,229537626,176129835,53407791,163,0
233968983,75,1,2353483,2353483,233968983,231615500,231615500,178138261,53477239,163,0
234493452,204,8,4098805,163717731,234493452,70775721,230394647,70775721,159618926,0,0
244985683,3,1,945683,945683,244985683,244040000,244040000,188749451,55290549,164,0
245085988,311,8,4720969,167401476,245085988,77684512,240365019,77684512,162680507,0,0
257532931,293,8,4527914,176290541,257532931,81242390,253005017,81242390,171762627,0,0
264723579,324,8,4951999,179882828,264723579,84840751,259771580,84840751,174930829,0,0
266429850,43,1,1945454,1945454,266429850,264484396,264484396,208384152,56100244,167,0
281204700,50,1,1945514,1945514,281204700,279259186,279259186,219650984,59608202,167,0
284926470,35,1,1943959,1943959,284926470,282982511,282982511,221628860,61353651,167,0
286976544,23,1,1943861,1943861,286976544,285032683,285032683,222369295,62663388,169,0
304021397,80,1,2353564,2353564,304021397,301667833,301667833,234038188,67629645,169,0
314427013,46,1,1945483,1945483,314427013,312481530,312481530,243779821,68701709,169,0
326894257,150,8,3698317,186565554,326894257,140328703,323195940,140328703,182867237,0,0
345595144,81,1,2353630,2353630,345595144,343241514,343241514,272836421,70405093,174,0
355331476,94,1,2372779,2372779,355331476,352958697,352958697,282036009,70922688,174,0
355626673,326,8,4959086,189107704,355626673,166518969,350667587,166518969,184148618,0,0
366726434,392,8,5305807,189107704,366726434,177618730,361420627,177618730,183801897,0,0
369562205,14,1,1943786,1943786,369562205,367618419,367618419,295257571,72360848,175,0
371647496,391,8,5305187,192490696,371647496,179156800,366342309,179156800,187185509,0,0
389984727,95,8,2471552,199546151,389984727,190438576,387513175,190438576,197074599,0,0
416891770,44,1,1945464,1945464,416891770,414946306,414946306,341081875,73864431,196,0
420599239,34,1,1943953,1943953,420599239,418655286,418655286,344249856,74405430,198,0
428359338,98,8,2746135,202112303,428359338,226247035,425613203,226247035,199366168,0,0
463836702,573,8,6135599,209134960,463836702,254701742,457701103,254701742,202999361,0,0
470534631,10,1,1639747,1639747,470534631,468894884,468894884,392159634,76735250,194,0
470897732,5,1,1245115,1245115,470897732,469652617,469652617,392891528,76761089,194,0
521805127,127,8,3512880,224387256,521805127,297417871,518292247,297417871,220874376,0,0
527174215,61,1,2341194,2341194,527174215,524833021,524833021,444263695,80569326,200,0
542152830,6,1,1245337,1245337,542152830,540907493,540907493,458042975,82864518,270,0
