time,job_id,num_gpu,submit_time,start_time,end_time,executed_time,JCT,duration,pending_time,preempt,promote
530126,1,8,70024,70024,530126,460102,460102,460102,0,0,0
665634,32,1,664372,664372,665634,1262,1262,1262,0,0,0
687406,24,16,401067,401067,687406,286339,286339,286339,0,0,0
690043,33,1,664544,664544,690043,25499,25499,25499,0,0,0
710349,18,16,394933,395522,710349,314827,315416,314827,589,0,0
738556,41,1,737793,737793,738556,763,763,763,0,0,0
738937,58,1,737907,737907,738937,1030,1030,1030,0,0,0
738940,57,1,737902,737902,738940,1038,1038,1038,0,0,0
739097,86,1,738163,738163,739097,934,934,934,0,0,0
739292,66,1,737957,737957,739292,1335,1335,1335,0,0,0
739531,55,1,737891,737891,739531,1640,1640,1640,0,0,0
739594,53,1,737875,737875,739594,1719,1719,1719,0,0,0
739818,64,1,737946,737946,739818,1872,1872,1872,0,0,0
742059,38,1,737775,737775,742059,4284,4284,4284,0,0,0
743682,47,1,737837,737837,743682,5845,5845,5845,0,0,0
744183,72,1,737996,737996,744183,6187,6187,6187,0,0,0
745531,71,1,737989,737989,745531,7542,7542,7542,0,0,0
746041,74,1,738019,738019,746041,8022,8022,8022,0,0,0
747545,70,1,737984,737984,747545,9561,9561,9561,0,0,0
748697,56,1,737896,737896,748697,10801,10801,10801,0,0,0
749618,49,1,737849,737849,749618,11769,11769,11769,0,0,0
752834,63,1,737941,737941,752834,14893,14893,14893,0,0,0
753683,85,1,738153,738153,753683,15530,15530,15530,0,0,0
753853,76,1,738038,738038,753853,15815,15815,15815,0,0,0
756513,54,1,737884,737884,756513,18629,18629,18629,0,0,0
756613,83,1,738129,738129,756613,18484,18484,18484,0,0,0
757381,79,1,738082,738082,757381,19299,19299,19299,0,0,0
761865,68,1,737967,737967,761865,23898,23898,23898,0,0,0
763606,42,1,737803,737803,763606,25803,25803,25803,0,0,0
764627,45,1,737821,737821,764627,26806,26806,26806,0,0,0
765097,89,1,738201,738201,765097,26896,26896,26896,0,0,0
768594,39,1,737781,737781,768594,30813,30813,30813,0,0,0
769411,73,1,738002,738002,769411,31409,31409,31409,0,0,0
776812,65,1,737952,737952,776812,38860,38860,38860,0,0,0
780611,62,1,737934,737934,780611,42677,42677,42677,0,0,0
787235,87,1,738170,738170,787235,49065,49065,49065,0,0,0
792330,82,1,738116,738116,792330,54214,54214,54214,0,0,0
813203,78,1,738069,738069,813203,75134,75134,75134,0,0,0
815214,31,1,664358,664358,815214,150856,150856,150856,0,0,0
827604,77,1,738049,738049,827604,89555,89555,89555,0,0,0
837932,40,1,737788,737788,837932,100144,100144,100144,0,0,0
855771,116,8,854211,854211,855771,1560,1560,1560,0,0,0
856384,117,8,854694,854694,856384,1690,1690,1690,0,0,0
859564,122,8,857621,857621,859564,1943,1943,1943,0,0,0
861207,124,8,857638,859564,861207,1643,3569,1643,1926,0,0
871116,128,8,857760,861207,871116,9909,13356,9909,3447,0,0
871468,52,1,737868,737868,871468,133600,133600,133600,0,0,0
871560,60,1,737918,737918,871560,133642,133642,133642,0,0,0
885624,119,8,855109,855115,885624,30509,30515,30509,6,0,0
888280,67,1,737962,737962,888280,150318,150318,150318,0,0,0
896466,90,1,738211,738211,896466,158255,158255,158255,0,0,0
899330,48,1,737844,737844,899330,161486,161486,161486,0,0,0
901477,118,8,854728,854728,901477,46749,46749,46749,0,0,0
915449,88,1,738194,738194,915449,177255,177255,177255,0,0,0
927710,133,8,869026,871116,927710,56594,58684,56594,2090,0,0
928344,59,1,737912,737912,928344,190432,190432,190432,0,0,0
929965,84,1,738137,738137,929965,191828,191828,191828,0,0,0
936453,120,8,855115,855118,936453,81335,81338,81335,3,0,0
944535,75,1,738025,738025,944535,206510,206510,206510,0,0,0
951024,51,1,737861,737861,951024,213163,213163,213163,0,0,0
952851,80,1,738097,738097,952851,214754,214754,214754,0,0,0
963738,121,8,855118,855118,963738,108620,108620,108620,0,0,0
964346,140,4,962109,962109,964346,2237,2237,2237,0,0,0
966555,43,1,737808,737808,966555,228747,228747,228747,0,0,0
976754,81,1,738103,738103,976754,238651,238651,238651,0,0,0
988931,69,1,737973,737973,988931,250958,250958,250958,0,0,0
1012448,151,8,995735,995735,1012448,16713,16713,16713,0,0,0
1013731,115,8,854174,854174,1013731,159557,159557,159557,0,0,0
1015312,114,8,854174,854728,1015312,160584,161138,160584,554,0,0
1019452,111,4,820970,820970,1019452,198482,198482,198482,0,0,0
1021342,141,4,962888,962888,1021342,58454,58454,58454,0,0,0
1021863,34,1,664555,664555,1021863,357308,357308,357308,0,0,0
1027503,156,8,996355,996356,1027503,31147,31148,31147,1,0,0
1027996,142,8,963205,963492,1027996,64504,64791,64504,287,0,0
1030509,50,1,737855,737855,1030509,292654,292654,292654,0,0,0
1048868,177,8,1047409,1047409,1048868,1459,1459,1459,0,0,0
1057244,159,8,996533,996533,1057244,60711,60711,60711,0,0,0
1075996,174,8,1047391,1047393,1075996,28603,28605,28603,2,0,0
1096518,46,1,737830,737830,1096518,358688,358688,358688,0,0,0
1105450,170,8,1047356,1047360,1105450,58090,58094,58090,4,0,0
1130036,155,8,995891,995891,1130036,134145,134145,134145,0,0,0
1138330,157,8,996356,996359,1138330,141971,141974,141971,3,0,0
1175117,61,1,737924,737924,1175117,437193,437193,437193,0,0,0
1226502,123,8,857634,857634,1226502,368868,368868,368868,0,0,0
1233084,154,8,995886,995886,1233084,237198,237198,237198,0,0,0
1238044,30,4,573378,573378,1238044,664666,664666,664666,0,0,0
1239516,44,1,737814,737814,1239516,501702,501702,501702,0,0,0
1251046,172,8,1047379,1047379,1251046,203667,203667,203667,0,0,0
1332346,175,8,1047393,1048868,1332346,283478,284953,283478,1475,0,0
1495815,153,8,995749,995749,1495815,500066,500066,500066,0,0,0
1518612,158,8,996359,1012448,1518612,506164,522253,506164,16089,0,0
1523241,143,8,963492,963738,1523241,559503,559749,559503,246,0,0
1539084,35,1,674938,674938,1539084,864146,864146,864146,0,4,0
1539796,186,8,1178859,1178859,1539796,360937,360937,360937,0,0,0
1562228,199,4,1511967,1511967,1562228,50261,50261,50261,0,0,0
1584003,181,8,1096098,1105450,1584003,478553,487905,478553,9352,0,0
1607814,137,4,960177,960177,1607814,647637,647637,647637,0,3,0
1635451,212,4,1631007,1631007,1635451,4444,4444,4444,0,0,0
1636212,235,8,1632770,1635451,1636212,761,3442,761,2681,0,0
1636571,135,4,905181,905181,1636571,731390,731390,714192,17198,1,0
1638554,223,4,1631550,1631550,1638554,7004,7004,7004,0,0,0
1641252,152,8,995747,995891,1641252,645361,645505,626408,19097,2,0
1669849,165,4,1019194,1019194,1669849,650655,650655,640820,9835,1,0
1687908,198,8,1450142,1450142,1687908,237766,237766,237766,0,0,0
1717626,195,16,1449863,1518612,1717626,199014,267763,199014,68749,0,0
1719510,160,8,996544,1021342,1719510,698168,722966,669565,53401,1,0
1727199,225,4,1631555,1631555,1727199,95644,95644,95644,0,0,0
1757176,219,4,1631071,1631071,1757176,126105,126105,126105,0,0,0
1771624,263,2,1770396,1770396,1771624,1228,1228,1228,0,0,0
1771767,269,2,1770441,1770441,1771767,1326,1326,1326,0,0,0
1771773,266,2,1770430,1770430,1771773,1343,1343,1343,0,0,0
1781346,272,4,1770525,1770574,1781346,10772,10821,10772,49,0,0
1782542,274,4,1770574,1770574,1782542,11968,11968,11968,0,0,0
1788173,265,2,1770407,1770407,1788173,17766,17766,17766,0,0,0
1790146,283,4,1774804,1774829,1790146,15317,15342,15317,25,0,0
1790589,228,4,1631570,1631570,1790589,159019,159019,159019,0,0,0
1796695,280,4,1774669,1774829,1796695,21866,22026,21866,160,0,0
1797107,268,2,1770435,1770435,1797107,26672,26672,26672,0,0,0
1800780,171,8,1047360,1130036,1800780,670744,753420,670744,82676,0,0
1804933,261,4,1770330,1770381,1804933,34552,34603,34552,51,0,0
1809773,247,2,1646510,1646510,1809773,163263,163263,163263,0,0,0
1832828,288,8,1819598,1822827,1832828,10001,13230,10001,3229,0,0
1836641,273,4,1770534,1771767,1836641,64874,66107,64874,1233,0,0
1838500,138,8,960874,960874,1838500,877626,877626,755528,122098,2,0
1838575,256,8,1729967,1729967,1838575,108608,108608,108608,0,0,0
1851600,193,8,1304054,1304054,1851600,547546,547546,547546,0,0,0
1853110,289,8,1822810,1832828,1853110,20282,30300,20282,10018,0,0
1860328,287,8,1819445,1836641,1860328,23687,40883,23687,17196,0,0
1862262,286,4,1774829,1781346,1862262,80916,87433,80916,6517,0,0
1864418,305,8,1856583,1860328,1864418,4090,7835,4090,3745,0,0
1869257,304,8,1856572,1864418,1869257,4839,12685,4839,7846,0,0
1874556,267,2,1770433,1770433,1874556,104123,104123,104123,0,0,0
1890743,290,8,1822816,1838500,1890743,52243,67927,52243,15684,0,0
1892175,202,4,1530394,1530394,1892175,361781,361781,361781,0,0,0
1893524,313,16,1889392,1890617,1893524,2907,4132,2907,1225,0,0
1894080,312,16,1886215,1890743,1894080,3337,7865,3337,4528,0,0
1898008,270,4,1770447,1770478,1898008,127530,127561,127530,31,0,0
1898308,301,16,1840047,1893524,1898308,4784,58261,4784,53477,0,0
1902990,275,4,1774471,1782542,1902990,120448,128519,120448,8071,0,0
1918560,303,8,1856559,1869257,1918560,49303,62001,49303,12698,0,0
1937870,264,2,1770401,1770401,1937870,167469,167469,167469,0,0,0
1959817,126,8,857742,885624,1959817,1074193,1102075,866683,235392,4,0
1964812,314,16,1889453,1894080,1964812,70732,75359,70732,4627,0,0
1994665,297,8,1822910,1838575,1994665,156090,171755,156090,15665,0,0
1995447,271,2,1770478,1770478,1995447,224969,224969,224969,0,0,0
2007117,262,2,1770381,1770381,2007117,236736,236736,236736,0,0,0
2013004,259,4,1767582,1767582,2013004,245422,245422,245422,0,0,0
2015710,232,8,1632632,1632658,2015710,383052,383078,383052,26,0,0
2018141,229,4,1631586,1631586,2018141,386555,386555,386555,0,0,0
2038433,215,4,1631039,1631039,2038433,407394,407394,407394,0,0,0
2044672,92,4,766066,766066,2044672,1278606,1278606,1175141,103465,59,0
2079515,328,4,2036130,2036130,2079515,43385,43385,43385,0,0,0
2119668,233,8,1632658,1636212,2119668,483456,487010,483456,3554,0,0
2119669,291,8,1822827,1851600,2119669,268069,296842,268069,28773,0,0
2144641,238,8,1641745,1641745,2144641,502896,502896,487579,15317,1,0
2164447,341,8,2163728,2163728,2164447,719,719,719,0,0,0
2187465,251,8,1687883,1687908,2187465,499557,499582,462086,37496,2,0
2230529,311,16,1883811,1898308,2230529,332221,346718,332221,14497,0,0
2246196,343,4,2185324,2185324,2246196,60872,60872,60872,0,0,0
2285106,327,4,2025109,2025109,2285106,259997,259997,259997,0,0,0
2303163,340,8,2163683,2164447,2303163,138716,139480,138716,764,0,0
2313429,356,8,2312628,2312628,2313429,801,801,801,0,0,0
2316678,353,8,2312551,2312551,2316678,4127,4127,4127,0,0,0
2317906,354,8,2312590,2313429,2317906,4477,5316,4477,839,0,0
2336557,351,8,2303532,2303532,2336557,33025,33025,33025,0,0,0
2336884,296,8,1822892,1853110,2336884,483774,513992,455831,58161,1,0
2347019,226,4,1631555,1631555,2347019,715464,715464,656545,58919,28,0
2348031,372,1,2347419,2347419,2348031,612,612,612,0,0,0
2352566,321,8,1989244,1994665,2352566,357901,363322,357901,5421,0,0
2355410,366,8,2322312,2322312,2355410,33098,33098,33098,0,0,0
2417997,161,8,996548,1238044,2417997,1179953,1421449,913602,507847,4,0
2423859,385,1,2422419,2422419,2423859,1440,1440,1440,0,0,0
2423931,382,4,2416845,2416845,2423931,7086,7086,7086,0,0,0
2427716,320,8,1989212,2007117,2427716,420599,438504,420599,17905,0,0
2428261,380,1,2413383,2413383,2428261,14878,14878,14878,0,0,0
2433185,364,8,2322273,2322273,2433185,110912,110912,110912,0,0,0
2434617,347,16,2294578,2294587,2434617,140030,140039,140030,9,0,0
2439043,384,4,2418837,2418837,2439043,20206,20206,20206,0,0,0
2452480,221,4,1631083,1631083,2452480,821397,821397,658378,163019,15,0
2472794,374,8,2348578,2352566,2472794,120228,124216,120228,3988,0,0
2474604,367,4,2327248,2327248,2474604,147356,147356,147356,0,0,0
2476646,373,1,2347446,2347446,2476646,129200,129200,129200,0,0,0
2485296,365,8,2322308,2336557,2485296,148739,162988,148739,14249,0,0
2505672,401,8,2495005,2495005,2505672,10667,10667,10667,0,0,0
2513120,394,4,2478535,2478535,2513120,34585,34585,34585,0,0,0
2513534,402,1,2499303,2499303,2513534,14231,14231,14231,0,0,0
2521485,389,4,2439592,2439592,2521485,81893,81893,81893,0,0,0
2522222,352,8,2312538,2312538,2522222,209684,209684,209684,0,0,0
2527608,387,1,2427720,2427720,2527608,99888,99888,99888,0,0,0
2533671,397,1,2480539,2480539,2533671,53132,53132,53132,0,0,0
2538397,406,1,2534033,2534033,2538397,4364,4364,4364,0,0,0
2543903,404,8,2516167,2521485,2543903,22418,27736,22418,5318,0,0
2549040,348,16,2294587,2303163,2549040,245877,254453,245877,8576,0,0
2556455,306,8,1856591,1964812,2556455,591643,699864,591643,108221,0,0
2575997,260,4,1769033,1769033,2575997,806964,806964,630453,176511,3,0
2606325,230,4,1631600,1719510,2606325,886815,974725,691051,283674,7,0
2606974,407,8,2578905,2606073,2606974,901,28069,901,27168,0,0
2615760,426,2,2613953,2613953,2615760,1807,1807,1807,0,0,0
2638872,243,2,1646494,1646510,2638872,992362,992378,986445,5933,123,0
2649574,428,2,2617413,2617413,2649574,32161,32161,32161,0,0,0
2658018,480,1,2657616,2657616,2658018,402,402,402,0,0,0
2658209,484,1,2657645,2657645,2658209,564,564,564,0,0,0
2658212,386,4,2427451,2427451,2658212,230761,230761,230761,0,0,0
2658456,470,1,2657555,2657555,2658456,901,901,901,0,0,0
2658471,451,1,2657376,2657376,2658471,1095,1095,1095,0,0,0
2658495,476,1,2657588,2657588,2658495,907,907,907,0,0,0
2658594,445,1,2657341,2657341,2658594,1253,1253,1253,0,0,0
2658771,477,1,2657599,2657599,2658771,1172,1172,1172,0,0,0
2659724,472,1,2657565,2657565,2659724,2159,2159,2159,0,0,0
2661515,525,1,2660848,2660848,2661515,667,667,667,0,0,0
2661516,457,1,2657416,2657416,2661516,4100,4100,4100,0,0,0
2661580,532,1,2661074,2661074,2661580,506,506,506,0,0,0
2661594,505,1,2660642,2660642,2661594,952,952,952,0,0,0
2661598,524,1,2660835,2660835,2661598,763,763,763,0,0,0
2661770,520,1,2660776,2660776,2661770,994,994,994,0,0,0
2661837,504,1,2660632,2660632,2661837,1205,1205,1205,0,0,0
2661934,513,1,2660670,2660670,2661934,1264,1264,1264,0,0,0
2662216,551,1,2661661,2661661,2662216,555,555,555,0,0,0
2662256,433,1,2657296,2657296,2662256,4960,4960,4960,0,0,0
2662258,560,1,2661676,2661676,2662258,582,582,582,0,0,0
2662289,556,1,2661668,2661668,2662289,621,621,621,0,0,0
2662332,552,1,2661661,2661661,2662332,671,671,671,0,0,0
2662401,568,1,2661689,2661689,2662401,712,712,712,0,0,0
2662413,603,1,2661782,2661782,2662413,631,631,631,0,0,0
2662446,561,1,2661678,2661678,2662446,768,768,768,0,0,0
2662547,583,1,2661732,2661732,2662547,815,815,815,0,0,0
2662613,582,1,2661732,2661732,2662613,881,881,881,0,0,0
2662750,617,1,2661961,2661961,2662750,789,789,789,0,0,0
2662761,613,1,2661932,2661932,2662761,829,829,829,0,0,0
2662802,569,1,2661691,2661691,2662802,1111,1111,1111,0,0,0
2662867,622,1,2661986,2661986,2662867,881,881,881,0,0,0
2662873,597,1,2661766,2661766,2662873,1107,1107,1107,0,0,0
2662929,636,1,2662103,2662103,2662929,826,826,826,0,0,0
2663162,620,1,2661979,2661979,2663162,1183,1183,1183,0,0,0
2663655,465,1,2657483,2657483,2663655,6172,6172,6172,0,0,0
2663673,490,1,2659714,2659714,2663673,3959,3959,3959,0,0,0
2663828,507,1,2660648,2660648,2663828,3180,3180,3180,0,0,0
2663873,464,1,2657479,2657479,2663873,6394,6394,6394,0,0,0
2664099,627,1,2662024,2662024,2664099,2075,2075,2075,0,0,0
2664104,515,1,2660677,2660677,2664104,3427,3427,3427,0,0,0
2664337,621,1,2661980,2661980,2664337,2357,2357,2357,0,0,0
2664545,553,1,2661664,2661664,2664545,2881,2881,2881,0,0,0
2664672,511,1,2660663,2660663,2664672,4009,4009,4009,0,0,0
2665894,530,1,2661028,2661028,2665894,4866,4866,4866,0,0,0
2666107,575,1,2661705,2661705,2666107,4402,4402,4402,0,0,0
2666753,482,1,2657623,2657623,2666753,9130,9130,9130,0,0,0
2666814,483,1,2657642,2657642,2666814,9172,9172,9172,0,0,0
2667060,534,1,2661089,2661089,2667060,5971,5971,5971,0,0,0
2667429,446,1,2657344,2657344,2667429,10085,10085,10085,0,0,0
2668098,615,1,2661950,2661950,2668098,6148,6148,6148,0,0,0
2668237,584,1,2661735,2661735,2668237,6502,6502,6502,0,0,0
2668324,601,1,2661778,2661778,2668324,6546,6546,6546,0,0,0
2668394,634,1,2662069,2662069,2668394,6325,6325,6325,0,0,0
2668570,487,1,2657661,2657661,2668570,10909,10909,10909,0,0,0
2668844,439,1,2657319,2657319,2668844,11525,11525,11525,0,0,0
2669289,587,1,2661740,2661740,2669289,7549,7549,7549,0,0,0
2669451,614,1,2661946,2661946,2669451,7505,7505,7505,0,0,0
2669561,629,1,2662046,2662046,2669561,7515,7515,7515,0,0,0
2669765,577,1,2661709,2661709,2669765,8056,8056,8056,0,0,0
2669879,541,1,2661159,2661159,2669879,8720,8720,8720,0,0,0
2670034,132,8,861366,888280,2670034,1781754,1808668,1042157,766511,19,0
2670034,565,1,2661684,2661684,2670034,8350,8350,8350,0,0,0
2670134,454,1,2657392,2657392,2670134,12742,12742,12742,0,0,0
2670159,493,1,2660591,2660591,2670159,9568,9568,9568,0,0,0
2670676,630,1,2662049,2662049,2670676,8627,8627,8627,0,0,0
2670764,502,1,2660623,2660623,2670764,10141,10141,10141,0,0,0
2670858,523,1,2660798,2660798,2670858,10060,10060,10060,0,0,0
2671002,713,1,2670581,2670581,2671002,421,421,421,0,0,0
2671021,656,1,2670204,2670204,2671021,817,817,817,0,0,0
2671058,711,1,2670522,2670522,2671058,536,536,536,0,0,0
2671068,697,1,2670381,2670381,2671068,687,687,687,0,0,0
2671137,510,1,2660659,2660659,2671137,10478,10478,10478,0,0,0
2671216,708,1,2670509,2670509,2671216,707,707,707,0,0,0
2671294,741,1,2670775,2670775,2671294,519,519,519,0,0,0
2671300,592,1,2661750,2661750,2671300,9550,9550,9550,0,0,0
2671313,725,1,2670673,2670673,2671313,640,640,640,0,0,0
2671315,692,1,2670374,2670374,2671315,941,941,941,0,0,0
2671330,671,1,2670285,2670285,2671330,1045,1045,1045,0,0,0
2671400,715,1,2670589,2670589,2671400,811,811,811,0,0,0
2671415,660,1,2670227,2670227,2671415,1188,1188,1188,0,0,0
2671423,716,1,2670603,2670603,2671423,820,820,820,0,0,0
2671473,724,1,2670672,2670672,2671473,801,801,801,0,0,0
2671516,672,1,2670287,2670287,2671516,1229,1229,1229,0,0,0
2671619,759,1,2670927,2670927,2671619,692,692,692,0,0,0
2671624,649,1,2670193,2670193,2671624,1431,1431,1431,0,0,0
2671642,669,1,2670282,2670282,2671642,1360,1360,1360,0,0,0
2671648,749,1,2670859,2670859,2671648,789,789,789,0,0,0
2671650,756,1,2670907,2670907,2671650,743,743,743,0,0,0
2671671,757,1,2670910,2670910,2671671,761,761,761,0,0,0
2671677,695,1,2670377,2670377,2671677,1300,1300,1300,0,0,0
2671697,755,1,2670904,2670904,2671697,793,793,793,0,0,0
2671755,736,1,2670738,2670738,2671755,1017,1017,1017,0,0,0
2671773,685,1,2670349,2670349,2671773,1424,1424,1424,0,0,0
2671864,837,1,2671453,2671453,2671864,411,411,411,0,0,0
2671977,702,1,2670405,2670405,2671977,1572,1572,1572,0,0,0
2671978,809,1,2671331,2671331,2671978,647,647,647,0,0,0
2671997,782,1,2671226,2671226,2671997,771,771,771,0,0,0
2672032,607,1,2661800,2661800,2672032,10232,10232,10232,0,0,0
2672038,703,1,2670406,2670406,2672038,1632,1632,1632,0,0,0
2672069,787,1,2671240,2671240,2672069,829,829,829,0,0,0
2672142,775,1,2671168,2671168,2672142,974,974,974,0,0,0
2672180,794,1,2671254,2671254,2672180,926,926,926,0,0,0
2672203,777,1,2671175,2671175,2672203,1028,1028,1028,0,0,0
2672219,550,1,2661658,2661658,2672219,10561,10561,10561,0,0,0
2672232,812,1,2671341,2671341,2672232,891,891,891,0,0,0
2672241,816,1,2671348,2671348,2672241,893,893,893,0,0,0
2672263,808,1,2671328,2671328,2672263,935,935,935,0,0,0
2672476,826,1,2671384,2671384,2672476,1092,1092,1092,0,0,0
2672487,529,1,2660962,2660962,2672487,11525,11525,11525,0,0,0
2672503,810,1,2671337,2671337,2672503,1166,1166,1166,0,0,0
2672652,500,1,2660616,2660616,2672652,12036,12036,12036,0,0,0
2672708,856,1,2671907,2671907,2672708,801,801,801,0,0,0
2672722,861,1,2671934,2671934,2672722,788,788,788,0,0,0
2672727,633,1,2662069,2662069,2672727,10658,10658,10658,0,0,0
2672806,880,1,2672344,2672344,2672806,462,462,462,0,0,0
2672837,496,1,2660603,2660603,2672837,12234,12234,12234,0,0,0
2672978,466,1,2657497,2657497,2672978,15481,15481,15481,0,0,0
2673076,491,1,2660584,2660584,2673076,12492,12492,12492,0,0,0
2673105,676,1,2670301,2670301,2673105,2804,2804,2804,0,0,0
2673272,868,1,2672043,2672043,2673272,1229,1229,1229,0,0,0
2673320,783,1,2671226,2671226,2673320,2094,2094,2094,0,0,0
2673426,650,1,2670193,2670193,2673426,3233,3233,3233,0,0,0
2673477,875,1,2672212,2672212,2673477,1265,1265,1265,0,0,0
2673702,665,1,2670265,2670265,2673702,3437,3437,3437,0,0,0
2673843,531,1,2661046,2661046,2673843,12797,12797,12797,0,0,0
2673873,771,1,2671026,2671026,2673873,2847,2847,2847,0,0,0
2674131,860,1,2671931,2671931,2674131,2200,2200,2200,0,0,0
2674170,474,1,2657574,2657574,2674170,16596,16596,16596,0,0,0
2674256,542,1,2661225,2661225,2674256,13031,13031,13031,0,0,0
2674308,509,1,2660655,2660655,2674308,13653,13653,13653,0,0,0
2674470,781,1,2671205,2671205,2674470,3265,3265,3265,0,0,0
2674485,766,1,2670986,2670986,2674485,3499,3499,3499,0,0,0
2674493,526,1,2660873,2660873,2674493,13620,13620,13620,0,0,0
2674594,871,1,2672072,2672072,2674594,2522,2522,2522,0,0,0
2674601,761,1,2670933,2670933,2674601,3668,3668,3668,0,0,0
2674709,878,1,2672325,2672325,2674709,2384,2384,2384,0,0,0
2674865,874,1,2672208,2672208,2674865,2657,2657,2657,0,0,0
2675003,579,1,2661712,2661712,2675003,13291,13291,13291,0,0,0
2675012,604,1,2661790,2661790,2675012,13222,13222,13222,0,0,0
2675068,774,1,2671076,2671076,2675068,3992,3992,3992,0,0,0
2675165,768,1,2670997,2670997,2675165,4168,4168,4168,0,0,0
2675316,746,1,2670789,2670789,2675316,4527,4527,4527,0,0,0
2675621,539,1,2661128,2661128,2675621,14493,14493,14493,0,0,0
2675677,598,1,2661772,2661772,2675677,13905,13905,13905,0,0,0
2675709,463,1,2657471,2657471,2675709,18238,18238,18238,0,0,0
2675715,643,1,2670112,2670112,2675715,5603,5603,5603,0,0,0
2675842,647,1,2670190,2670190,2675842,5652,5652,5652,0,0,0
2676110,788,1,2671241,2671241,2676110,4869,4869,4869,0,0,0
2676202,885,1,2675803,2675803,2676202,399,399,399,0,0,0
2676330,887,1,2675807,2675807,2676330,523,523,523,0,0,0
2676483,827,1,2671386,2671386,2676483,5097,5097,5097,0,0,0
2676553,605,1,2661790,2661790,2676553,14763,14763,14763,0,0,0
2676610,894,1,2675823,2675823,2676610,787,787,787,0,0,0
2676610,912,1,2675895,2675895,2676610,715,715,715,0,0,0
2676649,916,1,2675921,2675921,2676649,728,728,728,0,0,0
2676649,927,1,2676203,2676203,2676649,446,446,446,0,0,0
2676713,928,1,2676256,2676256,2676713,457,457,457,0,0,0
2676749,729,1,2670700,2670700,2676749,6049,6049,6049,0,0,0
2676791,909,1,2675877,2675877,2676791,914,914,914,0,0,0
2677172,652,1,2670198,2670198,2677172,6974,6974,6974,0,0,0
2677173,726,1,2670676,2670676,2677173,6497,6497,6497,0,0,0
2677804,489,1,2657676,2657676,2677804,20128,20128,20128,0,0,0
2677849,733,1,2670728,2670728,2677849,7121,7121,7121,0,0,0
2677898,722,1,2670654,2670654,2677898,7244,7244,7244,0,0,0
2677996,891,1,2675815,2675815,2677996,2181,2181,2181,0,0,0
2677997,442,1,2657329,2657329,2677997,20668,20668,20668,0,0,0
2678007,721,1,2670649,2670649,2678007,7358,7358,7358,0,0,0
2678399,850,1,2671853,2671853,2678399,6546,6546,6546,0,0,0
2678442,567,1,2661688,2661688,2678442,16754,16754,16754,0,0,0
2678506,917,1,2675922,2675922,2678506,2584,2584,2584,0,0,0
2678583,570,1,2661692,2661692,2678583,16891,16891,16891,0,0,0
2678642,855,1,2671897,2671897,2678642,6745,6745,6745,0,0,0
2678721,719,1,2670631,2670631,2678721,8090,8090,8090,0,0,0
2678835,893,1,2675823,2675823,2678835,3012,3012,3012,0,0,0
2678871,918,1,2675929,2675929,2678871,2942,2942,2942,0,0,0
2678942,478,1,2657606,2657606,2678942,21336,21336,21336,0,0,0
2678946,517,1,2660739,2660739,2678946,18207,18207,18207,0,0,0
2679109,779,1,2671201,2671201,2679109,7908,7908,7908,0,0,0
2679125,651,1,2670197,2670197,2679125,8928,8928,8928,0,0,0
2679436,623,1,2661996,2661996,2679436,17440,17440,17440,0,0,0
2679476,905,1,2675865,2675865,2679476,3611,3611,3611,0,0,0
2679648,680,1,2670322,2670322,2679648,9326,9326,9326,0,0,0
2679665,562,1,2661679,2661679,2679665,17986,17986,17986,0,0,0
2679687,847,1,2671816,2671816,2679687,7871,7871,7871,0,0,0
2679805,701,1,2670401,2670401,2679805,9404,9404,9404,0,0,0
2680027,851,1,2671874,2671874,2680027,8153,8153,8153,0,0,0
2680225,854,1,2671897,2671897,2680225,8328,8328,8328,0,0,0
2680485,800,1,2671300,2671300,2680485,9185,9185,9185,0,0,0
2680492,732,1,2670715,2670715,2680492,9777,9777,9777,0,0,0
2680707,866,1,2672033,2672033,2680707,8674,8674,8674,0,0,0
2680732,540,1,2661154,2661154,2680732,19578,19578,19578,0,0,0
2680858,734,1,2670732,2670732,2680858,10126,10126,10126,0,0,0
2680979,819,1,2671352,2671352,2680979,9627,9627,9627,0,0,0
2680999,499,1,2660613,2660613,2680999,20386,20386,20386,0,0,0
2681013,674,1,2670291,2670291,2681013,10722,10722,10722,0,0,0
2681072,740,1,2670773,2670773,2681072,10299,10299,10299,0,0,0
2681339,535,1,2661092,2661092,2681339,20247,20247,20247,0,0,0
2681550,700,1,2670401,2670401,2681550,11149,11149,11149,0,0,0
2681551,581,1,2661718,2661718,2681551,19833,19833,19833,0,0,0
2681620,475,1,2657581,2657581,2681620,24039,24039,24039,0,0,0
2681685,438,1,2657316,2657316,2681685,24369,24369,24369,0,0,0
2681960,423,2,2606073,2606073,2681960,75887,75887,75887,0,0,0
2682043,557,1,2661671,2661671,2682043,20372,20372,20372,0,0,0
2682181,595,1,2661757,2661757,2682181,20424,20424,20424,0,0,0
2682218,903,1,2675854,2675854,2682218,6364,6364,6364,0,0,0
2682520,920,1,2675939,2675939,2682520,6581,6581,6581,0,0,0
2682724,537,1,2661117,2661117,2682724,21607,21607,21607,0,0,0
2682803,658,1,2670218,2670218,2682803,12585,12585,12585,0,0,0
2683032,516,1,2660681,2660681,2683032,22351,22351,22351,0,0,0
2683048,709,1,2670510,2670510,2683048,12538,12538,12538,0,0,0
2683051,914,1,2675901,2675901,2683051,7150,7150,7150,0,0,0
2683077,911,1,2675887,2675887,2683077,7190,7190,7190,0,0,0
2683375,753,1,2670899,2670899,2683375,12476,12476,12476,0,0,0
2683427,738,1,2670765,2670765,2683427,12662,12662,12662,0,0,0
2683499,395,4,2478535,2478535,2683499,204964,204964,204964,0,0,0
2683508,822,1,2671365,2671365,2683508,12143,12143,12143,0,0,0
2683727,653,1,2670200,2670200,2683727,13527,13527,13527,0,0,0
2683759,944,1,2682871,2682871,2683759,888,888,888,0,0,0
2683769,962,1,2683056,2683056,2683769,713,713,713,0,0,0
2683782,954,1,2682971,2682971,2683782,811,811,811,0,0,0
2683819,506,1,2660645,2660645,2683819,23174,23174,23174,0,0,0
2683831,935,1,2682782,2682782,2683831,1049,1049,1049,0,0,0
2683901,752,1,2670896,2670896,2683901,13005,13005,13005,0,0,0
2683915,681,1,2670323,2670323,2683915,13592,13592,13592,0,0,0
2683956,1006,1,2683473,2683473,2683956,483,483,483,0,0,0
2683967,950,1,2682931,2682931,2683967,1036,1036,1036,0,0,0
2683977,1011,1,2683541,2683541,2683977,436,436,436,0,0,0
2683980,437,1,2657313,2657313,2683980,26667,26667,26667,0,0,0
2683983,455,1,2657399,2657399,2683983,26584,26584,26584,0,0,0
2683987,931,1,2682750,2682750,2683987,1237,1237,1237,0,0,0
2684021,730,1,2670708,2670708,2684021,13313,13313,13313,0,0,0
2684140,599,1,2661772,2661772,2684140,22368,22368,22368,0,0,0
2684193,973,1,2683183,2683183,2684193,1010,1010,1010,0,0,0
2684227,739,1,2670765,2670765,2684227,13462,13462,13462,0,0,0
2684264,943,1,2682867,2682867,2684264,1397,1397,1397,0,0,0
2684274,951,1,2682968,2682968,2684274,1306,1306,1306,0,0,0
2684304,1022,1,2683621,2683621,2684304,683,683,683,0,0,0
2684308,1048,1,2683726,2683726,2684308,582,582,582,0,0,0
2684312,982,1,2683273,2683273,2684312,1039,1039,1039,0,0,0
2684327,1014,1,2683557,2683557,2684327,770,770,770,0,0,0
2684357,956,1,2683031,2683031,2684357,1326,1326,1326,0,0,0
2684365,1026,1,2683628,2683628,2684365,737,737,737,0,0,0
2684372,966,1,2683114,2683114,2684372,1258,1258,1258,0,0,0
2684392,959,1,2683041,2683041,2684392,1351,1351,1351,0,0,0
2684418,1015,1,2683563,2683563,2684418,855,855,855,0,0,0
2684486,600,1,2661778,2661778,2684486,22708,22708,22708,0,0,0
2684511,1037,1,2683696,2683696,2684511,815,815,815,0,0,0
2684541,1034,1,2683685,2683685,2684541,856,856,856,0,0,0
2684557,890,1,2675814,2675814,2684557,8743,8743,8743,0,0,0
2684672,981,1,2683270,2683270,2684672,1402,1402,1402,0,0,0
2684713,881,1,2672352,2672352,2684713,12361,12361,12361,0,0,0
2684721,977,1,2683200,2683200,2684721,1521,1521,1521,0,0,0
2684742,1078,1,2684119,2684119,2684742,623,623,623,0,0,0
2684756,1053,1,2683744,2683744,2684756,1012,1012,1012,0,0,0
2684759,1097,1,2684196,2684196,2684759,563,563,563,0,0,0
2684845,1067,1,2684042,2684042,2684845,803,803,803,0,0,0
2684857,735,1,2670735,2670735,2684857,14122,14122,14122,0,0,0
2684895,859,1,2671931,2671931,2684895,12964,12964,12964,0,0,0
2684921,996,1,2683359,2683359,2684921,1562,1562,1562,0,0,0
2684925,1098,1,2684196,2684196,2684925,729,729,729,0,0,0
2684930,1065,1,2683814,2683814,2684930,1116,1116,1116,0,0,0
2684976,1039,1,2683703,2683703,2684976,1273,1273,1273,0,0,0
2684988,1135,1,2684515,2684515,2684988,473,473,473,0,0,0
2685034,1102,1,2684209,2684209,2685034,825,825,825,0,0,0
2685048,1069,1,2684077,2684077,2685048,971,971,971,0,0,0
2685092,1129,1,2684352,2684352,2685092,740,740,740,0,0,0
2685102,1044,1,2683716,2683716,2685102,1386,1386,1386,0,0,0
2685128,1084,1,2684163,2684163,2685128,965,965,965,0,0,0
2685138,1068,1,2684045,2684045,2685138,1093,1093,1093,0,0,0
2685166,797,1,2671293,2671293,2685166,13873,13873,13873,0,0,0
2685170,1124,1,2684316,2684316,2685170,854,854,854,0,0,0
2685174,1079,1,2684122,2684122,2685174,1052,1052,1052,0,0,0
2685303,1134,1,2684456,2684456,2685303,847,847,847,0,0,0
2685340,1081,1,2684142,2684142,2685340,1198,1198,1198,0,0,0
2685349,1156,1,2684899,2684899,2685349,450,450,450,0,0,0
2685356,1136,1,2684711,2684711,2685356,645,645,645,0,0,0
2685394,1091,1,2684177,2684177,2685394,1217,1217,1217,0,0,0
2685470,1152,1,2684888,2684888,2685470,582,582,582,0,0,0
2685489,999,1,2683366,2683366,2685489,2123,2123,2123,0,0,0
2685549,1117,1,2684301,2684301,2685549,1248,1248,1248,0,0,0
2685618,949,1,2682930,2682930,2685618,2688,2688,2688,0,0,0
2685638,1164,1,2684952,2684952,2685638,686,686,686,0,0,0
2685649,1145,1,2684851,2684851,2685649,798,798,798,0,0,0
2685654,434,1,2657299,2657299,2685654,28355,28355,28355,0,0,0
2685658,1155,1,2684896,2684896,2685658,762,762,762,0,0,0
2685735,1147,1,2684862,2684862,2685735,873,873,873,0,0,0
2685772,1153,1,2684892,2684892,2685772,880,880,880,0,0,0
2685783,883,1,2675796,2675796,2685783,9987,9987,9987,0,0,0
2685840,1010,1,2683521,2683521,2685840,2319,2319,2319,0,0,0
2686069,1143,1,2684845,2684845,2686069,1224,1224,1224,0,0,0
2686101,1176,1,2685444,2685444,2686101,657,657,657,0,0,0
2686178,913,1,2675895,2675895,2686178,10283,10283,10283,0,0,0
2686198,1158,1,2684914,2684914,2686198,1284,1284,1284,0,0,0
2686212,453,1,2657387,2657387,2686212,28825,28825,28825,0,0,0
2686320,1182,1,2685462,2685462,2686320,858,858,858,0,0,0
2686498,1113,1,2684255,2684255,2686498,2243,2243,2243,0,0,0
2686615,1246,1,2685882,2685882,2686615,733,733,733,0,0,0
2686626,1233,1,2685752,2685752,2686626,874,874,874,0,0,0
2686627,1224,1,2685678,2685678,2686627,949,949,949,0,0,0
2686665,578,1,2661711,2661711,2686665,24954,24954,24954,0,0,0
2686804,514,1,2660673,2660673,2686804,26131,26131,26131,0,0,0
2686810,571,1,2661698,2661698,2686810,25112,25112,25112,0,0,0
2686824,1255,1,2685968,2685968,2686824,856,856,856,0,0,0
2686855,1215,1,2685615,2685615,2686855,1240,1240,1240,0,0,0
2686858,896,1,2675834,2675834,2686858,11024,11024,11024,0,0,0
2686882,1214,1,2685615,2685615,2686882,1267,1267,1267,0,0,0
2686925,790,1,2671244,2671244,2686925,15681,15681,15681,0,0,0
2686947,1282,1,2686252,2686252,2686947,695,695,695,0,0,0
2687091,845,1,2671638,2671638,2687091,15453,15453,15453,0,0,0
2687135,1274,1,2686166,2686166,2687135,969,969,969,0,0,0
2687144,456,1,2657407,2657407,2687144,29737,29737,29737,0,2,0
2687227,1276,1,2686224,2686224,2687227,1003,1003,1003,0,0,0
2687240,1149,1,2684871,2684871,2687240,2369,2369,2369,0,0,0
2687250,1096,1,2684193,2684193,2687250,3057,3057,3057,0,0,0
2687263,737,1,2670761,2670761,2687263,16502,16502,16488,14,3,0
2687277,1216,1,2685619,2685619,2687277,1658,1658,1658,0,0,0
2687318,852,1,2671874,2671874,2687318,15444,15444,15444,0,0,0
2687338,1089,1,2684174,2684174,2687338,3164,3164,3164,0,0,0
2687418,886,1,2675803,2675803,2687418,11615,11615,11615,0,0,0
2687521,1017,1,2683574,2683574,2687521,3947,3947,3947,0,0,0
2687567,926,1,2676124,2676124,2687567,11443,11443,11443,0,0,0
2687598,831,1,2671438,2671438,2687598,16160,16160,16160,0,4,0
2687620,1159,1,2684918,2684918,2687620,2702,2702,2702,0,0,0
2687760,574,1,2661702,2661702,2687760,26058,26058,26007,51,14,0
2687961,969,1,2683118,2683118,2687961,4843,4843,4843,0,0,0
2688023,1077,1,2684119,2684119,2688023,3904,3904,3904,0,0,0
2688168,1040,1,2683705,2683705,2688168,4463,4463,4463,0,0,0
2688318,1099,1,2684199,2684199,2688318,4119,4119,4119,0,0,0
2688365,780,1,2671204,2671204,2688365,17161,17161,17025,136,15,0
2688437,1308,1,2687939,2687939,2688437,498,498,498,0,0,0
2688459,1163,1,2684942,2684942,2688459,3517,3517,3517,0,0,0
2688472,1344,1,2688006,2688006,2688472,466,466,466,0,0,0
2688479,1331,1,2687981,2687981,2688479,498,498,498,0,0,0
2688575,898,1,2675840,2675840,2688575,12735,12735,12735,0,0,0
2688591,965,1,2683059,2683059,2688591,5532,5532,5532,0,0,0
2688613,1237,1,2685834,2685834,2688613,2779,2779,2779,0,0,0
2688616,1253,1,2685964,2685964,2688616,2652,2652,2652,0,0,0
2688676,1315,1,2687952,2687952,2688676,724,724,724,0,0,0
2688775,723,1,2670661,2670661,2688775,18114,18114,17804,310,9,0
2688788,1301,1,2687928,2687928,2688788,860,860,860,0,0,0
2688800,897,1,2675834,2675834,2688800,12966,12966,12966,0,0,0
2688817,1290,1,2687898,2687898,2688817,919,919,919,0,0,0
2688849,679,1,2670319,2670319,2688849,18530,18530,18203,327,12,0
2688911,1316,1,2687955,2687955,2688911,956,956,956,0,0,0
2688928,1327,1,2687973,2687973,2688928,955,955,955,0,0,0
2688932,1248,1,2685921,2685921,2688932,3011,3011,3011,0,0,0
2688983,1299,1,2687924,2687924,2688983,1059,1059,1059,0,0,0
2688984,1311,1,2687945,2687945,2688984,1039,1039,1039,0,0,0
2689013,1298,1,2687921,2687921,2689013,1092,1092,1092,0,0,0
2689014,1319,1,2687960,2687960,2689014,1054,1054,1054,0,0,0
2689016,1317,1,2687956,2687956,2689016,1060,1060,1060,0,0,0
2689033,1357,1,2688280,2688280,2689033,753,753,753,0,0,0
2689068,1293,1,2687906,2687906,2689068,1162,1162,1162,0,0,0
2689070,1373,1,2688472,2688472,2689070,598,598,598,0,0,0
2689117,624,1,2661999,2661999,2689117,27118,27118,26744,374,23,0
2689121,1322,1,2687965,2687965,2689121,1156,1156,1156,0,0,0
2689126,1361,1,2688393,2688393,2689126,733,733,733,0,0,0
2689315,1360,1,2688393,2688393,2689315,922,922,922,0,0,0
2689347,815,1,2671346,2671650,2689347,17697,18001,17471,530,12,0
2689395,1266,1,2686022,2686022,2689395,3373,3373,3373,0,0,0
2689461,961,1,2683052,2683052,2689461,6409,6409,6409,0,0,0
2689482,1367,1,2688426,2688426,2689482,1056,1056,1056,0,0,0
2689550,548,1,2661654,2661654,2689550,27896,27896,27213,683,20,0
2689818,989,1,2683293,2683293,2689818,6525,6525,6525,0,0,0
2689838,801,1,2671317,2671317,2689838,18521,18521,17719,802,14,0
2689840,1364,1,2688411,2688411,2689840,1429,1429,1429,0,0,0
2689950,1181,1,2685459,2685459,2689950,4491,4491,4491,0,0,0
2690096,640,1,2669790,2669790,2690096,20306,20306,19345,961,13,0
2690096,1016,1,2683565,2683565,2690096,6531,6531,6531,0,0,0
2690320,712,1,2670578,2670578,2690320,19742,19742,18650,1092,10,0
2690544,1283,1,2686284,2686284,2690544,4260,4260,4260,0,0,0
2690558,1263,1,2686011,2686011,2690558,4547,4547,4547,0,0,0
2690577,1168,1,2685059,2685059,2690577,5518,5518,5518,0,0,0
2690592,1213,1,2685589,2685589,2690592,5003,5003,5003,0,0,0
2690658,1294,1,2687908,2687908,2690658,2750,2750,2750,0,0,0
2690687,879,1,2672333,2672652,2690687,18035,18354,18035,319,1,0
2690736,1201,1,2685514,2685514,2690736,5222,5222,5222,0,0,0
2690818,449,1,2657355,2657355,2690818,33463,33463,32038,1425,8,0
2690869,1304,1,2687932,2687932,2690869,2937,2937,2937,0,0,0
2691129,834,1,2671449,2672722,2691129,18407,19680,18407,1273,1,0
2691217,1284,1,2686288,2686288,2691217,4929,4929,4929,0,0,0
2691311,763,1,2670940,2670940,2691311,20371,20371,18870,1501,4,0
2691425,796,1,2671293,2672806,2691425,18619,20132,18619,1513,1,0
2691913,1236,1,2685805,2685805,2691913,6108,6108,6108,0,0,0
2692012,899,1,2675840,2675840,2692012,16172,16172,16172,0,0,0
2692060,1138,1,2684758,2684758,2692060,7302,7302,7302,0,0,0
2692157,978,1,2683270,2683270,2692157,8887,8887,8887,0,0,0
2692211,786,1,2671237,2672837,2692211,19374,20974,19374,1600,1,0
2692249,921,1,2675940,2675940,2692249,16309,16309,16309,0,0,0
2692320,895,1,2675828,2675828,2692320,16492,16492,16492,0,0,0
2692439,835,1,2671449,2672978,2692439,19461,20990,19461,1529,1,0
2692444,1013,1,2683557,2683557,2692444,8887,8887,8887,0,0,0
2692445,1244,1,2685875,2685875,2692445,6570,6570,6570,0,0,0
2692463,1272,1,2686079,2686079,2692463,6384,6384,6384,0,0,0
2692496,1221,1,2685635,2685635,2692496,6861,6861,6861,0,0,0
2692515,1309,1,2687942,2687942,2692515,4573,4573,4573,0,0,0
2692638,1387,1,2692016,2692016,2692638,622,622,622,0,0,0
2692691,858,1,2671923,2673076,2692691,19615,20768,19615,1153,1,0
2692717,884,1,2675799,2675799,2692717,16918,16918,16918,0,0,0
2692757,1460,1,2692143,2692143,2692757,614,614,614,0,0,0
2692770,1512,1,2692270,2692270,2692770,500,500,500,0,0,0
2692772,1389,1,2692019,2692019,2692772,753,753,753,0,0,0
2692786,793,1,2671250,2673105,2692786,19681,21536,19681,1855,1,0
2692793,1526,1,2692358,2692358,2692793,435,435,435,0,0,0
2692796,1438,1,2692106,2692106,2692796,690,690,690,0,0,0
2692847,1029,1,2683648,2683648,2692847,9199,9199,9199,0,0,0
2692862,1488,1,2692204,2692204,2692862,658,658,658,0,0,0
2692896,1445,1,2692121,2692121,2692896,775,775,775,0,0,0
2692898,1419,1,2692087,2692087,2692898,811,811,811,0,0,0
2692932,1392,1,2692023,2692023,2692932,909,909,909,0,0,0
2692941,1424,1,2692091,2692091,2692941,850,850,850,0,0,0
2692952,1417,1,2692084,2692084,2692952,868,868,868,0,0,0
2692952,1433,1,2692103,2692103,2692952,849,849,849,0,0,0
2692979,1450,1,2692130,2692130,2692979,849,849,849,0,0,0
2692999,1514,1,2692291,2692291,2692999,708,708,708,0,0,0
2693003,1418,1,2692084,2692084,2693003,919,919,919,0,0,0
2693003,1474,1,2692193,2692193,2693003,810,810,810,0,0,0
2693016,1413,1,2692076,2692076,2693016,940,940,940,0,0,0
2693022,1506,1,2692248,2692248,2693022,774,774,774,0,0,0
2693056,1432,1,2692099,2692099,2693056,957,957,957,0,0,0
2693075,1412,1,2692076,2692076,2693075,999,999,999,0,0,0
2693075,1473,1,2692192,2692192,2693075,883,883,883,0,0,0
2693082,838,1,2671456,2673272,2693082,19810,21626,19810,1816,3,0
2693085,1575,1,2692482,2692482,2693085,603,603,603,0,0,0
2693087,1522,1,2692329,2692329,2693087,758,758,758,0,0,0
2693088,1402,1,2692032,2692032,2693088,1056,1056,1056,0,0,0
2693100,1114,1,2684296,2684296,2693100,8804,8804,8804,0,0,0
2693110,1523,1,2692329,2692329,2693110,781,781,781,0,0,0
2693131,1559,1,2692451,2692451,2693131,680,680,680,0,0,0
2693165,1574,1,2692478,2692478,2693165,687,687,687,0,0,0
2693170,1420,1,2692088,2692088,2693170,1082,1082,1082,0,0,0
2693232,1256,1,2685972,2685972,2693232,7260,7260,7260,0,0,0
2693268,1396,1,2692027,2692027,2693268,1241,1241,1241,0,0,0
2693277,1261,1,2686003,2686003,2693277,7274,7274,7274,0,0,0
2693326,1581,1,2692498,2692498,2693326,828,828,828,0,0,0
2693334,995,1,2683358,2683358,2693334,9976,9976,9976,0,0,0
2693339,1464,1,2692151,2692151,2693339,1188,1188,1188,0,0,0
2693342,1540,1,2692387,2692387,2693342,955,955,955,0,0,0
2693361,1583,1,2692502,2692502,2693361,859,859,859,0,0,0
2693363,1539,1,2692386,2692386,2693363,977,977,977,0,0,0
2693368,1119,1,2684304,2684304,2693368,9064,9064,9064,0,0,0
2693377,441,1,2657326,2657326,2693377,36051,36051,33872,2179,16,0
2693385,1491,1,2692208,2692208,2693385,1177,1177,1177,0,0,0
2693401,1028,1,2683637,2683637,2693401,9764,9764,9764,0,0,0
2693402,1503,1,2692228,2692228,2693402,1174,1174,1174,0,0,0
2693403,1571,1,2692474,2692474,2693403,929,929,929,0,0,0
2693414,1475,1,2692193,2692193,2693414,1221,1221,1221,0,0,0
2693420,1580,1,2692498,2692498,2693420,922,922,922,0,0,0
2693430,1259,1,2685997,2685997,2693430,7433,7433,7433,0,0,0
2693463,974,1,2683185,2683185,2693463,10278,10278,10278,0,0,0
2693518,1490,1,2692208,2692208,2693518,1310,1310,1310,0,0,0
2693525,1070,1,2684078,2684078,2693525,9447,9447,9447,0,0,0
2693544,1126,1,2684345,2684345,2693544,9199,9199,9199,0,0,0
2693613,1577,1,2692491,2692491,2693613,1122,1122,1122,0,0,0
2693653,1195,1,2685504,2685504,2693653,8149,8149,8149,0,0,0
2693668,1563,1,2692462,2692462,2693668,1206,1206,1206,0,0,0
2693690,1462,1,2692143,2692143,2693690,1547,1547,1547,0,0,0
2693696,1501,1,2692222,2692222,2693696,1474,1474,1474,0,0,0
2693715,1082,1,2684143,2684143,2693715,9572,9572,9572,0,0,0
2693762,1118,1,2684304,2684304,2693762,9458,9458,9458,0,0,0
2693810,1477,1,2692196,2692196,2693810,1614,1614,1614,0,0,0
2693853,1554,1,2692445,2692445,2693853,1408,1408,1408,0,0,0
2693899,1578,1,2692492,2692492,2693899,1407,1407,1407,0,0,0
2694014,1019,1,2683583,2683583,2694014,10431,10431,10431,0,0,0
2694085,1050,1,2683737,2683737,2694085,10348,10348,10348,0,0,0
2694120,1111,1,2684249,2684249,2694120,9871,9871,9871,0,0,0
2694149,1031,1,2683652,2683652,2694149,10497,10497,10497,0,0,0
2694153,1093,1,2684181,2684181,2694153,9972,9972,9972,0,0,0
2694255,1465,1,2692151,2692151,2694255,2104,2104,2104,0,0,0
2694327,1112,1,2684251,2684251,2694327,10076,10076,10076,0,0,0
2694335,448,1,2657352,2657352,2694335,36983,36983,34233,2750,11,0
2694401,1356,1,2688278,2688278,2694401,6123,6123,6123,0,0,0
2694815,805,1,2671324,2673477,2694815,21338,23491,20724,2767,5,0
2694967,1285,1,2686301,2686301,2694967,8666,8666,8666,0,0,0
2695048,1508,1,2692254,2692254,2695048,2794,2794,2794,0,0,0
2695114,988,1,2683290,2683290,2695114,11824,11824,11824,0,0,0
2695138,1481,1,2692199,2692199,2695138,2939,2939,2939,0,0,0
2695175,718,1,2670626,2670626,2695175,24549,24549,21362,3187,14,0
2695176,1128,1,2684349,2684349,2695176,10827,10827,10827,0,0,0
2695185,1116,1,2684301,2684301,2695185,10884,10884,10884,0,0,0
2695284,1455,1,2692135,2692135,2695284,3149,3149,3149,0,0,0
2695290,1323,1,2687966,2687966,2695290,7324,7324,7324,0,0,0
2695429,593,1,2661752,2661752,2695429,33677,33677,30254,3423,15,0
2695503,1061,1,2683782,2683782,2695503,11721,11721,11721,0,0,0
2695512,975,1,2683188,2683188,2695512,12324,12324,12324,0,0,0
2695684,1234,1,2685797,2685797,2695684,9887,9887,9887,0,0,0
2695721,1363,1,2688408,2688408,2695721,7313,7313,7313,0,0,0
2695759,1314,1,2687950,2687950,2695759,7809,7809,7809,0,0,0
2695777,1451,1,2692131,2692131,2695777,3646,3646,3646,0,0,0
2695800,1366,1,2688422,2688422,2695800,7378,7378,7378,0,0,0
2695812,1289,1,2687894,2687894,2695812,7918,7918,7918,0,0,0
2695815,1020,1,2683588,2683588,2695815,12227,12227,12227,0,0,0
2695819,435,1,2657305,2657305,2695819,38514,38514,34892,3622,9,0
2695844,1239,1,2685841,2685841,2695844,10003,10003,10003,0,0,0
2696100,825,1,2671383,2674131,2696100,21969,24717,21221,3496,4,0
2696100,1109,1,2684245,2684245,2696100,11855,11855,11855,0,0,0
2696118,1180,1,2685455,2685455,2696118,10663,10663,10663,0,0,0
2696158,1280,1,2686238,2686238,2696158,9920,9920,9920,0,0,0
2696158,1519,1,2692311,2692311,2696158,3847,3847,3847,0,0,0
2696175,938,1,2682789,2682789,2696175,13386,13386,13386,0,0,0
2696233,1468,1,2692155,2692155,2696233,4078,4078,4078,0,0,0
2696354,1329,1,2687977,2687977,2696354,8377,8377,8377,0,0,0
2696498,1573,1,2692477,2692477,2696498,4021,4021,4021,0,0,0
2696514,1150,1,2684873,2684873,2696514,11641,11641,11641,0,0,0
2696542,1570,1,2692473,2692473,2696542,4069,4069,4069,0,0,0
2696562,1588,1,2692535,2692535,2696562,4027,4027,4027,0,0,0
2696582,1183,1,2685465,2685465,2696582,11117,11117,11117,0,0,0
2696618,1321,1,2687963,2687963,2696618,8655,8655,8655,0,0,0
2696634,1469,1,2692189,2692189,2696634,4445,4445,4445,0,0,0
2696662,925,1,2676080,2676713,2696662,19949,20582,19949,633,1,0
2696854,1185,1,2685468,2685468,2696854,11386,11386,11386,0,0,0
2696927,661,1,2670231,2670231,2696927,26696,26696,22605,4091,6,0
2696962,1121,1,2684308,2684308,2696962,12654,12654,12654,0,2,0
2697149,957,1,2683034,2683034,2697149,14115,14115,14096,19,7,0
2697153,1368,1,2688433,2688433,2697153,8720,8720,8720,0,0,0
2697157,1354,1,2688091,2688091,2697157,9066,9066,9066,0,0,0
2697206,1307,1,2687938,2687938,2697206,9268,9268,9268,0,3,0
2697215,1558,1,2692451,2692451,2697215,4764,4764,4764,0,0,0
2697372,1295,1,2687910,2687910,2697372,9462,9462,9458,4,6,0
2697421,1036,1,2683692,2683692,2697421,13729,13729,13481,248,15,0
2697613,644,1,2670117,2670117,2697613,27496,27496,22867,4629,35,0
2697864,1187,1,2685484,2685484,2697864,12380,12380,11761,619,14,0
2697907,1346,1,2688010,2688010,2697907,9897,9897,9714,183,6,0
2698246,1240,1,2685845,2685845,2698246,12401,12401,11567,834,28,0
2698411,1521,1,2692315,2692315,2698411,6096,6096,5980,116,7,0
2698662,1422,1,2692089,2692089,2698662,6573,6573,6380,193,5,0
2698698,1090,1,2684174,2684174,2698698,14524,14524,13205,1319,29,0
2698764,1544,1,2692424,2692424,2698764,6340,6340,6074,266,4,0
2699164,1414,1,2692076,2692076,2699164,7088,7088,6800,288,3,0
2699194,1391,1,2692020,2692020,2699194,7174,7174,6880,294,3,0
2699262,1543,1,2692411,2692411,2699262,6851,6851,6542,309,3,0
2699364,1337,1,2687993,2687993,2699364,11371,11371,10382,989,13,0
2699700,848,1,2671849,2674308,2699700,25392,27851,22100,5751,44,0
2699801,1398,1,2692028,2692028,2699801,7773,7773,7362,411,7,0
2699977,1502,1,2692225,2692225,2699977,7752,7752,7308,444,9,0
2700049,936,1,2682786,2682786,2700049,17263,17263,14918,2345,29,0
2700070,1497,1,2692218,2692218,2700070,7852,7852,7340,512,14,0
2700186,1541,1,2692388,2692932,2700186,7254,7798,7254,544,1,0
2700356,1532,1,2692375,2692941,2700356,7415,7981,7415,566,1,0
2700393,1148,1,2684868,2684868,2700393,15525,15525,13175,2350,18,0
2700471,1562,1,2692459,2692952,2700471,7519,8012,7519,493,1,0
2700632,1499,1,2692221,2692221,2700632,8411,8411,7761,650,4,0
2700695,1087,1,2684170,2684170,2700695,16525,16525,13710,2815,27,0
2700715,1405,1,2692036,2692036,2700715,8679,8679,7987,692,5,0
2700984,870,1,2672071,2674470,2700984,26514,28913,22185,6728,32,0
2701338,960,1,2683052,2683052,2701338,18286,18286,14918,3368,35,0
2701775,1250,1,2685931,2686925,2701775,14850,15844,13115,2729,13,0
2701844,1369,1,2688436,2688932,2701844,12912,13408,12084,1324,4,0
2701946,1362,1,2688397,2688983,2701946,12963,13549,12113,1436,3,0
2701985,1041,1,2683707,2683707,2701985,18278,18278,14543,3735,27,0
2702135,1355,1,2688091,2689013,2702135,13122,14044,12261,1783,7,0
2702210,1535,1,2692380,2693085,2702210,9125,9830,9125,705,1,0
2702266,1166,1,2684962,2685138,2702266,17128,17304,13918,3386,17,0
2702299,1466,1,2692151,2692151,2702299,10148,10148,9268,880,4,0
2702695,1277,1,2686225,2687135,2702695,15560,16470,13600,2870,9,0
2702753,1495,1,2692213,2693110,2702753,9643,10540,9643,897,1,0
2702782,1348,1,2688015,2689033,2702782,13749,14767,12817,1950,5,0
2702860,1524,1,2692354,2693165,2702860,9695,10506,9695,811,1,0
2702934,1220,1,2685635,2685654,2702934,17280,17299,13879,3420,20,0
2703171,1296,1,2687912,2687912,2703171,15259,15259,13095,2164,6,0
2703297,1059,1,2683774,2683774,2703297,19523,19523,14887,4636,35,0
2703405,1249,1,2685927,2687240,2703405,16165,17478,13898,3580,9,0
2703465,1421,1,2692088,2692088,2703465,11377,11377,10238,1139,4,0
2703572,1225,1,2685681,2685783,2703572,17789,17891,13965,3926,9,0
2703590,1463,1,2692143,2692143,2703590,11447,11447,10259,1188,2,0
2703608,1513,1,2692276,2693342,2703608,10266,11332,10266,1066,1,0
2703814,1330,1,2687979,2689315,2703814,14499,15835,13289,2546,4,0
2703909,1561,1,2692455,2693363,2703909,10546,11454,10546,908,1,0
2703964,1072,1,2684082,2684082,2703964,19882,19882,14658,5224,41,0
2703976,1385,1,2692007,2692007,2703976,11969,11969,10735,1234,2,0
2704273,1132,1,2684432,2685174,2704273,19099,19841,14610,5231,20,0
2704674,919,1,2675933,2677804,2704674,26870,28741,21092,7649,15,0
2704800,1482,1,2692199,2693402,2704800,11398,12601,11398,1203,1,0
2704850,1188,1,2685484,2687338,2704850,17512,19366,14679,4687,8,0
2705140,1449,1,2692126,2692126,2705140,13014,13014,11730,1284,2,0
2705360,544,1,2661237,2661237,2705360,44123,44123,32513,11610,22,0
2705442,1401,1,2692031,2692031,2705442,13411,13411,12102,1309,7,0
2705744,1587,1,2692532,2693463,2705744,12281,13212,12281,931,1,0
2705873,1407,1,2692071,2692071,2705873,13802,13802,12390,1412,3,0
2705995,1441,1,2692116,2693525,2705995,12470,13879,12470,1409,1,0
2706055,1565,1,2692466,2693544,2706055,12511,13589,12511,1078,1,0
2706125,970,1,2683121,2683121,2706125,23004,23004,16349,6655,11,0
2706289,1205,1,2685522,2687567,2706289,18722,20767,15238,5529,10,0
2706532,698,1,2670384,2670384,2706532,36148,36148,23680,12468,31,0
2706566,1454,1,2692134,2693690,2706566,12876,14432,12876,1556,1,0
2706766,1444,1,2692117,2693696,2706766,13070,14649,13070,1579,1,0
2706819,1001,1,2683369,2683369,2706819,23450,23450,16352,7098,33,0
2707013,1435,1,2692103,2693762,2707013,13251,14910,13251,1659,1,0
2707285,1161,1,2684935,2687760,2707285,19525,22350,15601,6749,3,0
2707363,1476,1,2692193,2693853,2707363,13510,15170,13510,1660,1,0
2707412,1382,1,2692001,2692001,2707412,15411,15411,13600,1811,3,0
2707584,1472,1,2692189,2694014,2707584,13570,15395,13570,1825,1,0
2707747,1173,1,2685425,2690096,2707747,17651,22322,15653,6669,4,0
2708140,1534,1,2692379,2694120,2708140,14020,15761,14020,1741,1,0
2708273,675,1,2670301,2670301,2708273,37972,37972,23814,14158,21,0
2708758,1416,1,2692084,2694153,2708758,14605,16674,14605,2069,1,0
2708983,830,1,2671432,2674601,2708983,34382,37551,23462,14089,17,0
2709147,1546,1,2692424,2694327,2709147,14820,16723,14820,1903,1,0
2709362,479,1,2657610,2657610,2709362,51752,51752,36868,14884,15,0
2709454,1404,1,2692034,2692034,2709454,17420,17420,15095,2325,2,0
2709884,1428,1,2692094,2694815,2709884,15069,17790,15069,2721,1,0
2710446,1046,1,2683720,2683956,2710446,26490,26726,17141,9585,10,0
2710601,1018,1,2683575,2683575,2710601,27026,27026,17290,9736,13,0
2710838,1409,1,2692071,2695114,2710838,15724,18767,15724,3043,1,0
2710865,1341,1,2688000,2690658,2710865,20207,22865,17103,5762,4,0
2710943,1211,1,2685585,2690687,2710943,20256,25358,17113,8245,4,0
2711029,1453,1,2692131,2695176,2711029,15853,18898,15853,3045,1,0
2711185,1007,1,2683514,2683514,2711185,27671,27671,17589,10082,11,0
2711429,814,1,2671344,2674865,2711429,36564,40085,23713,16372,13,0
2711536,1101,1,2684203,2690869,2711536,20667,27333,17404,9929,6,0
2711972,1530,1,2692368,2695429,2711972,16543,19604,16543,3061,1,0
2712406,720,1,2670634,2670634,2712406,41772,41772,24223,17549,20,0
2712418,1537,1,2692382,2695512,2712418,16906,20036,16906,3130,1,0
2712696,1210,1,2685583,2691217,2712696,21479,27113,17815,9298,4,0
2712830,1189,1,2685492,2691311,2712830,21519,27338,17817,9521,6,0
2712885,1457,1,2692140,2695759,2712885,17126,20745,17126,3619,1,0
2713050,940,1,2682843,2682843,2713050,30207,30207,18759,11448,14,0
2713103,1520,1,2692315,2695800,2713103,17303,20788,17303,3485,1,0
2713133,1589,1,2692542,2695812,2713133,17321,20591,17321,3270,1,0
2713562,1582,1,2692499,2695815,2713562,17747,21063,17747,3316,1,0
2713621,1586,1,2692528,2695819,2713621,17802,21093,17802,3291,1,0
2713707,1105,1,2684238,2691913,2713707,21794,29469,17951,11518,4,0
2714090,807,1,2671327,2675012,2714090,39078,42763,23968,18795,8,0
2714193,1313,1,2687949,2696100,2714193,18093,26244,18093,8151,1,0
2714232,1328,1,2687975,2696118,2714232,18114,26257,18114,8143,1,0
2714292,1212,1,2685587,2696158,2714292,18134,28705,18134,10571,0,0
2714308,1086,1,2684167,2696158,2714308,18150,30141,18150,11991,1,0
2714431,467,1,2657514,2657514,2714431,56917,56917,37344,19573,14,0
2714766,832,1,2671443,2675165,2714766,39601,43323,24177,19146,9,0
2714915,1380,1,2691994,2696354,2714915,18561,22921,18561,4360,1,0
2715111,1265,1,2686020,2696498,2715111,18613,29091,18613,10478,1,0
2715171,1342,1,2688003,2696514,2715171,18657,27168,18657,8511,1,0
2715309,1269,1,2686066,2696542,2715309,18767,29243,18767,10476,1,0
2715334,1223,1,2685678,2696562,2715334,18772,29656,18772,10884,1,0
2715469,1167,1,2685051,2696582,2715469,18887,30418,18887,11531,1,0
2715513,1297,1,2687913,2696618,2715513,18895,27600,18895,8705,1,0
2715529,1550,1,2692435,2696634,2715529,18895,23094,18895,4199,1,0
2715670,922,1,2675946,2678721,2715670,36949,39724,23915,15809,6,0
2715970,1566,1,2692467,2696854,2715970,19116,23503,19116,4387,1,0
2716134,1199,1,2685510,2696927,2716134,19207,30624,19207,11417,1,0
2716179,1531,1,2692370,2696962,2716179,19217,23809,19217,4592,1,0
2716456,1320,1,2687962,2697149,2716456,19307,28494,19307,9187,1,0
2716502,1461,1,2692143,2697153,2716502,19349,24359,19349,5010,1,0
2716569,798,1,2671296,2675316,2716569,41253,45273,24689,20584,8,0
2716739,1057,1,2683770,2697206,2716739,19533,32969,19533,13436,1,0
2716926,902,1,2675851,2678871,2716926,38055,41075,24428,16647,4,0
2717385,648,1,2670190,2670190,2717385,47195,47195,25421,21774,8,0
2717450,1120,1,2684308,2697421,2717450,20029,33142,20029,13113,1,0
2717672,1122,1,2684312,2697613,2717672,20059,33360,20059,13301,1,0
2717927,1231,1,2685745,2697864,2717927,20063,32182,20063,12119,1,0
2718047,1206,1,2685576,2697907,2718047,20140,32471,20140,12331,1,0
2718428,849,1,2671849,2675677,2718428,42751,46579,24937,21642,7,0
2718637,1423,1,2692091,2698411,2718637,20226,26546,20226,6320,1,0
2719046,1486,1,2692203,2698662,2719046,20384,26843,20384,6459,1,0
2719058,1613,1,2718473,2718473,2719058,585,585,585,0,0,0
2719106,1654,1,2718582,2718582,2719106,524,524,524,0,0,0
2719173,1326,1,2687972,2698698,2719173,20475,31201,20475,10726,1,0
2719181,1649,1,2718574,2718574,2719181,607,607,607,0,0,0
2719247,1634,1,2718496,2718496,2719247,751,751,751,0,0,0
2719250,1710,1,2718745,2718745,2719250,505,505,505,0,0,0
2719255,1740,1,2718836,2718836,2719255,419,419,419,0,0,0
2719272,1633,1,2718496,2718496,2719272,776,776,776,0,0,0
2719335,1411,1,2692076,2698764,2719335,20571,27259,20571,6688,1,0
2719370,1696,1,2718719,2718719,2719370,651,651,651,0,0,0
2719410,1596,1,2718458,2718458,2719410,952,952,952,0,0,0
2719411,1708,1,2718742,2718742,2719411,669,669,669,0,0,0
2719412,1667,1,2718633,2718633,2719412,779,779,779,0,0,0
2719451,1764,1,2719011,2719011,2719451,440,440,440,0,0,0
2719473,1763,1,2719010,2719010,2719473,463,463,463,0,0,0
2719516,1597,1,2718458,2718458,2719516,1058,1058,1058,0,0,0
2719521,1599,1,2718462,2718462,2719521,1059,1059,1059,0,0,0
2719526,1676,1,2718677,2718677,2719526,849,849,849,0,0,0
2719530,1728,1,2718805,2718805,2719530,725,725,725,0,0,0
2719543,1721,1,2718772,2718772,2719543,771,771,771,0,0,0
2719557,1819,1,2719156,2719156,2719557,401,401,401,0,0,0
2719607,1682,1,2718690,2718690,2719607,917,917,917,0,0,0
2719628,1803,1,2719138,2719138,2719628,490,490,490,0,0,0
2719629,1604,1,2718466,2718466,2719629,1163,1163,1163,0,0,0
2719636,1635,1,2718497,2718497,2719636,1139,1139,1139,0,0,0
2719649,1746,1,2718865,2718865,2719649,784,784,784,0,0,0
2719669,1666,1,2718633,2718633,2719669,1036,1036,1036,0,0,0
2719671,1648,1,2718571,2718571,2719671,1100,1100,1100,0,0,0
2719701,1706,1,2718735,2718735,2719701,966,966,966,0,0,0
2719722,1806,1,2719138,2719138,2719722,584,584,584,0,0,0
2719727,1733,1,2718817,2718817,2719727,910,910,910,0,0,0
2719732,1745,1,2718853,2718853,2719732,879,879,879,0,0,0
2719755,1727,1,2718798,2718798,2719755,957,957,957,0,0,0
2719781,1755,1,2718942,2718942,2719781,839,839,839,0,0,0
2719813,1631,1,2718491,2718491,2719813,1322,1322,1322,0,0,0
2719827,1767,1,2719017,2719017,2719827,810,810,810,0,0,0
2719837,1765,1,2719014,2719014,2719837,823,823,823,0,0,0
2719847,1659,1,2718611,2718611,2719847,1236,1236,1236,0,0,0
2719852,1687,1,2718699,2718699,2719852,1153,1153,1153,0,0,0
2719858,1802,1,2719131,2719131,2719858,727,727,727,0,0,0
2719874,924,1,2676045,2679109,2719874,40765,43829,25175,18654,4,0
2719893,1686,1,2718699,2718699,2719893,1194,1194,1194,0,0,0
2719897,1793,1,2719114,2719114,2719897,783,783,783,0,0,0
2719904,1775,1,2719033,2719033,2719904,871,871,871,0,0,0
2719909,1822,1,2719160,2719160,2719909,749,749,749,0,0,0
2719937,1637,1,2718514,2718514,2719937,1423,1423,1423,0,0,0
2719943,1711,1,2718746,2718746,2719943,1197,1197,1197,0,0,0
2719953,1831,1,2719177,2719177,2719953,776,776,776,0,0,0
2719961,1821,1,2719159,2719159,2719961,802,802,802,0,0,0
2719977,1542,1,2692407,2699194,2719977,20783,27570,20783,6787,1,0
2719979,1818,1,2719155,2719155,2719979,824,824,824,0,0,0
2720020,1715,1,2718752,2718752,2720020,1268,1268,1268,0,0,0
2720046,1175,1,2685430,2699262,2720046,20784,34616,20784,13832,1,0
2720046,1758,1,2719004,2719004,2720046,1042,1042,1042,0,0,0
2720068,1762,1,2719007,2719007,2720068,1061,1061,1061,0,0,0
2720108,1820,1,2719158,2719158,2720108,950,950,950,0,0,0
2720167,1828,1,2719172,2719172,2720167,995,995,995,0,0,0
2720236,659,1,2670227,2670227,2720236,50009,50009,25948,24061,11,0
2720250,1700,1,2718729,2718729,2720250,1521,1521,1521,0,0,0
2720304,1829,1,2719172,2719172,2720304,1132,1132,1132,0,0,0
2720367,1714,1,2718752,2718752,2720367,1615,1615,1615,0,0,0
2720475,1830,1,2719176,2719176,2720475,1299,1299,1299,0,0,0
2720489,1791,1,2719112,2719112,2720489,1377,1377,1377,0,0,0
2720605,941,1,2682843,2682843,2720605,37762,37762,21619,16143,9,0
2720687,1824,1,2719163,2719163,2720687,1524,1524,1524,0,0,0
2720963,1024,1,2683624,2699801,2720963,21162,37339,21162,16177,1,0
2721174,1744,1,2718853,2718853,2721174,2321,2321,2321,0,0,0
2721226,1761,1,2719007,2719007,2721226,2219,2219,2219,0,0,0
2721235,1805,1,2719138,2719138,2721235,2097,2097,2097,0,0,0
2721292,863,1,2671976,2675715,2721292,45577,49316,25430,23886,10,0
2721449,1140,1,2684769,2700049,2721449,21400,36680,21400,15280,1,0
2721586,1458,1,2692140,2700070,2721586,21516,29446,21516,7930,1,0
2721615,1642,1,2718545,2718545,2721615,3070,3070,3070,0,0,0
2721753,1403,1,2692034,2700186,2721753,21567,29719,21567,8152,1,0
2721967,1722,1,2718772,2718772,2721967,3195,3195,3195,0,0,0
2721969,1108,1,2684243,2700356,2721969,21613,37726,21613,16113,1,0
2721991,1695,1,2718719,2718719,2721991,3272,3272,3272,0,0,0
2722037,1494,1,2692211,2700393,2722037,21644,29826,21644,8182,1,0
2722040,1665,1,2718633,2718633,2722040,3407,3407,3407,0,0,0
2722197,1052,1,2683743,2700471,2722197,21726,38454,21726,16728,1,0
2722467,1107,1,2684242,2700632,2722467,21835,38225,21835,16390,1,0
2722524,1859,1,2722103,2722103,2722524,421,421,421,0,0,0
2722617,391,1,2452096,2452096,2722617,270521,270521,244532,25989,10,0
2722663,1917,1,2722175,2722175,2722663,488,488,488,0,0,0
2722679,1353,1,2688088,2700715,2722679,21964,34591,21964,12627,1,0
2722686,1880,1,2722129,2722129,2722686,557,557,557,0,0,0
2722697,1963,1,2722240,2722240,2722697,457,457,457,0,0,0
2722718,1804,1,2719138,2719138,2722718,3580,3580,3580,0,0,0
2722724,1869,1,2722118,2722118,2722724,606,606,606,0,0,0
2722734,1743,1,2718850,2718850,2722734,3884,3884,3884,0,0,0
2722734,1981,1,2722325,2722325,2722734,409,409,409,0,0,0
2722748,1903,1,2722162,2722162,2722748,586,586,586,0,0,0
2722773,1678,1,2718683,2718683,2722773,4090,4090,4090,0,0,0
2722782,1660,1,2718624,2718624,2722782,4158,4158,4158,0,0,0
2722822,1992,1,2722388,2722388,2722822,434,434,434,0,0,0
2722827,1776,1,2719034,2719034,2722827,3793,3793,3793,0,0,0
2722875,1862,1,2722114,2722114,2722875,761,761,761,0,0,0
2722925,1878,1,2722128,2722128,2722925,797,797,797,0,0,0
2722926,1847,1,2722093,2722093,2722926,833,833,833,0,0,0
2722942,1620,1,2718479,2718479,2722942,4463,4463,4463,0,0,0
2722962,1962,1,2722237,2722237,2722962,725,725,725,0,0,0
2723060,1927,1,2722189,2722189,2723060,871,871,871,0,0,0
2723065,1846,1,2722092,2722092,2723065,973,973,973,0,0,0
2723072,1854,1,2722100,2722100,2723072,972,972,972,0,0,0
2723078,1919,1,2722181,2722181,2723078,897,897,897,0,0,0
2723087,1643,1,2718545,2718545,2723087,4542,4542,4542,0,0,0
2723126,1756,1,2718997,2718997,2723126,4129,4129,4129,0,0,0
2723267,1970,1,2722295,2722295,2723267,972,972,972,0,0,0
2723283,1865,1,2722114,2722114,2723283,1169,1169,1169,0,0,0
2723310,1131,1,2684390,2700984,2723310,22326,38920,22326,16594,1,0
2723316,1883,1,2722132,2722132,2723316,1184,1184,1184,0,0,0
2723337,1925,1,2722185,2722185,2723337,1152,1152,1152,0,0,0
2723363,1937,1,2722199,2722199,2723363,1164,1164,1164,0,0,0
2723408,1969,1,2722291,2722291,2723408,1117,1117,1117,0,0,0
2723448,1909,1,2722167,2722167,2723448,1281,1281,1281,0,0,0
2723475,1939,1,2722200,2722200,2723475,1275,1275,1275,0,0,0
2723498,1636,1,2718507,2718507,2723498,4991,4991,4991,0,0,0
2723503,1669,1,2718643,2718643,2723503,4860,4860,4860,0,0,0
2723675,872,1,2672202,2679648,2723675,44027,51473,26089,25384,10,0
2723916,1742,1,2718842,2718842,2723916,5074,5074,5074,0,0,0
2724104,1593,1,2716761,2716761,2724104,7343,7343,7343,0,0,0
2724317,1092,1,2684178,2701775,2724317,22542,40139,22542,17597,1,0
2724395,1425,1,2692091,2701844,2724395,22551,32304,22551,9753,1,0
2724424,1661,1,2718624,2718624,2724424,5800,5800,5800,0,0,0
2724641,1347,1,2688011,2701946,2724641,22695,36630,22695,13935,1,0
2724767,910,1,2675886,2679665,2724767,45102,48881,26432,22449,7,0
2724792,1719,1,2718770,2718770,2724792,6022,6022,6022,0,0,0
2724930,1538,1,2692383,2702135,2724930,22795,32547,22795,9752,1,0
2724951,1732,1,2718813,2718813,2724951,6138,6138,6138,0,0,0
2725022,1137,1,2684715,2702210,2725022,22812,40307,22812,17495,1,0
2725131,1262,1,2686009,2702266,2725131,22865,39122,22865,16257,1,0
2725163,1668,1,2718643,2718643,2725163,6520,6520,6520,0,0,0
2725207,1894,1,2722155,2722155,2725207,3052,3052,3052,0,0,0
2725234,983,1,2683275,2683275,2725234,41959,41959,22956,19003,7,0
2725750,1273,1,2686154,2702695,2725750,23055,39596,23055,16541,1,0
2725779,1726,1,2718794,2718794,2725779,6985,6985,6985,0,0,0
2725799,1979,1,2722325,2722325,2725799,3474,3474,3474,0,0,0
2725898,1617,1,2718476,2718476,2725898,7422,7422,7422,0,0,0
2726154,1944,1,2722208,2722208,2726154,3946,3946,3946,0,0,0
2726209,1688,1,2718699,2718699,2726209,7510,7510,7510,0,0,0
2726263,1103,1,2684235,2702753,2726263,23510,42028,23510,18518,1,0
2726304,1760,1,2719004,2719004,2726304,7300,7300,7300,0,0,0
2726309,1003,1,2683447,2702782,2726309,23527,42862,23527,19335,1,0
2726406,1218,1,2685627,2702860,2726406,23546,40779,23546,17233,1,0
2726489,1718,1,2718767,2718767,2726489,7722,7722,7722,0,0,0
2726515,1931,1,2722193,2722193,2726515,4322,4322,4322,0,0,0
2726599,1190,1,2685494,2702934,2726599,23665,41105,23665,17440,1,0
2726604,1766,1,2719015,2719015,2726604,7589,7589,7589,0,0,0
2726769,1850,1,2722096,2722096,2726769,4673,4673,4673,0,0,0
2726938,602,1,2661782,2661782,2726938,65156,65156,36335,28821,7,0
2727085,1832,1,2719179,2719179,2727085,7906,7906,7906,0,0,0
2727099,1406,1,2692038,2703297,2727099,23802,35061,23802,11259,1,0
2727215,1701,1,2718729,2718729,2727215,8486,8486,8486,0,0,0
2727285,1146,1,2684857,2703405,2727285,23880,42428,23880,18548,1,0
2727380,1395,1,2692026,2703465,2727380,23915,35354,23915,11439,1,0
2727418,1741,1,2718842,2718842,2727418,8576,8576,8576,0,0,0
2727457,1800,1,2719130,2719130,2727457,8327,8327,8327,0,0,0
2727519,1716,1,2718766,2718766,2727519,8753,8753,8753,0,0,0
2727550,1208,1,2685580,2703572,2727550,23978,41970,23978,17992,1,0
2727550,1844,1,2722089,2722089,2727550,5461,5461,5461,0,0,0
2727562,1759,1,2719004,2719004,2727562,8558,8558,8558,0,2,0
2727603,933,1,2682762,2682762,2727603,44841,44841,24522,20319,7,0
2727631,1916,1,2722174,2722174,2727631,5457,5457,5457,0,0,0
2727657,1938,1,2722199,2722199,2727657,5458,5458,5458,0,0,0
2727760,1264,1,2686012,2703608,2727760,24152,41748,24082,17666,6,0
2727847,1848,1,2722093,2722093,2727847,5754,5754,5754,0,0,0
2727975,1731,1,2718811,2718811,2727975,9164,9164,9089,75,3,0
2728061,1196,1,2685505,2703814,2728061,24247,42556,24164,18392,6,0
2728120,1835,1,2719186,2719272,2728120,8848,8934,8848,86,1,0
2728168,1841,1,2722087,2722087,2728168,6081,6081,6081,0,0,0
2728334,932,1,2682762,2682762,2728334,45572,45572,24761,20811,6,0
2728446,1699,1,2718729,2718729,2728446,9717,9717,9507,210,3,0
2728677,1967,1,2722288,2722288,2728677,6389,6389,6389,0,0,0
2728839,699,1,2670385,2670385,2728839,58454,58454,28442,30012,9,0
2728860,1247,1,2685906,2703976,2728860,24884,42954,24631,18323,4,0
2728948,1978,1,2722323,2722323,2728948,6625,6625,6625,0,0,0
2728965,1874,1,2722124,2722124,2728965,6841,6841,6841,0,0,0
2729217,992,1,2683352,2704273,2729217,24944,45865,24688,21177,4,0
2729431,1658,1,2718597,2718597,2729431,10834,10834,10538,296,11,0
2729623,1729,1,2718808,2718808,2729623,10815,10815,10480,335,2,0
2729649,1977,1,2722316,2722316,2729649,7333,7333,7333,0,0,0
2729685,1976,1,2722310,2722310,2729685,7375,7375,7375,0,0,0
2729778,1679,1,2718683,2718683,2729778,11095,11095,10717,378,2,0
2729849,1275,1,2686171,2704674,2729849,25175,43678,24792,18886,3,0
2729920,1849,1,2722095,2722095,2729920,7825,7825,7825,0,0,0
2729927,1997,1,2722419,2722419,2729927,7508,7508,7508,0,0,0
2730023,1349,1,2688019,2704800,2730023,25223,42004,24835,17169,4,0
2730084,1515,1,2692295,2704850,2730084,25234,37789,24835,12954,7,0
2730131,1698,1,2718719,2718719,2730131,11412,11412,10987,425,10,0
2730216,1870,1,2722121,2722121,2730216,8095,8095,8095,0,0,0
2730355,1725,1,2718789,2718789,2730355,11566,11566,11098,468,18,0
2730585,1685,1,2718699,2718699,2730585,11886,11886,11302,584,6,0
2730742,1623,1,2718483,2718483,2730742,12259,12259,11646,613,3,0
2730829,990,1,2683293,2705140,2730829,25689,47536,25074,22462,4,0
2730998,1594,1,2718449,2718449,2730998,12549,12549,11924,625,3,0
2731045,1960,1,2722233,2722233,2731045,8812,8812,8812,0,0,0
2731094,846,1,2671809,2680027,2731094,51067,59285,28268,31017,8,0
2731178,1618,1,2718478,2718478,2731178,12700,12700,12038,662,2,0
2731360,1035,1,2683689,2705442,2731360,25918,47671,25254,22417,4,0
2731601,1843,1,2722089,2722089,2731601,9512,9512,9512,0,0,0
2731787,1993,1,2722388,2722388,2731787,9399,9399,9399,0,0,0
2731820,1100,1,2684200,2705744,2731820,26076,47620,25379,22241,3,0
2731847,1677,1,2718681,2718681,2731847,13166,13166,12448,718,2,0
2732047,1891,1,2722140,2722140,2732047,9907,9907,9907,0,0,0
2732142,1873,1,2722122,2722122,2732142,10020,10020,10020,0,0,0
2732315,1735,1,2718825,2718825,2732315,13490,13490,12767,723,3,0
2732386,1921,1,2722181,2722181,2732386,10205,10205,10205,0,0,0
2732418,1948,1,2722213,2722213,2732418,10205,10205,10205,0,3,0
2732475,1217,1,2685620,2705873,2732475,26602,46855,25819,21036,10,0
2732779,1292,1,2687904,2705995,2732779,26784,44875,25835,19040,12,0
2733048,1446,1,2692121,2706055,2733048,26993,40927,25848,15079,14,0
2733300,1900,1,2722159,2722159,2733300,11141,11141,10803,338,2,0
2733335,1333,1,2687984,2706125,2733335,27210,45351,25896,19455,6,0
2733412,1770,1,2719018,2719827,2733412,13585,14394,13222,1172,4,0
2733515,1951,1,2722215,2722215,2733515,11300,11300,10919,381,3,0
2733603,1579,1,2692495,2706289,2733603,27314,41108,25922,15186,11,0
2734001,1655,1,2718597,2718597,2734001,15404,15404,13978,1426,6,0
2734149,1771,1,2719023,2719852,2734149,14297,15126,13854,1272,3,0
2734204,1415,1,2692084,2706532,2734204,27672,42120,26210,15910,9,0
2734317,1032,1,2683659,2706566,2734317,27751,50658,26211,24447,7,0
2734387,1757,1,2719004,2719893,2734387,14494,15383,13958,1425,5,0
2734463,1787,1,2719104,2719897,2734463,14566,15359,14017,1342,10,0
2734582,1690,1,2718710,2718710,2734582,15872,15872,14197,1675,8,0
2734699,1459,1,2692140,2706766,2734699,27933,42559,26235,16324,9,0
2735008,1790,1,2719111,2719937,2735008,15071,15897,14404,1493,6,0
2735130,1779,1,2719074,2719943,2735130,15187,16056,14462,1594,4,0
2735166,527,1,2660900,2660900,2735166,74266,74266,39282,34984,15,0
2735428,1986,1,2722341,2722942,2735428,12486,13087,12486,601,1,0
2735475,1627,1,2718486,2718486,2735475,16989,16989,15074,1915,9,0
2735630,1747,1,2718873,2719977,2735630,15653,16757,14782,1975,4,0
2735730,1926,1,2722189,2723065,2735730,12665,13541,12665,876,1,0
2735755,1023,1,2683621,2707013,2735755,28742,52134,26687,25447,8,0
2735798,1947,1,2722212,2723078,2735798,12720,13586,12720,866,1,0
2736165,469,1,2657550,2657550,2736165,78615,78615,42644,35971,14,0
2736310,1797,1,2719121,2720046,2736310,16264,17189,15319,1870,3,0
2736502,1083,1,2684163,2707363,2736502,29139,52339,26806,25533,7,0
2736667,1110,1,2684248,2707412,2736667,29255,52419,26876,25543,10,0
2736973,1942,1,2722204,2723310,2736973,13663,14769,13663,1106,1,0
2737230,1922,1,2722185,2723316,2737230,13914,15045,13914,1131,1,0
2737258,1335,1,2687989,2707584,2737258,29674,49269,27190,22079,9,0
2737522,1095,1,2684191,2707747,2737522,29775,53331,27196,26135,9,0
2737844,1639,1,2718534,2718534,2737844,19310,19310,16597,2713,5,0
2737929,1966,1,2722284,2723448,2737929,14481,15645,14481,1164,1,0
2738185,1365,1,2688422,2708140,2738185,30045,49763,27247,22516,8,0
2738378,1799,1,2719130,2720304,2738378,18074,19248,16716,2532,9,0
2738780,1871,1,2722121,2722121,2738780,16659,16659,15288,1371,4,0
2739111,1197,1,2685507,2708273,2739111,30838,53604,27695,25909,7,0
2739859,1985,1,2722333,2723916,2739859,15943,17526,15943,1583,1,0
2740066,1914,1,2722173,2724104,2740066,15962,17893,15962,1931,1,0
2740401,1426,1,2692093,2708758,2740401,31643,48308,27746,20562,9,0
2740836,1600,1,2718462,2718462,2740836,22374,22374,18380,3994,6,0
2740964,1875,1,2722125,2724424,2740964,16540,18839,16540,2299,1,0
2741261,693,1,2670374,2670374,2741261,70887,70887,30951,39936,11,0
2741396,1929,1,2722190,2724767,2741396,16629,19206,16629,2577,1,0
2741541,1855,1,2722100,2722100,2741541,19441,19441,16770,2671,2,0
2741682,1611,1,2718472,2718472,2741682,23210,23210,18466,4744,7,0
2742084,1749,1,2718880,2720963,2742084,21121,23204,18288,4916,5,0
2742394,1663,1,2718625,2718625,2742394,23769,23769,18433,5336,5,0
2742552,1933,1,2722195,2725131,2742552,17421,20357,17421,2936,1,0
2742620,1610,1,2718471,2718471,2742620,24149,24149,18619,5530,7,0
2742909,1434,1,2692103,2709147,2742909,33762,50806,28165,22641,9,0
2743092,1703,1,2718734,2718734,2743092,24358,24358,18667,5691,4,0
2743775,1834,1,2719186,2721449,2743775,22326,24589,18676,5913,5,0
2744082,1953,1,2722218,2725779,2744082,18303,21864,18303,3561,1,0
2744114,1691,1,2718710,2718710,2744114,25404,25404,18849,6555,6,0
2744275,1751,1,2718929,2721615,2744275,22660,25346,18857,6489,4,0
2744574,1994,1,2722391,2726154,2744574,18420,22183,18420,3763,1,0
2744778,666,1,2670268,2670268,2744778,74510,74510,31137,43373,11,0
2745116,1852,1,2722096,2726263,2745116,18853,23020,18853,4167,1,0
2745277,1842,1,2722088,2722088,2745277,23189,23189,18978,4211,3,0
2745323,1548,1,2692428,2709454,2745323,35869,52895,28414,24481,7,0
2745733,1934,1,2722196,2726406,2745733,19327,23537,19327,4210,1,0
2745943,1106,1,2684239,2709884,2745943,36059,61704,28419,33285,6,0
2746279,1675,1,2718671,2718671,2746279,27608,27608,19910,7698,5,0
2746779,1372,1,2688460,2710446,2746779,36333,58319,28504,29815,6,0
2746788,1811,1,2719148,2722040,2746788,24748,27640,20231,7409,7,0
2747260,821,1,2671362,2680732,2747260,66528,75898,30995,44903,10,0
2747633,1957,1,2722223,2726938,2747633,20695,25410,20695,4715,1,0
2747826,1782,1,2719081,2727085,2747826,20741,28745,20741,8004,1,0
2747870,1965,1,2722277,2727099,2747870,20771,25593,20771,4822,1,0
2747993,1388,1,2692016,2710838,2747993,37155,55977,28650,27327,3,0
2748234,1629,1,2718489,2718489,2748234,29745,29745,21170,8575,3,0
2748381,1896,1,2722155,2727380,2748381,21001,26226,21001,5225,1,0
2748495,429,1,2643544,2643544,2748495,104951,104951,58200,46751,14,0
2748653,1720,1,2718772,2727457,2748653,21196,29881,21196,8685,1,0
2748791,1674,1,2718664,2718664,2748791,30127,30127,21307,8820,2,0
2748971,1801,1,2719130,2727550,2748971,21421,29841,21421,8420,0,0
2749094,1080,1,2684126,2710943,2749094,38151,64968,29300,35668,3,0
2749117,1920,1,2722181,2727562,2749117,21555,26936,21555,5381,1,0
2749279,1868,1,2722118,2727603,2749279,21676,27161,21676,5485,1,0
2749400,1866,1,2722117,2727631,2749400,21769,27283,21769,5514,1,0
2749540,776,1,2671171,2680979,2749540,68561,78369,31630,46739,10,0
2749878,1500,1,2692222,2711185,2749878,38693,57656,29623,28033,4,0
2750015,1777,1,2719035,2727847,2750015,22168,30980,22168,8812,1,0
2750465,1399,1,2692030,2711429,2750465,39036,58435,29744,28691,3,0
2750737,979,1,2683270,2711536,2750737,39201,67467,29823,37644,4,0
2751040,1737,1,2718835,2728120,2751040,22920,32205,22920,9285,1,0
2751159,1889,1,2722137,2728168,2751159,22991,29022,22991,6031,1,0
2751359,1603,1,2718465,2718465,2751359,32894,32894,23241,9653,3,0
2751753,1786,1,2719104,2728446,2751753,23307,32649,23307,9342,1,0
2752023,948,1,2682927,2682927,2752023,69096,69096,30169,38927,11,0
2752192,1906,1,2722166,2728839,2752192,23353,30026,23353,6673,1,0
2752361,1950,1,2722215,2728860,2752361,23501,30146,23501,6645,1,0
2752456,1673,1,2718664,2718664,2752456,33792,33792,23515,10277,2,0
2752525,1612,1,2718473,2718473,2752525,34052,34052,23751,10301,2,0
2753043,980,1,2683270,2712406,2753043,40637,69773,30084,39689,6,0
2753346,1998,1,2722420,2729431,2753346,23915,30926,23915,7011,1,0
2753754,1943,1,2722208,2729623,2753754,24131,31546,24131,7415,1,0
2753788,1990,1,2722367,2729649,2753788,24139,31421,24139,7282,1,0
2753837,1912,1,2722170,2729685,2753837,24152,31667,24152,7515,1,0
2753943,1336,1,2687992,2712418,2753943,41525,65951,30390,35561,5,0
2754319,1940,1,2722202,2729849,2754319,24470,32117,24470,7647,1,0
2754432,1614,1,2718475,2718475,2754432,35957,35957,24676,11281,3,0
2754665,1051,1,2683740,2712696,2754665,41969,70925,30675,40250,4,0
2754953,876,1,2672215,2680999,2754953,73954,82738,32768,49970,9,0
2755068,1833,1,2719179,2730084,2755068,24984,35889,24984,10905,1,0
2755161,1505,1,2692248,2712885,2755161,42276,62913,30770,32143,4,0
2755420,1383,1,2692003,2713050,2755420,42370,63417,30778,32639,3,0
2755700,1853,1,2722099,2730355,2755700,25345,33601,25345,8256,1,0
2756063,945,1,2682871,2682871,2756063,73192,73192,31099,42093,6,0
2756279,1662,1,2718624,2730742,2756279,25537,37655,25537,12118,1,0
2756404,1709,1,2718745,2730829,2756404,25575,37659,25575,12084,1,0
2756745,1739,1,2718836,2730998,2756745,25747,37909,25747,12162,1,0
2756953,915,1,2675908,2681013,2756953,75940,81045,33341,47704,8,0
2757172,1959,1,2722233,2731094,2757172,26078,34939,26078,8861,1,0
2757343,1736,1,2718828,2731178,2757343,26165,38515,26165,12350,1,0
2757897,828,1,2671429,2681072,2757897,76825,86468,33431,53037,6,0
2758246,1258,1,2685978,2713621,2758246,44625,72268,31621,40647,4,0
2758746,1899,1,2722159,2731787,2758746,26959,36587,26959,9628,1,0
2758947,691,1,2670370,2670370,2758947,88577,88577,33923,54654,12,0
2759158,1707,1,2718741,2731847,2759158,27311,40417,27311,13106,1,0
2759736,1815,1,2719152,2732047,2759736,27689,40584,27689,12895,1,0
2759975,1877,1,2722126,2732142,2759975,27833,37849,27833,10016,1,0
2760341,1200,1,2685513,2714090,2760341,46251,74828,32510,42318,4,0
2760432,1609,1,2718469,2718469,2760432,41963,41963,28148,13815,6,0
2760547,1902,1,2722162,2732418,2760547,28129,38385,28129,10256,1,0
2761829,1350,1,2688022,2714193,2761829,47636,73807,33706,40101,3,0
2762372,1492,1,2692210,2714232,2762372,48140,70162,33906,36256,5,0
2762690,1910,1,2722170,2733048,2762690,29642,40520,29642,10878,1,0
2762972,1094,1,2684182,2714292,2762972,48680,78790,33914,44876,4,0
2763062,1809,1,2719145,2733335,2763062,29727,43917,29727,14190,1,0
2763157,1227,1,2685685,2714308,2763157,48849,77472,33951,43521,4,0
2763362,1615,1,2718476,2718476,2763362,44886,44886,29878,15008,3,0
2763612,804,1,2671320,2681550,2763612,82062,92292,35452,56840,8,0
2764290,1879,1,2722129,2734001,2764290,30289,42161,30289,11872,1,0
2764801,1178,1,2685447,2714766,2764801,50035,79354,34382,44972,3,0
2765026,1999,1,2722420,2734204,2765026,30822,42606,30822,11784,1,0
2765206,1483,1,2692201,2714915,2765206,50291,73005,34470,38535,4,0
2765475,1601,1,2718462,2718462,2765475,47013,47013,31117,15896,3,0
2765821,1881,1,2722130,2734463,2765821,31358,43691,31358,12333,1,0
2766050,820,1,2671362,2681551,2766050,84499,94688,36166,58522,7,0
2766205,1602,1,2718464,2718464,2766205,47741,47741,31528,16213,4,0
2766587,1816,1,2719152,2735008,2766587,31579,47435,31579,15856,1,0
2766983,1172,1,2685411,2715171,2766983,51812,81572,35165,46407,5,0
2767374,1773,1,2719027,2735166,2767374,32208,48347,32208,16139,1,0
2767805,1905,1,2722163,2735428,2767805,32377,45642,32377,13265,1,0
2767937,1680,1,2718683,2735475,2767937,32462,49254,32462,16792,1,0
2768537,1908,1,2722166,2735630,2768537,32907,46371,32907,13464,1,0
2769314,1814,1,2719152,2735730,2769314,33584,50162,33584,16578,1,0
2769409,1945,1,2722208,2735755,2769409,33654,47201,33654,13547,1,0
2769666,657,1,2670214,2670214,2769666,99452,99452,38748,60704,9,0
2770359,1452,1,2692131,2715334,2770359,55025,78228,37338,40890,4,0
2770950,1564,1,2692463,2715469,2770950,55481,78487,37647,40840,3,0
2771258,765,1,2670951,2681685,2771258,89573,100307,38901,61406,7,0
2771627,1628,1,2718487,2736667,2771627,34960,53140,34960,18180,1,0
2772069,1646,1,2718566,2736973,2772069,35096,53503,35096,18407,1,0
2772431,458,1,2657421,2657421,2772431,115010,115010,52094,62916,12,0
2772528,1621,1,2718479,2737258,2772528,35270,54049,35270,18779,1,0
2772872,1857,1,2722102,2737522,2772872,35350,50770,35350,15420,1,0
2773287,1705,1,2718735,2737844,2773287,35443,54552,35443,19109,1,0
2773894,1088,1,2684170,2715670,2773894,58224,89724,38768,50956,3,0
2774913,839,1,2671460,2681960,2774913,92953,103453,40100,63353,9,0
2775472,1861,1,2722106,2738378,2775472,37094,53366,37094,16272,1,0
2776058,1375,1,2688484,2716134,2776058,59924,87574,39616,47958,4,0
2776637,1987,1,2722349,2739111,2776637,37526,54288,37526,16762,1,0
2777485,1245,1,2685880,2716179,2777485,61306,91605,39918,51687,4,0
2778214,1510,1,2692264,2716456,2778214,61758,85950,40161,45789,5,0
2778720,673,1,2670289,2670289,2778720,108431,108431,41398,67033,9,0
2779163,1840,1,2722086,2740836,2779163,38327,57077,38327,18750,1,0
2779389,1624,1,2718483,2740964,2779389,38425,60906,38425,22481,1,0
2779768,1310,1,2687943,2716569,2779768,63199,91825,40403,51422,6,0
2780523,1928,1,2722189,2741396,2780523,39127,58334,39127,19207,1,0
2780754,1650,1,2718578,2741541,2780754,39213,62176,39213,22963,1,0
2781918,1241,1,2685852,2716739,2781918,65179,96066,41796,54270,5,0
2782478,1845,1,2722091,2742084,2782478,40394,60387,40394,19993,1,0
2782858,1983,1,2722333,2742394,2782858,40464,60525,40464,20061,1,0
2783951,686,1,2670363,2670363,2783951,113588,113588,43368,70220,8,0
2784093,1456,1,2692140,2717450,2784093,66643,91953,42485,49468,3,0
2784402,1734,1,2718817,2742909,2784402,41493,65585,41493,24092,1,0
2784882,545,1,2661248,2661248,2784882,123634,123634,52336,71298,13,0
2786100,1027,1,2683635,2717927,2786100,68173,102465,42856,59609,3,0
2787103,727,1,2670697,2682520,2787103,104583,116406,43674,72732,7,0
2788197,857,1,2671919,2682724,2788197,105473,116278,44130,72148,3,0
2788525,1291,1,2687901,2744275,2788525,44250,100624,44250,56374,1,0
2788978,1807,1,2719141,2744574,2788978,44404,69837,44404,25433,1,0
2789522,1684,1,2718691,2744778,2789522,44744,70831,44744,26087,1,0
2790195,518,1,2660744,2660744,2790195,129451,129451,54729,74722,6,0
2790435,1480,1,2692197,2745277,2790435,45158,98238,45158,53080,1,0
2790693,1306,1,2687936,2745323,2790693,45370,102757,45370,57387,1,0
2791462,997,1,2683362,2745733,2791462,45729,108100,45729,62371,1,0
2791855,705,1,2670416,2670416,2791855,121439,121439,46127,75312,3,0
2792509,495,1,2660599,2660599,2792509,131910,131910,55971,75939,8,0
2793359,1644,1,2718562,2746779,2793359,46580,74797,46580,28217,1,0
2793409,618,1,2661968,2661968,2793409,131441,131441,54879,76562,8,0
2794478,770,1,2671015,2747260,2794478,47218,123463,47218,76245,1,0
2794911,842,1,2671524,2747633,2794911,47278,123387,47278,76109,1,0
2795515,655,1,2670204,2670204,2795515,125311,125311,48074,77237,4,0
2796469,626,1,2662021,2662413,2796469,134056,134448,56767,77681,4,0
2796849,1496,1,2692218,2747993,2796849,48856,104631,48856,55775,1,0
2797153,1949,1,2722215,2748234,2797153,48919,74938,48919,26019,1,0
2797367,631,1,2662049,2662446,2797367,134921,135318,57118,78200,4,0
2797560,823,1,2671370,2748495,2797560,49065,126190,49065,77125,1,0
2797930,1025,1,2683625,2748653,2797930,49277,114305,49277,65028,1,0
2798099,1009,1,2683521,2748791,2798099,49308,114578,49308,65270,1,0
2798437,486,1,2657651,2657651,2798437,140786,140786,61789,78997,7,0
2800203,538,1,2661124,2661124,2800203,139079,139079,59878,79201,6,0
2800764,485,1,2657648,2657648,2800764,143116,143116,63744,79372,8,0
2801399,443,1,2657334,2657334,2801399,144065,144065,64421,79644,8,0
2801706,764,1,2670949,2749400,2801706,52306,130757,52306,78451,1,0
2801967,1955,1,2722219,2749540,2801967,52427,79748,52427,27321,1,0
2802586,619,1,2661968,2661968,2802586,140618,140618,60323,80295,5,0
2803138,1251,1,2685934,2750015,2803138,53123,117204,53123,64081,1,0
2803952,714,1,2670587,2750465,2803952,53487,133365,53487,79878,1,0
2805405,1792,1,2719114,2750737,2805405,54668,86291,54668,31623,1,0
2806011,811,1,2671337,2751040,2806011,54971,134674,54971,79703,1,0
2807478,683,1,2670329,2670329,2807478,137149,137149,56395,80754,3,0
2807819,1139,1,2684764,2751359,2807819,56460,123055,56460,66595,1,0
2808511,904,1,2675862,2751753,2808511,56758,132649,56758,75891,1,0
2809084,1287,1,2686362,2752023,2809084,57061,122722,57061,65661,1,0
2809829,1192,1,2685497,2752192,2809829,57637,124332,57637,66695,1,0
2810119,1074,1,2684085,2752361,2810119,57758,126034,57758,68276,1,0
2810244,792,1,2671248,2752456,2810244,57788,138996,57788,81208,1,0
2810741,1748,1,2718873,2752525,2810741,58216,91868,58216,33652,1,0
2811829,710,1,2670513,2753043,2811829,58786,141316,58786,82530,1,0
2812746,459,1,2657424,2657424,2812746,155322,155322,71478,83844,8,0
2813594,1517,1,2692304,2753754,2813594,59840,121290,59840,61450,1,0
2813848,1509,1,2692263,2753788,2813848,60060,121585,60060,61525,1,0
2813945,564,1,2661682,2661682,2813945,152263,152263,67918,84345,10,0
2814178,1516,1,2692295,2753943,2814178,60235,121883,60235,61648,1,0
2814593,1252,1,2685964,2754319,2814593,60274,128629,60274,68355,1,0
2814755,717,1,2670621,2754432,2814755,60323,144134,60323,83811,1,0
2815251,1279,1,2686234,2754665,2815251,60586,129017,60586,68431,1,0
2815627,1511,1,2692267,2754953,2815627,60674,123360,60674,62686,1,0
2816124,1324,1,2687969,2755068,2816124,61056,128155,61056,67099,1,0
2816266,869,1,2672044,2755161,2816266,61105,144222,61105,83117,1,0
2816797,1376,1,2688485,2755420,2816797,61377,128312,61377,66935,1,0
2817636,929,1,2676434,2755700,2817636,61936,141202,61936,79266,1,0
2818243,906,1,2675867,2756063,2818243,62180,142376,62180,80196,1,0
2818512,588,1,2661742,2661742,2818512,156770,156770,69904,86866,16,0
2818796,773,1,2671038,2756404,2818796,62392,147758,62392,85366,1,0
2820054,1141,1,2684776,2756745,2820054,63309,135278,63309,71969,1,0
2820437,864,1,2671984,2756953,2820437,63484,148453,63484,84969,1,0
2821014,1242,1,2685860,2757172,2821014,63842,135154,63842,71312,1,0
2821530,1075,1,2684089,2757343,2821530,64187,137441,64187,73254,1,0
2822318,1267,1,2686023,2757897,2822318,64421,136295,64421,71874,2,0
2823000,1904,1,2722163,2758246,2823000,64754,100837,64754,36083,3,0
2823773,1893,1,2722143,2758746,2823773,65027,101630,65027,36603,3,0
2825722,1973,1,2722303,2758947,2825722,66775,103419,66775,36644,3,0
2826080,1243,1,2685864,2759158,2826080,66922,140216,66922,73294,3,0
2827636,841,1,2671522,2759736,2827636,67900,156114,67900,88214,3,0
2828119,1142,1,2684822,2759975,2828119,68144,143297,68144,75153,3,0
2828583,1507,1,2692252,2760341,2828583,68242,136331,68242,68089,3,0
2829749,1130,1,2684353,2760432,2829749,69317,145396,69317,76079,3,0
2830170,694,1,2670377,2670377,2830170,159793,159793,69630,90163,6,0
2831635,908,1,2675873,2761829,2831635,69806,155762,69806,85956,3,0
2832442,1872,1,2722121,2762372,2832442,70070,110321,70070,40251,3,0
2832775,942,1,2682867,2762690,2832775,70085,149908,70085,79823,3,0
2833117,1652,1,2718582,2762972,2833117,70145,114535,70145,44390,3,0
2834668,1184,1,2685466,2763062,2834668,71606,149202,71606,77596,3,0
2834806,610,1,2661852,2661852,2834806,172954,172954,78966,93988,17,0
2835563,1397,1,2692027,2763362,2835563,72201,143536,72201,71335,3,0
2835965,1191,1,2685496,2763612,2835965,72353,150469,72353,78116,3,0
2836737,976,1,2683197,2764290,2836737,72447,153540,72447,81093,3,0
2837296,1352,1,2688043,2764801,2837296,72495,149253,72495,76758,3,0
2838547,1984,1,2722333,2765026,2838547,73521,116214,73521,42693,3,0
2838874,1784,1,2719101,2765206,2838874,73668,119773,73668,46105,3,0
2839402,576,1,2661707,2661707,2839402,177695,177695,80870,96825,23,0
2839842,1379,1,2688510,2765821,2839842,74021,151332,74021,77311,3,0
2840815,488,1,2657667,2657667,2840815,183148,183148,85596,97552,17,0
2841339,1723,1,2718777,2766205,2841339,75134,122562,75134,47428,3,0
2843110,984,1,2683277,2766587,2843110,76523,159833,76523,83310,3,0
2843682,1493,1,2692211,2766983,2843682,76699,151471,76699,74772,3,0
2844776,1056,1,2683763,2767374,2844776,77402,161013,77402,83611,3,0
2845263,508,1,2660652,2660652,2845263,184611,184611,85107,99504,14,0
2845778,937,1,2682787,2767937,2845778,77841,162991,77841,85150,3,0
2846948,1400,1,2692031,2768537,2846948,78411,154917,78411,76506,3,0
2847839,591,1,2661749,2661749,2847839,186090,186090,85009,101081,13,0
2847965,742,1,2670778,2769409,2847965,78556,177187,78556,98631,3,0
2848222,1952,1,2722216,2769666,2848222,78556,126006,78556,47450,3,0
2849160,1179,1,2685451,2770359,2849160,78801,163709,78801,84908,3,0
2850459,803,1,2671320,2770950,2850459,79509,179139,79509,99630,3,0
2850948,1518,1,2692308,2771258,2850948,79690,158640,79690,78950,3,0
2851909,1257,1,2685972,2771627,2851909,80282,165937,80282,85655,3,0
2852385,1229,1,2685741,2772069,2852385,80316,166644,80316,86328,3,0
2852894,1447,1,2692121,2772431,2852894,80463,160773,80463,80310,3,0
2853368,536,1,2661114,2661114,2853368,192254,192254,87719,104535,13,0
2854182,546,1,2661254,2661254,2854182,192928,192928,88026,104902,14,0
2854640,1936,1,2722197,2773287,2854640,81353,132443,81353,51090,3,0
2857310,1370,1,2688444,2773894,2857310,83416,168866,83416,85450,3,0
2858944,689,1,2670367,2774913,2858944,84031,188577,84031,104546,3,0
2860139,802,1,2671317,2775472,2860139,84667,188822,84667,104155,3,0
2861274,818,1,2671352,2776058,2861274,85216,189922,85216,104706,3,0
2862135,1738,1,2718835,2776637,2862135,85498,143300,85498,57802,3,0
2863295,1133,1,2684448,2777485,2863295,85810,178847,85810,93037,3,0
2864381,993,1,2683355,2778214,2864381,86167,181026,86167,94859,3,0
2865122,744,1,2670782,2778720,2865122,86402,194340,86402,107938,3,0
2865834,1789,1,2719110,2779163,2865834,86671,146724,86671,60053,3,0
2866405,1924,1,2722185,2779389,2866405,87016,144220,87016,57204,3,0
2866894,731,1,2670711,2779768,2866894,87126,196183,87126,109057,3,0
2867902,1954,1,2722219,2780523,2867902,87379,145683,87379,58304,3,0
2868305,1194,1,2685500,2780754,2868305,87551,182805,87551,95254,3,0
2869563,1774,1,2719027,2781918,2869563,87645,150536,87645,62891,3,0
2870176,611,1,2661865,2664337,2870176,205839,208311,93670,114641,8,0
2870774,1527,1,2692364,2782858,2870774,87916,178410,87916,90494,3,0
2872382,789,1,2671243,2783951,2872382,88431,201139,88431,112708,3,0
2872599,840,1,2671498,2784093,2872599,88506,201101,88506,112595,3,0
2873077,867,1,2672040,2784402,2873077,88675,201037,88675,112362,3,0
2874114,1932,1,2722193,2784882,2874114,89232,151921,89232,62689,3,0
2875478,964,1,2683059,2786100,2875478,89378,192419,89378,103041,3,0
2876795,1572,1,2692474,2787103,2876795,89692,184321,89692,94629,3,0
2878195,566,1,2661686,2661686,2878195,216509,216509,95796,120713,15,0
2878922,1270,1,2686066,2788525,2878922,90397,192856,90397,102459,3,0
2879657,1560,1,2692451,2788978,2879657,90679,187206,90679,96527,3,0
2880841,690,1,2670370,2789522,2880841,91319,210471,91319,119152,3,0
2881669,452,1,2657379,2657379,2881669,224290,224290,101434,122856,17,0
2881946,882,1,2672359,2790435,2881946,91511,209587,91511,118076,3,0
2882671,947,1,2682927,2790693,2882671,91978,199744,91978,107766,3,0
2883510,901,1,2675846,2791462,2883510,92048,207664,92048,115616,3,0
2884245,1885,1,2722133,2791855,2884245,92390,162112,92390,69722,3,0
2884948,998,1,2683366,2792509,2884948,92439,201582,92439,109143,3,0
2886455,1312,1,2687947,2793359,2886455,93096,198508,93096,105412,3,0
2886748,1657,1,2718597,2793409,2886748,93339,168151,93339,74812,3,0
2887877,1058,1,2683771,2794478,2887877,93399,204106,93399,110707,3,0
2888366,1021,1,2683601,2794911,2888366,93455,204765,93455,111310,3,0
2889274,754,1,2670900,2795515,2889274,93759,218374,93759,124615,3,0
2890833,1768,1,2719017,2796469,2890833,94364,171816,94364,77452,3,0
2891647,586,1,2661739,2665894,2891647,225753,229908,99186,130722,13,0
2892186,1769,1,2719018,2797153,2892186,95033,173168,95033,78135,4,0
2892837,1064,1,2683791,2797367,2892837,95470,209046,95470,113576,4,0
2893124,1752,1,2718929,2797560,2893124,95564,174195,95564,78631,3,0
2893874,1305,1,2687935,2797930,2893874,95944,205939,95944,109995,3,0
2894730,1638,1,2718514,2798099,2894730,96631,176216,96631,79585,3,0
2895484,473,1,2657569,2657569,2895484,237915,237915,105354,132561,16,0
2897313,1754,1,2718938,2800203,2897313,97110,178375,97110,81265,4,0
2899070,1207,1,2685577,2800764,2899070,98306,213493,98306,115187,4,0
2899778,1823,1,2719162,2801399,2899778,98379,180616,98379,82237,4,0
2900595,1810,1,2719146,2801706,2900595,98889,181449,98889,82560,4,0
2900938,1974,1,2722306,2801967,2900938,98971,178632,98971,79661,4,0
2901576,769,1,2671000,2802586,2901576,98990,230576,98990,131586,4,0
2902546,1004,1,2683447,2803138,2902546,99408,219099,99408,119691,4,0
2903506,632,1,2662060,2666753,2903506,236753,241446,103066,138380,12,0
2905110,1193,1,2685500,2805405,2905110,99705,219610,99705,119905,4,0
2905777,767,1,2670993,2806011,2905777,99766,234784,99766,135018,4,0
2907304,1626,1,2718485,2807478,2907304,99826,188819,99826,88993,4,0
2907650,594,1,2661756,2666814,2907650,240836,245894,103248,142646,9,0
2908708,1371,1,2688450,2808511,2908708,100197,220258,100197,120061,4,0
2909443,791,1,2671247,2809084,2909443,100359,238196,100359,137837,4,0
2910312,844,1,2671608,2809829,2910312,100483,238704,100483,138221,4,0
2910998,1127,1,2684348,2810119,2910998,100879,226650,100879,125771,4,0
2911140,1838,1,2722084,2810244,2911140,100896,189056,100896,88160,4,0
2912013,877,1,2672266,2810741,2912013,101272,239747,101272,138475,4,0
2913378,1961,1,2722236,2811829,2913378,101549,191142,101549,89593,4,0
2914341,1547,1,2692424,2812746,2914341,101595,221917,101595,120322,4,0
2915370,1529,1,2692368,2813594,2915370,101776,223002,101776,121226,4,0
2915669,533,1,2661082,2661082,2915669,254587,254587,105617,148970,12,0
2915889,1808,1,2719142,2813945,2915889,101944,196747,101944,94803,4,0
2916311,1556,1,2692448,2814178,2916311,102133,223863,102133,121730,4,0
2917459,668,1,2670272,2814593,2917459,102866,247187,102866,144321,4,0
2917621,678,1,2670319,2814755,2917621,102866,247302,102866,144436,4,0
2918257,572,1,2661698,2661698,2918257,256559,256559,105815,150744,13,0
2919007,1073,1,2684085,2815627,2919007,103380,234922,103380,131542,4,0
2919560,1487,1,2692204,2816124,2919560,103436,227356,103436,123920,4,0
2919948,1525,1,2692354,2816266,2919948,103682,227594,103682,123912,4,0
2921020,1436,1,2692106,2816797,2921020,104223,228914,104223,124691,4,0
2921993,1359,1,2688377,2817636,2921993,104357,233616,104357,129259,4,0
2922610,772,1,2671030,2818243,2922610,104367,251580,104367,147213,4,0
2923471,1204,1,2685521,2818512,2923471,104959,237950,104959,132991,4,0
2924308,436,1,2657308,2657308,2924308,267000,267000,112031,154969,13,0
2925972,549,1,2661657,2661657,2925972,264315,264315,107943,156372,11,0
2926808,1930,1,2722192,2820437,2926808,106371,204616,106371,98245,4,0
2927789,1630,1,2718489,2821014,2927789,106775,209300,106775,102525,4,0
2928928,1066,1,2683815,2821530,2928928,107398,245113,107398,137715,4,0
2929974,1334,1,2687989,2822318,2929974,107656,241985,107656,134329,4,0
2930723,1995,1,2722415,2823000,2930723,107723,208308,107723,100585,4,0
2931529,635,1,2662078,2668324,2931529,263205,269451,109636,159815,10,0
2933740,432,1,2657292,2657292,2933740,276448,276448,114238,162210,13,0
2934478,813,1,2671341,2826080,2934478,108398,263137,108398,154739,4,0
2937167,494,1,2660595,2660595,2937167,276572,276572,112264,164308,14,0
2937658,1697,1,2718719,2828119,2937658,109539,218939,109539,109400,4,0
2938412,1568,1,2692471,2828583,2938412,109829,245941,109829,136112,4,0
2940031,1892,1,2722140,2829749,2940031,110282,217891,110282,107609,4,0
2941120,1996,1,2722416,2830170,2941120,110950,218704,110950,107754,4,0
2943203,1377,1,2688492,2831635,2943203,111568,254711,111568,143143,4,0
2944861,1958,1,2722227,2832442,2944861,112419,222634,112419,110215,4,0
2945256,1935,1,2722196,2832775,2945256,112481,223060,112481,110579,4,0
2946894,663,1,2670261,2833117,2946894,113777,276633,113777,162856,4,0
2949168,1895,1,2722155,2834668,2949168,114500,227013,114500,112513,5,0
2949373,889,1,2675811,2834806,2949373,114567,273562,114567,158995,5,0
2950535,1606,1,2718468,2835563,2950535,114972,232067,114972,117095,5,0
2951190,743,1,2670779,2835965,2951190,115225,280411,115225,165186,5,0
2952093,1235,1,2685805,2836737,2952093,115356,266288,115356,150932,5,0
2952680,431,1,2657288,2657288,2952680,295392,295392,121147,174245,27,0
2954060,670,1,2670284,2838547,2954060,115513,283776,115513,168263,5,0
2955020,1226,1,2685682,2838874,2955020,116146,269338,116146,153192,5,0
2955746,1647,1,2718571,2839402,2955746,116344,237175,116344,120831,5,0
2956317,1171,1,2685405,2839842,2956317,116475,270912,116475,154437,5,0
2957436,1576,1,2692487,2840815,2957436,116621,264949,116621,148328,5,0
2959295,481,1,2657619,2657619,2959295,301676,301676,122933,178743,26,0
2961428,1049,1,2683737,2843110,2961428,118318,277691,118318,159373,5,0
2962704,637,1,2662106,2669451,2962704,293253,300598,119764,180834,20,0
2963808,953,1,2682971,2844776,2963808,119032,280837,119032,161805,6,0
2964394,1085,1,2684167,2845263,2964394,119131,280227,119131,161096,6,0
2965327,707,1,2670454,2845778,2965327,119549,294873,119549,175324,6,0
2967141,447,1,2657347,2657347,2967141,309794,309794,125161,184633,27,0
2968144,1681,1,2718690,2847839,2968144,120305,249454,120305,129149,6,0
2969076,519,1,2660747,2660747,2969076,308329,308329,122357,185972,18,0
2970356,1408,1,2692071,2848222,2970356,122134,278285,122134,156151,6,0
2971476,1964,1,2722273,2849160,2971476,122316,249203,122316,126887,6,0
2972857,1783,1,2719101,2850459,2972857,122398,253756,122398,131358,6,0
2974024,1030,1,2683652,2850948,2974024,123076,290372,123076,167296,6,0
2975634,1887,1,2722136,2851909,2975634,123725,253498,123725,129773,6,0
2976453,1640,1,2718542,2852385,2976453,124068,257911,124068,133843,6,0
2977402,1837,1,2722083,2852894,2977402,124508,255319,124508,130811,6,0
2977730,430,4,2653756,2653756,2977730,323974,323974,101461,222513,1,0
2978003,1431,1,2692099,2853368,2978003,124635,285904,124635,161269,6,0
2979338,1608,1,2718469,2854182,2979338,125156,260869,125156,135713,6,0
2979854,645,1,2670163,2670163,2979854,309691,309691,125241,184450,7,0
2982654,1619,1,2718479,2857310,2982654,125344,264175,125344,138831,6,0
2984662,1440,1,2692111,2858944,2984662,125718,292551,125718,166833,6,0
2986113,985,1,2683278,2860139,2986113,125974,302835,125974,176861,6,0
2987422,1169,1,2685398,2861274,2987422,126148,302024,126148,175876,6,0
2988415,967,1,2683114,2862135,2988415,126280,305301,126280,179021,6,0
2989838,1826,1,2719169,2863295,2989838,126543,270669,126543,144126,6,0
2990991,987,1,2683289,2864381,2990991,126610,307702,126610,181092,6,0
2992389,1448,1,2692124,2865122,2992389,127267,300265,127267,172998,6,0
2993330,829,1,2671429,2865834,2993330,127496,321901,127496,194405,6,0
2993901,1980,1,2722325,2866405,2993901,127496,271576,127496,144080,6,0
2994622,1796,1,2719118,2866894,2994622,127728,275504,127728,147776,6,0
2995939,1345,1,2688008,2867902,2995939,128037,307931,128037,179894,6,0
2996938,590,1,2661747,2670034,2996938,326904,335191,128715,206476,9,0
2998219,795,1,2671257,2869563,2998219,128656,326962,128656,198306,6,0
2998909,1569,1,2692471,2870176,2998909,128733,306438,128733,177705,6,0
3000048,1427,1,2692094,2870774,3000048,129274,307954,129274,178680,6,0
3002429,865,1,2671999,2872382,3002429,130047,330430,130047,200383,6,0
3003063,1772,1,2719025,2872599,3003063,130464,284038,130464,153574,6,0
3003936,492,1,2660588,2660588,3003936,343348,343348,131939,211409,10,0
3005476,806,1,2671324,2874114,3005476,131362,334152,131362,202790,6,0
3006946,1160,1,2684925,2875478,3006946,131468,322021,131468,190553,6,0
3009267,1689,1,2718710,2876795,3009267,132472,290557,132472,158085,6,0
3010924,1478,1,2692196,2878195,3010924,132729,318728,132729,185999,7,0
3011783,662,1,2670261,2878922,3011783,132861,341522,132861,208661,8,0
3013570,1177,1,2685444,2879657,3013570,133913,328126,133913,194213,9,0
3014963,580,1,2661714,2880841,3014963,134122,353249,134122,219127,9,0
3015969,1605,1,2718466,2881669,3015969,134300,297503,134300,163203,9,0
3016953,503,1,2660627,2660627,3016953,356326,356326,135341,220985,12,0
3019255,1918,1,2722181,2882671,3019255,136584,297074,134374,162700,7,0
3020467,968,1,2683118,2883510,3020467,136957,337349,134454,202895,6,0
3022795,1076,1,2684092,2887877,3022795,134918,338703,134918,203785,5,0
3023439,1300,1,2687925,2888366,3023439,135073,335514,135073,200441,5,0
3025189,1479,1,2692196,2889274,3025189,135915,332993,135915,197078,5,0
3026898,543,1,2661232,2661232,3026898,365666,365666,136233,229433,9,0
3028061,1442,1,2692116,2891647,3028061,136414,335945,136414,199531,5,0
3028995,862,1,2671972,2892186,3028995,136809,357023,136809,220214,5,0
3030150,1008,1,2683514,2892837,3030150,137313,346636,137313,209323,5,0
3030723,1813,1,2719149,2893124,3030723,137599,311574,137599,173975,5,0
3031736,654,1,2670201,2893874,3031736,137862,361535,137862,223673,5,0
3032773,1692,1,2718714,2894730,3032773,138043,314059,138043,176016,5,0
3033572,1174,1,2685427,2895484,3033572,138088,348145,138088,210057,5,0
3035635,1125,1,2684345,2897313,3035635,138322,351290,138322,212968,5,0
3037777,1443,1,2692116,2899070,3037777,138707,345661,138707,206954,5,0
3038640,963,1,2683056,2899778,3038640,138862,355584,138862,216722,5,0
3040208,1913,1,2722171,2900595,3040208,139613,318037,139613,178424,5,0
3040726,1343,1,2688004,2900938,3040726,139788,352722,139788,212934,5,0
3042224,1941,1,2722202,2901576,3042224,140648,320022,140648,179374,5,0
3043340,1384,1,2692006,2902546,3043340,140794,351334,140794,210540,5,0
3044705,907,1,2675870,2903506,3044705,141199,368835,141199,227636,5,0
3046368,1907,1,2722166,2905110,3046368,141258,324202,141258,182944,5,0
3047577,1071,1,2684081,2905777,3047577,141800,363496,141800,221696,5,0
3048109,398,4,2485014,2485014,3048109,563095,563095,287126,275969,1,0
3049243,642,1,2670107,2907304,3049243,141939,379136,141939,237197,5,0
3049855,682,1,2670326,2907650,3049855,142205,379529,142205,237324,5,0
3051176,1055,1,2683759,2908708,3051176,142468,367417,142468,224949,5,0
3051938,1338,1,2687995,2909443,3051938,142495,363943,142495,221448,5,0
3052885,892,1,2675819,2910312,3052885,142573,377066,142573,234493,5,0
3054450,1898,1,2722159,2910998,3054450,143452,332291,143452,188839,5,0
3054606,1339,1,2687996,2911140,3054606,143466,366610,143466,223144,5,0
3055668,1202,1,2685517,2912013,3055668,143655,370151,143655,226496,5,0
3057162,1439,1,2692110,2913378,3057162,143784,365052,143784,221268,5,0
3058389,1693,1,2718714,2914341,3058389,144048,339675,144048,195627,5,0
3061182,1625,1,2718485,2915370,3061182,145812,342697,145812,196885,5,0
3062494,1484,1,2692201,2915669,3062494,146825,370293,146825,223468,5,0
3063029,706,1,2670451,2915889,3063029,147140,392578,147140,245438,5,0
3063517,1553,1,2692444,2916311,3063517,147206,371073,147206,223867,5,0
3065638,1836,1,2722080,2917459,3065638,148179,343558,148179,195379,5,0
3066087,751,1,2670870,2917621,3066087,148466,395217,148466,246751,5,0
3066845,1170,1,2685405,2918257,3066845,148588,381440,148588,232852,5,0
3067832,750,1,2670863,2919007,3067832,148825,396969,148825,248144,5,0
3068748,1968,1,2722288,2919560,3068748,149188,346460,149188,197272,5,0
3069567,1794,1,2719115,2919948,3069567,149619,350452,149619,200833,5,0
3070924,1923,1,2722185,2921020,3070924,149904,348739,149904,198835,5,0
3072095,1410,1,2692072,2921993,3072095,150102,380023,150102,229921,5,0
3072975,986,1,2683280,2922610,3072975,150365,389695,150365,239330,5,0
3074549,817,1,2671349,2923471,3074549,151078,403200,151078,252122,5,0
3075463,1890,1,2722139,2924308,3075463,151155,353324,151155,202169,5,0
3077823,596,1,2661766,2925972,3077823,151851,416057,151851,264206,5,0
3079434,972,1,2683183,2926808,3079434,152626,396251,152626,243625,5,0
3080589,1607,1,2718469,2927789,3080589,152800,362120,152800,209320,5,0
3082218,1033,1,2683682,2928928,3082218,153290,398536,153290,245246,6,0
3083432,1151,1,2684885,2929974,3083432,153458,398547,153458,245089,7,0
3084584,1664,1,2718633,2930723,3084584,153861,365951,153861,212090,8,0
3085898,1975,1,2722309,2931529,3085898,154369,363589,154369,209220,8,0
3089200,1897,1,2722155,2933740,3089200,155460,367045,154706,212339,7,0
3092084,211,4,1631004,1631004,3092084,1461080,1461080,742697,718383,29,0
3092349,688,1,2670367,2934478,3092349,157871,421982,155498,266484,6,0
3096698,1651,1,2718578,2937167,3096698,159531,378120,156069,222051,5,0
3101351,563,1,2661681,2943203,3101351,158148,439670,158148,281522,4,0
3103052,784,1,2671230,2944861,3103052,158191,431822,158191,273631,4,0
3105455,1254,1,2685968,2945256,3105455,160199,419487,160199,259288,4,0
3107956,843,1,2671600,2946894,3107956,161062,436356,161062,275294,4,0
3111621,1590,8,2701423,3048109,3111621,63512,410198,63512,346686,0,0
3112553,1429,1,2692095,2949168,3112553,163385,420458,163385,257073,4,0
3113131,1467,1,2692151,2949373,3113131,163758,420980,163758,257222,4,0
3114370,1286,1,2686301,2950535,3114370,163835,428069,163835,264234,4,0
3115334,1788,1,2719105,2951190,3115334,164144,396229,164144,232085,4,0
3116933,1012,1,2683544,2952093,3116933,164840,433389,164840,268549,4,0
3118139,934,1,2682782,2952680,3118139,165459,435357,165459,269898,4,0
3119764,625,1,2662011,2954060,3119764,165704,457753,165704,292049,4,0
3121048,1268,1,2686035,2955020,3121048,166028,435013,166028,268985,4,0
3121901,1956,1,2722220,2955746,3121901,166155,399681,166155,233526,4,0
3122607,1858,1,2722103,2956317,3122607,166290,400504,166290,234214,4,0
3124518,1713,1,2718751,2957436,3124518,167082,405767,167082,238685,4,0
3127151,1622,1,2718481,2959295,3127151,167856,408670,167856,240814,4,0
3129833,1123,1,2684312,2961428,3129833,168405,445521,168405,277116,4,0
3131642,1498,1,2692218,2962704,3131642,168938,439424,168938,270486,5,0
3132823,1911,1,2722170,2963808,3132823,169015,410653,169015,241638,5,0
3133974,1915,1,2722174,2964394,3133974,169580,411800,169580,242220,5,0
3135165,440,1,2657323,2657323,3135165,477842,477842,173908,303934,10,0
3138553,778,1,2671201,2967141,3138553,171412,467352,171412,295940,5,0
3141032,521,1,2660781,2660781,3141032,480251,480251,173422,306829,10,0
3143524,1672,1,2718663,2969076,3143524,174448,424861,174448,250413,5,0
3144825,1278,1,2686225,2970356,3144825,174469,458600,174469,284131,5,0
3146248,1551,1,2692440,2971476,3146248,174772,453808,174772,279036,5,0
3149140,1702,1,2718729,2972857,3149140,176283,430411,176283,254128,5,0
3151036,1860,1,2722103,2974024,3151036,177012,428933,177012,251921,5,0
3153257,1982,1,2722330,2975634,3153257,177623,430927,177623,253304,5,0
3155688,1595,1,2718458,2976453,3155688,179235,437230,179235,257995,5,0
3156700,799,1,2671297,2977402,3156700,179298,485403,179298,306105,5,0
3158928,1557,1,2692451,2978003,3158928,180925,466477,180925,285552,4,0
3160587,1555,1,2692447,2979338,3160587,181249,468140,181249,286891,4,0
3161241,1717,1,2718767,2979854,3161241,181387,442474,181387,261087,4,0
3165008,609,1,2661844,2982654,3165008,182354,503164,182354,320810,4,0
3167666,1864,1,2722114,2984662,3167666,183004,445552,183004,262548,4,0
3169183,677,1,2670305,2986113,3169183,183070,498878,183070,315808,4,0
3173934,608,1,2661808,2987422,3173934,186512,512126,186512,325614,4,0
3175136,939,1,2682792,2988415,3175136,186721,492344,186721,305623,4,0
3175351,409,8,2581927,2606325,3175351,569026,593424,119482,473942,2,0
3176593,1839,1,2722085,2989838,3176593,186755,454508,186755,267753,4,0
3179413,687,1,2670363,2990991,3179413,188422,509050,188422,320628,4,0
3181950,1271,1,2686079,2992389,3181950,189561,495871,189561,306310,4,0
3183107,1302,1,2687928,2993330,3183107,189777,495179,189777,305402,4,0
3184002,1228,1,2685741,2993901,3184002,190101,498261,190101,308160,4,0
3185827,1230,1,2685744,2994622,3185827,191205,500083,191205,308878,4,0
3187376,1798,1,2719122,2995939,3187376,191437,468254,191437,276817,4,0
3188754,888,1,2675807,2996938,3188754,191816,512947,191816,321131,4,0
3191019,1281,1,2686252,2998219,3191019,192800,504767,192800,311967,4,0
3192147,512,1,2660666,2660666,3192147,531481,531481,193867,337614,9,0
3193871,1340,1,2687999,3000048,3193871,193823,505872,193823,312049,4,0
3196682,923,1,2676007,3002429,3196682,194253,520675,194253,326422,4,0
3197889,1351,1,2688026,3003063,3197889,194826,509863,194826,315037,4,0
3201056,616,1,2661959,3003936,3201056,197120,539097,197120,341977,4,0
3202740,853,1,2671877,3005476,3202740,197264,530863,197264,333599,4,0
3204438,471,1,2657558,2657558,3204438,546880,546880,201215,345665,8,0
3207391,554,1,2661665,3009267,3207391,198124,545726,198124,347602,4,0
3209478,1991,1,2722383,3010924,3209478,198554,487095,198554,288541,4,0
3211035,468,1,2657524,2657524,3211035,553511,553511,202887,350624,6,0
3213821,1062,1,2683785,3013570,3213821,200251,530036,200251,329785,4,0
3215319,1827,1,2719170,3014963,3215319,200356,496149,200356,295793,4,0
3216850,1545,1,2692424,3015969,3216850,200881,524426,200881,323545,4,0
3218112,528,1,2660930,2660930,3218112,557182,557182,201383,355799,6,0
3220676,1005,1,2683451,3019255,3220676,201421,537225,201421,335804,4,0
3222119,1186,1,2685470,3020467,3222119,201652,536649,201652,334997,4,0
3226488,1000,1,2683369,3022795,3226488,203693,543119,203693,339426,4,0
3227584,1045,1,2683716,3023439,3227584,204145,543868,204145,339723,4,0
3230624,1303,1,2687931,3025189,3230624,205435,542693,205435,337258,4,0
3233461,1358,1,2688366,3026898,3233461,206563,545095,206563,338532,4,0
3235218,1694,1,2718714,3028061,3235218,207157,516504,207157,309347,4,0
3237397,1817,1,2719153,3028995,3237397,208402,518244,208402,309842,4,0
3239599,728,1,2670697,3030150,3239599,209449,568902,209449,359453,4,0
3240172,1325,1,2687970,3030723,3240172,209449,552202,209449,342753,4,0
3242310,555,1,2661667,3031736,3242310,210574,580643,210574,370069,4,0
3243849,1162,1,2684938,3032773,3243849,211076,558911,211076,347835,4,0
3245695,1470,1,2692189,3033572,3245695,212123,553506,212123,341383,4,0
3249385,1154,1,2684892,3035635,3249385,213750,564493,213750,350743,4,0
3252491,1886,1,2722135,3037777,3252491,214714,530356,214714,315642,4,0
3253394,1489,1,2692206,3038640,3253394,214754,561188,214754,346434,4,0
3255796,1165,1,2684959,3040208,3255796,215588,570837,215588,355249,5,0
3256982,745,1,2670786,3040726,3256982,216256,586196,216256,369940,6,0
3258557,1504,1,2692229,3042224,3258557,216333,566328,216333,349995,7,0
3261065,1988,1,2722362,3043340,3261065,217725,538703,216591,322112,7,0
3263712,747,1,2670789,3044705,3263712,219007,592923,217261,375662,6,0
3266912,573,1,2661702,3046368,3266912,220544,605210,217477,387733,5,0
3269574,1598,1,2718461,3047577,3269574,221997,551113,218168,332945,4,0
3271131,460,1,2657428,2657428,3271131,613703,613703,221946,391757,5,0
3272834,1318,1,2687959,3054450,3272834,218384,584875,218384,366491,3,0
3274070,946,1,2682874,3054606,3274070,219464,591196,219464,371732,3,0
3275267,1260,1,2686000,3055668,3275267,219599,589267,219599,369668,3,0
3277764,585,1,2661736,3057162,3277764,220602,616028,220602,395426,3,0
3279737,762,1,2670937,3058389,3279737,221348,608800,221348,387452,3,0
3282960,641,1,2669837,3061182,3282960,221778,613123,221778,391345,3,0
3284272,1730,1,2718809,3062494,3284272,221778,565463,221778,343685,3,0
3285299,1430,1,2692099,3063029,3285299,222270,593200,222270,370930,3,0
3286872,1104,1,2684235,3063517,3286872,223355,602637,223355,379282,3,0
3294154,1144,1,2684848,3065638,3294154,228516,609306,228516,380790,3,0
3294711,1238,1,2685838,3066087,3294711,228624,608873,228624,380249,3,0
3296564,873,1,2672203,3066845,3296564,229719,624361,229719,394642,3,0
3299645,1812,1,2719149,3067832,3299645,231813,580496,231813,348683,3,0
3300714,1042,1,2683712,3068748,3300714,231966,617002,231966,385036,3,0
3302097,1585,1,2692528,3069567,3302097,232530,609569,232530,377039,3,0
3304097,1157,1,2684910,3070924,3304097,233173,619187,233173,386014,3,0
3305825,1946,1,2722211,3072095,3305825,233730,583614,233730,349884,3,0
3307226,971,1,2683121,3072975,3307226,234251,624105,234251,389854,3,0
3310097,836,1,2671452,3074549,3310097,235548,638645,235548,403097,3,0
3311106,1552,1,2692444,3075463,3311106,235643,618662,235643,383019,3,0
3313507,1378,1,2688492,3077823,3313507,235684,625015,235684,389331,3,0
3316710,1884,1,2722133,3079434,3316710,237276,594577,237276,357301,3,0
3318080,1386,1,2692016,3080589,3318080,237491,626064,237491,388573,3,0
3319908,1785,1,2719104,3082218,3319908,237690,600804,237690,363114,3,0
3324924,1332,1,2687982,3083432,3324924,241492,636942,241492,395450,3,0
3326178,1198,1,2685508,3084584,3326178,241594,640670,241594,399076,3,0
3328031,1394,1,2692024,3085898,3328031,242133,636007,242133,393874,2,0
3331765,1209,1,2685581,3089200,3331765,242565,646184,242565,403619,1,0
3334671,497,1,2660606,2660606,3334671,674065,674065,243105,430960,6,0
3337373,1219,1,2685631,3092084,3337373,245289,651742,245289,406453,1,0
3337950,462,1,2657464,2657464,3337950,680486,680486,249514,430972,13,0
3338088,900,1,2675846,3092084,3338088,246004,662242,246004,416238,3,0
3338796,638,8,2666697,3175351,3338796,163445,672099,163445,508654,0,0
3338855,1054,1,2683755,3092349,3338855,246506,655100,246506,408594,3,0
3345285,1549,1,2692431,3096698,3345285,248587,652854,248587,404267,3,0
3351257,1670,1,2718647,3101351,3351257,249906,632610,249906,382704,3,0
3356370,589,1,2661745,3103052,3356370,253318,694625,253318,441307,4,0
3359463,958,1,2683038,3105455,3359463,254008,676425,254008,422417,4,0
3363486,1780,1,2719075,3107956,3363486,255530,644411,255530,388881,5,0
3368308,748,1,2670825,3112553,3368308,255755,697483,255755,441728,4,0
3369497,1795,1,2719118,3113131,3369497,256366,650379,256366,394013,4,0
3371272,1901,1,2722159,3114370,3371272,256902,649113,256902,392211,4,0
3372536,1047,1,2683723,3115334,3372536,257202,688813,257202,431611,4,0
3374948,522,1,2660794,2660794,3374948,714154,714154,258335,455819,11,0
3377680,1971,1,2722298,3118139,3377680,259541,655382,259541,395841,4,0
3379676,760,1,2670930,3119764,3379676,259912,708746,259912,448834,4,0
3384266,1060,1,2683779,3121048,3384266,263218,700487,263218,437269,4,0
3385595,1533,1,2692376,3121901,3385595,263694,693219,263694,429525,4,0
3387410,1641,1,2718545,3122607,3387410,264803,668865,264803,404062,4,0
3389969,1656,1,2718597,3124518,3389969,265451,671372,265451,405921,4,0
3397054,1972,1,2722303,3127151,3397054,269903,674751,269903,404848,4,0
3400070,1753,1,2718932,3129833,3400070,270237,681138,270237,410901,4,0
3402882,1567,1,2692469,3131642,3402882,271240,710413,271240,439173,4,0
3405722,696,1,2670380,3132823,3405722,272899,735342,272899,462443,4,0
3410373,1653,1,2718582,3133974,3410373,276399,691791,276399,415392,4,0
3411920,1038,1,2683696,3135165,3411920,276755,728224,276755,451469,4,0
3415812,1645,1,2718563,3138553,3415812,277259,697249,277259,419990,4,0
3421380,1471,1,2692189,3141032,3421380,280348,729191,280348,448843,4,0
3425098,498,1,2660610,2660610,3425098,764488,764488,281990,482498,16,0
3430605,558,1,2661672,3144825,3430605,285780,768933,285780,483153,4,0
3432395,1584,1,2692506,3146248,3432395,286147,739889,286147,453742,4,0
3436004,606,1,2661797,3149140,3436004,286864,774207,286864,487343,4,0
3439824,1374,1,2688478,3151036,3439824,288788,751346,288788,462558,4,0
3446557,1528,1,2692366,3153257,3446557,293300,754191,293300,460891,4,0
3449657,1712,1,2718751,3155688,3449657,293969,730906,293969,436937,4,0
3450875,994,1,2683355,3156700,3450875,294175,767520,294175,473345,4,0
3454234,1390,1,2692020,3158928,3454234,295306,762214,295306,466908,4,0
3457199,1671,1,2718663,3160587,3457199,296612,738536,296612,441924,4,0
3457997,991,1,2683351,3161241,3457997,296756,774646,296756,477890,4,0
3462911,1863,1,2722114,3165008,3462911,297903,740797,297903,442894,4,0
3467661,1856,1,2722100,3167666,3467661,299995,745561,299995,445566,4,0
3469236,1063,1,2683789,3169183,3469236,300053,785447,300053,485394,4,0
3475089,1232,1,2685748,3173934,3475089,301155,789341,301155,488186,4,0
3477196,1851,1,2722096,3175136,3477196,302060,755100,302060,453040,4,0
3479208,501,1,2660620,2660620,3479208,818588,818588,302993,515595,20,0
3484059,612,1,2661919,3179413,3484059,304646,822140,304646,517494,3,0
3495472,704,1,2670410,3181950,3495472,313522,825062,313522,511540,4,0
3498070,1876,1,2722125,3183107,3498070,314963,775945,314963,460982,4,0
3499195,628,1,2662035,3184002,3499195,315193,837160,315193,521967,4,0
3506201,1115,1,2684297,3185827,3506201,320374,821904,320374,501530,4,0
3509650,1704,1,2718735,3187376,3509650,322274,790915,322274,468641,4,0
3514977,1381,1,2691997,3188754,3514977,326223,822980,326223,496757,4,0
3517409,1437,1,2692106,3191019,3517409,326390,825303,326390,498913,4,0
3522592,758,1,2670927,3192147,3522592,330445,851665,330445,521220,4,0
3529286,952,1,2682968,3193871,3529286,335415,846318,335415,510903,4,0
3532719,1203,1,2685518,3196682,3532719,336037,847201,336037,511164,4,0
3535646,1825,1,2719163,3197889,3535646,337757,816483,337757,478726,4,0
3541986,824,1,2671373,3201056,3541986,340930,870613,340930,529683,4,0
3544506,1632,1,2718496,3202740,3544506,341766,826010,341766,484244,4,0
3547039,833,1,2671444,3204438,3547039,342601,875595,342601,532994,4,0
3559853,559,1,2661674,3207391,3559853,352462,898179,352462,545717,4,0
3563444,667,1,2670269,3209478,3563444,353966,893175,353966,539209,4,0
3565763,450,1,2657372,2657372,3565763,908391,908391,358257,550134,35,0
3572939,1485,1,2692203,3213821,3572939,359118,880736,359118,521618,5,0
3574437,1683,1,2718690,3215319,3574437,359118,855747,359118,496629,5,0
3579596,444,1,2657338,2657338,3579596,922258,922258,366166,556092,48,0
3581938,664,1,2670264,3218112,3581938,363826,911674,363826,547848,6,0
3583105,2,4,135296,135296,3583105,3447809,3447809,1924399,1523410,60,0
3588680,646,1,2670190,3220676,3588680,368004,918490,368004,550486,6,0
3594301,955,1,2683031,3222119,3594301,372182,911270,372182,539088,6,0
3606536,1781,1,2719077,3226488,3606536,380048,887459,380048,507411,7,0
3613925,461,1,2657431,2657431,3613925,956494,956494,389563,566931,55,0
3619686,1616,1,2718476,3230624,3619686,389062,901210,389062,512148,7,0
3627035,1882,1,2722132,3233461,3627035,393574,904903,393574,511329,7,0
3636312,1043,1,2683713,3235218,3636312,401094,952599,401094,551505,7,0
3637345,363,8,2320958,2320958,3637345,1316387,1316387,527341,789046,4,0
3640330,1393,1,2692023,3237397,3640330,402933,948307,402933,545374,7,0
3647545,1222,1,2685639,3239599,3647545,407946,961906,407946,553960,8,0
3649036,1888,1,2722137,3240172,3649036,408864,926899,408864,518035,8,0
3651593,930,1,2681620,3242310,3651593,409283,969973,409283,560690,8,0
3657979,684,1,2670349,3243849,3657979,414130,987630,414130,573500,8,0
3667847,785,1,2671234,3245695,3667847,422152,996613,422152,574461,10,0
3773456,415,4,2596848,2596848,3773456,1176608,1176608,411625,764983,10,0
3828295,337,4,2128140,2187465,3828295,1640830,1700155,741753,958402,26,0
3861516,417,8,2597176,2606974,3861516,1254542,1264340,397213,867127,1,0
3938455,355,8,2312592,2472794,3938455,1465661,1625863,574700,1051163,8,0
3952168,338,4,2136440,2246196,3952168,1705972,1815728,742416,1073312,31,0
4015217,252,8,1687886,1727199,4015217,2288018,2327331,719180,1608151,11,0
4025763,1750,1,2718920,3249385,4025763,776378,1306843,776378,530465,29,0
4101364,1867,1,2722118,3252491,4101364,848873,1379246,848873,530373,36,0
4110004,388,1,2433436,2433436,4110004,1676568,1676568,1075997,600571,164,0
4115461,336,4,2127314,2285106,4115461,1830355,1988147,745997,1242150,23,0
4124244,375,8,2367116,2543903,4124244,1580341,1757128,654524,1102604,2,0
4180468,346,16,2294569,2434617,4180468,1745851,1885899,468177,1417722,1,0
4182384,315,24,1890617,4180468,4182384,1916,2291767,1916,2289851,0,0
4204400,326,8,1999507,2119669,4204400,2084731,2204893,748747,1456146,6,0
4213285,390,4,2446555,2575997,4213285,1637288,1766730,764900,1001830,2,0
4343032,1989,1,2722367,3255796,4343032,1087236,1620665,1087236,533429,70,0
4356526,344,4,2228466,3498070,4356526,858456,2128060,858456,1269604,0,0
4415237,1724,1,2718782,3256982,4415237,1158255,1696455,1158255,538200,77,0
4419480,200,4,1512239,1607814,4419480,2811666,2907241,943475,1963766,3,0
4430843,1778,1,2719070,3258557,4430843,1172286,1711773,1172286,539487,77,0
4473161,371,4,2335306,3506201,4473161,966960,2137855,966960,1170895,0,0
4476382,547,1,2661650,3261065,4476382,1215317,1814732,1215317,599415,85,0
4478536,196,16,1449967,1539796,4478536,2938740,3028569,731170,2297399,3,0
4500372,310,8,1869016,3619686,4500372,880686,2631356,880686,1750670,0,0
4522082,220,4,1631077,3509650,4522082,1012432,2891005,1007480,1883525,6,0
4599705,421,8,2604199,3637345,4599705,962360,1995506,962360,1033146,0,0
4755176,339,4,2163120,3563444,4755176,1191732,2592056,1148297,1443759,7,0
4766716,146,8,964711,988931,4766716,3777785,3802005,1124484,2677521,3,0
4891530,419,8,2600242,3773456,4891530,1118074,2291288,1118074,1173214,1,0
4932228,22,16,400756,401222,4932228,4531006,4531472,1269666,3261806,2,0
4999146,224,4,1631552,3647545,4999146,1351601,3367594,1294205,2073389,5,0
5077830,400,8,2494512,3861516,5077830,1216314,2583318,1139552,1443766,1,0
5165552,378,16,2376860,4204400,5165552,961152,2788692,961152,1827540,0,0
5231774,246,2,1646505,1770478,5231774,3461296,3585269,2799272,785997,382,0
5296325,376,4,2372592,3952168,5296325,1344157,2923733,1344157,1579576,8,0
5454893,410,16,2594093,4478536,5454893,976357,2860800,976357,1884443,0,0
5466384,1002,1,2683376,3263712,5466384,2202672,2783008,2200010,582998,129,0
5510135,1536,1,2692381,3271131,5510135,2239004,2817754,2239004,578750,131,0
5510967,292,8,1822851,4110004,5510967,1400963,3688116,1238138,2449978,6,0
5696860,277,4,1774638,4101364,5696860,1595496,3922222,1429261,2492961,5,0
5739622,188,8,1178874,4500372,5739622,1239250,4560748,1239250,3321498,0,0
5881268,307,8,1865425,4522082,5881268,1359186,4015843,1359186,2656657,0,0
5963110,377,16,2376839,4932228,5963110,1030882,3586271,1030882,2555389,0,0
6027469,97,4,766093,766093,6027469,5261376,5261376,1618713,3642663,12,0
6313221,1592,4,2713430,4599705,6313221,1713516,3599791,1713516,1886275,1,0
6395070,205,16,1557968,5165552,6395070,1229518,4837102,1229518,3607584,0,0
6422957,189,8,1178884,4766716,6422957,1656241,5244073,1656241,3587832,0,0
6569984,169,8,1047350,4891530,6569984,1678454,5522634,1678454,3844180,0,0
6696728,317,8,1974764,4999146,6696728,1697582,4721964,1697582,3024382,0,0
6783203,112,4,821081,821081,6783203,5962122,5962122,2003388,3958734,13,0
6805509,399,16,2493450,5454893,6805509,1350616,4312059,1350616,2961443,0,0
6980324,131,8,861361,927710,6980324,6052614,6118963,1775226,4343737,4,0
7148863,278,4,1774640,5077830,7148863,2071033,5374223,2006482,3367741,2,0
7399387,258,8,1730062,5510967,7399387,1888420,5669325,1888420,3780905,0,0
7475739,241,2,1646306,1771624,7475739,5704115,5829433,4244887,1584546,263,0
7668544,21,16,400593,401376,7668544,7267168,7267951,2158786,5109165,1,0
7698998,293,8,1822860,5739622,7698998,1959376,5876138,1959376,3916762,0,0
7804532,281,4,1774670,5696860,7804532,2107672,6029862,2107672,3922190,2,0
8040251,104,4,784410,784410,8040251,7255841,7255841,2239657,5016184,4,0
8066566,144,4,963852,5881268,8066566,2185298,7102714,2185298,4917416,1,0
8106263,424,16,2606750,6395070,8106263,1711193,5499513,1711193,3788320,0,0
8219942,162,4,1019104,6027469,8219942,2192473,7200838,2192473,5008365,0,0
8327367,255,2,1688722,1809773,8327367,6517594,6638645,4479073,2159572,174,0
8508930,218,4,1631067,6313221,8508930,2195709,6877863,2195709,4682154,1,0
8626492,101,4,781010,781010,8626492,7845482,7845482,2276736,5568746,1,0
8634672,227,4,1631556,6422957,8634672,2211715,7003116,2211715,4791401,0,0
8855123,403,8,2512305,6569984,8855123,2285139,6342818,2285139,4057679,0,0
9027509,4,4,265278,265278,9027509,8762231,8762231,2919714,5842517,2,0
9029569,285,4,1774822,6696728,9029569,2332841,7254747,2332841,4921906,0,0
9118518,214,4,1631035,6783203,9118518,2335315,7487483,2335315,5152168,0,0
9131327,208,16,1558015,6805509,9131327,2325818,7573312,2325818,5247494,0,0
9358760,333,4,2090363,6980324,9358760,2378436,7268397,2378436,4889961,0,0
9414356,213,4,1631022,6980324,9414356,2434032,7783334,2434032,5349302,0,0
9621522,334,4,2116069,7148863,9621522,2472659,7505453,2472659,5032794,0,0
9780997,25,8,401222,401376,9780997,9379621,9379775,2817446,6562329,2,0
10104526,405,8,2526558,7668544,10104526,2435982,7577968,2435982,5141986,0,0
10170918,176,8,1047404,7668544,10170918,2502374,9123514,2502374,6621140,0,0
10428630,257,8,1730048,7698998,10428630,2729632,8698582,2729632,5968950,0,0
10634416,279,4,1774667,7804532,10634416,2829884,8859749,2829884,6029865,0,0
10957881,331,4,2061649,8040251,10957881,2917630,8896232,2917630,5978602,0,0
11073796,408,4,2581022,8066566,11073796,3007230,8492774,3007230,5485544,0,0
11081266,7,8,318802,318802,11081266,10762464,10762464,3437211,7325253,1,0
11127165,173,8,1047390,8106263,11127165,3020902,10079775,3020902,7058873,0,0
11256022,100,4,780879,781010,11256022,10475012,10475143,3049919,7425224,5,0
11678739,425,8,2608106,8508930,11678739,3169809,9070633,3169809,5900824,0,0
11812941,381,8,2414713,8634672,11812941,3178269,9398228,3178269,6219959,0,0
12069784,323,8,1998746,8855123,12069784,3214661,10071038,3214661,6856377,0,0
12247707,180,8,1096082,9029569,12247707,3218138,11151625,3218138,7933487,0,0
12385959,164,4,1019170,8327367,12385959,4058592,11366789,3459244,7907545,3,0
12551180,148,8,965420,9131327,12551180,3419853,11585760,3419853,8165907,0,0
12685327,210,4,1627770,9131327,12685327,3554000,11057557,3554000,7503557,0,0
12823871,216,4,1631050,9131327,12823871,3692544,11192821,3692544,7500277,1,0
13031133,150,8,995729,9414356,13031133,3616777,12035404,3616777,8418627,0,0
13438156,231,4,1631618,9358760,13438156,4079396,11806538,3872230,7934308,2,0
13635003,349,16,2294598,10170918,13635003,3464085,11340405,3464085,7876320,0,0
13663925,302,4,1856539,9780997,13663925,3882928,11807386,3882928,7924458,0,0
13757100,383,4,2417375,9780997,13757100,3976103,11339725,3976103,7363622,1,0
14379439,422,8,2604284,10104526,14379439,4274913,11775155,4017201,7757954,2,0
14700766,91,4,766066,766066,14700766,13934700,13934700,4066377,9868323,2,0
15160893,342,4,2181484,10957881,15160893,4203012,12979409,4203012,8776397,1,0
15216543,190,8,1304037,11081266,15216543,4135277,13912506,4135277,9777229,0,0
15328405,240,2,1646305,3296564,15328405,12031841,13682100,5904651,7777449,116,0
15428323,184,8,1178856,11127165,15428323,4301158,14249467,4301158,9948309,0,0
15716103,130,4,857974,11256022,15716103,4460081,14858129,4460081,10398048,0,0
16027469,8,8,319542,319542,16027469,15707927,15707927,4793924,10914003,2,0
16175670,300,8,1823022,11812941,16175670,4362729,14352648,4362729,9989919,0,0
16470661,299,8,1822961,12069784,16470661,4400877,14647700,4400877,10246823,0,0
16689763,145,8,964317,12247707,16689763,4442056,15725446,4442056,11283390,0,0
16982078,37,4,686742,686742,16982078,16295336,16295336,4648901,11646435,11,0
17151492,309,8,1865433,12551180,17151492,4600312,15286059,4600312,10685747,0,0
17238387,393,16,2477340,13635003,17238387,3603384,14761047,3603384,11157663,0,0
17400729,396,4,2478572,12685327,17400729,4715402,14922157,4715402,10206755,0,0
17671725,639,4,2668201,12823871,17671725,4847854,15003524,4847854,10155670,0,0
17738659,185,8,1178858,13031133,17738659,4707526,16559801,4707526,11852275,0,0
18549351,96,4,766078,13438156,18549351,5111195,17783273,5111195,12672078,1,0
18650569,237,8,1641723,13757100,18650569,4893469,17008846,4893469,12115377,0,0
19353113,318,8,1989178,14379439,19353113,4973674,17363935,4973674,12390261,0,0
20473491,168,4,1039080,13663925,20473491,6809566,19434411,5865900,13568511,1,0
20887091,368,8,2334109,15216543,20887091,5670548,18552982,5670548,12882434,0,0
21009555,244,2,1646496,3302097,21009555,17707458,19363059,10282698,9080361,114,0
21120344,379,8,2407884,15428323,21120344,5692021,18712460,5692021,13020439,0,0
21354548,0,4,0,0,21354548,21354548,21354548,6720840,14633708,45,0
21605445,11,16,323049,323049,21605445,21282396,21282396,5844722,15437674,4,0
22115646,332,4,2073301,15716103,22115646,6399543,20042345,6399543,13642802,2,0
22234757,178,8,1096057,16027469,22234757,6207288,21138700,5912297,15226403,1,0
22711977,411,16,2594103,17151492,22711977,5560485,20117874,5560485,14557389,0,0
22935649,414,16,2594228,17238387,22935649,5697262,20341421,5697262,14644159,0,0
23451297,222,4,1631085,16689763,23451297,6761534,21820212,6761534,15058678,3,0
23690791,16,16,394610,394610,23690791,23296181,23296181,6052640,17243541,3,0
25292819,191,8,1304039,16982078,25292819,8310741,23988780,6878598,17110182,2,0
25353875,106,4,817942,16689763,25353875,8664112,24535933,7367835,17168098,3,0
26249059,392,8,2459476,19353113,26249059,6895946,23789583,6895946,16893637,0,0
27190265,13,16,324387,324387,27190265,26865878,26865878,6174342,20691536,3,0
27875110,350,16,2294607,21605445,27875110,6269665,25580503,6269665,19310838,0,0
27898030,284,4,1774804,20473491,27898030,7424539,26123226,7424539,18698687,1,0
28576279,187,8,1178860,20887091,28576279,7689188,27397419,7454984,19942435,3,0
29528947,147,4,965019,21009555,29528947,8519392,28563928,7758294,20805634,2,0
30015234,163,4,1019109,22234757,30015234,7780477,28996125,7780477,21215648,0,0
30218747,102,4,782660,22234757,30218747,7983990,29436087,7983990,21452097,0,0
30412446,15,16,394438,394774,30412446,30017672,30018008,7706762,22311246,1,0
31245049,416,4,2596880,22935649,31245049,8309400,28648169,8309400,20338769,0,0
31406508,105,4,817779,22935649,31406508,8470859,30588729,8470859,22117870,0,0
31452022,28,8,401681,573378,31452022,30878644,31050341,8607473,22442868,17,0
32192985,245,2,1646501,3310097,32192985,28882888,30546484,14927798,15618686,109,0
32280981,17,16,394774,23690791,32280981,8590190,31886207,8590190,23296017,0,0
34167755,282,4,1774802,25292819,34167755,8874936,32392953,8874936,23518017,0,0
34733939,93,4,766066,25292819,34733939,9441120,33967873,9441120,24526753,0,0
35115764,94,4,766068,25353875,35115764,9761889,34349696,9761889,24587807,0,0
35326039,134,8,869029,26249059,35326039,9076980,34457010,9076980,25380030,0,0
36901520,420,8,2602087,27190265,36901520,9711255,34299433,9711255,24588178,0,0
36995087,369,8,2334143,27190265,36995087,9804822,34660944,9804822,24856122,0,0
37896474,36,4,686170,686170,37896474,37210304,37210304,10022074,27188230,17,0
37915265,322,8,1989246,27875110,37915265,10040155,35926019,10040155,25885864,0,0
38285038,359,8,2320908,27898030,38285038,10387008,35964130,10387008,25577122,0,0
39376756,98,4,766112,27875110,39376756,11501646,38610644,10823397,27787247,1,0
40388126,9,8,319849,319849,40388126,40068277,40068277,10940552,29127725,5,0
40461202,413,16,2594185,30412446,40461202,10048756,37867017,10048756,27818261,0,0
41109916,125,8,857704,30218747,41109916,10891169,40252212,10891169,29361043,0,0
42319754,360,8,2320926,31406508,42319754,10913246,39998828,10913246,29085582,0,0
43273329,27,8,401530,31452022,43273329,11821307,42871799,11821307,31050492,0,0
44179642,29,4,504171,504171,44179642,43675471,43675471,13352064,30323407,10,0
44453287,192,8,1304040,32280981,44453287,12172306,43149247,12172306,30976941,0,0
46302485,107,4,820095,32280981,46302485,14021504,45482390,14021504,31460886,0,0
46922091,330,4,2055825,32280981,46922091,14641110,44866266,14641110,30225156,0,0
48951262,298,8,1822924,34733939,48951262,14217323,47128338,14217323,32911015,0,0
49381473,95,4,766070,34167755,49381473,15213718,48615403,14831893,33783510,1,0
50366230,1288,8,2686540,35326039,50366230,15040191,47679690,15040191,32639499,0,0
51966824,358,8,2320879,36901520,51966824,15065304,49645945,15065304,34580641,0,0
52082870,362,8,2320955,36995087,52082870,15087783,49761915,15087783,34674132,0,0
53114521,182,8,1096114,37915265,53114521,15199256,52018407,15199256,36819151,0,0
53683904,108,4,820394,37896474,53683904,15787430,52863510,15787430,37076080,1,0
53691258,139,8,962031,38285038,53691258,15406220,52729227,15406220,37323007,0,0
55637724,194,4,1343095,39376756,55637724,16260968,54294629,16260968,38033661,0,0
56105574,295,8,1822869,40388126,56105574,15717448,54282705,15717448,38565257,0,0
56741099,99,4,766117,40461202,56741099,16279897,55974982,16279897,39695085,0,0
56750149,1591,4,2712817,40461202,56750149,16288947,54037332,16288947,37748385,0,0
57230319,248,8,1687837,40461202,57230319,16769117,55542482,16769117,38773365,0,0
58293916,239,8,1641757,41109916,58293916,17184000,56652159,17184000,39468159,0,0
59803276,19,8,395522,42319754,59803276,17483522,59407754,17483522,41924232,0,0
61897377,166,4,1019195,43273329,61897377,18624048,60878182,18624048,42254134,0,0
61918014,167,4,1019219,43273329,61918014,18644685,60898795,18644685,42254110,0,0
63300567,149,8,965719,44453287,63300567,18847280,62334848,18847280,43487568,0,0
63457314,209,4,1613397,44179642,63457314,19277672,61843917,19277672,42566245,1,0
65773054,335,4,2116072,46302485,65773054,19470569,63656982,19470569,44186413,0,0
67510102,316,4,1966130,46922091,67510102,20588011,65543972,20588011,44955961,0,0
71112286,253,2,1688640,3313507,71112286,67798779,69423646,31393029,38030617,102,0
71601927,345,4,2292500,48951262,71601927,22650665,69309427,22650665,46658762,0,0
73337075,217,4,1631051,49381473,73337075,23955602,71706024,23955602,47750422,0,0
76503893,26,8,401376,50366230,76503893,26137663,76102517,26137663,49964854,0,0
79038247,427,8,2614804,51966824,79038247,27071423,76423443,27071423,49352020,0,0
79953294,136,4,948297,52082870,79953294,27870424,79004997,27870424,51134573,0,0
80112337,207,16,1558001,58293916,80112337,21818421,78554336,21818421,56735915,0,0
81506783,129,8,857791,53114521,81506783,28392262,80648992,28392262,52256730,0,0
81779599,276,4,1774474,52082870,81779599,29696729,80005125,29696729,50308396,1,0
82182813,183,8,1096116,53691258,82182813,28491555,81086697,28491555,52595142,0,0
85524055,103,4,783187,53683904,85524055,31840151,84740868,31840151,52900717,1,0
88787875,319,8,1989194,56105574,88787875,32682301,86798681,32682301,54116380,0,0
90051175,361,8,2320942,56741099,90051175,33310076,87730233,33310076,54420157,1,0
93096071,110,4,820685,55637724,93096071,37458347,92275386,37449297,54826089,3,0
94790163,294,8,1822866,57230319,94790163,37559844,92967297,36050484,56916813,1,0
94957045,206,16,1557984,63300567,94957045,31656478,93399061,31656478,61742583,0,0
97374639,242,2,1646329,3319908,97374639,94054731,95728310,48715766,47012544,93,0
100752534,234,8,1632724,61918014,100752534,38834520,99119810,36362033,62757777,1,0
113174250,113,4,842377,61897377,113174250,51276873,112331873,48000525,64331348,2,0
116304057,236,8,1641711,73337075,116304057,42966982,114662346,42966982,71695364,0,0
120480141,12,8,324143,324143,120480141,120155998,120155998,44047627,76108371,1,0
123652305,20,8,395836,79038247,123652305,44614058,123256469,44614058,78642411,0,0
128312683,418,8,2597518,80112337,128312683,48200346,125715165,48200346,77514819,0,0
129073536,357,8,2320868,80112337,129073536,48961199,126752668,48961199,77791469,0,0
130774341,249,8,1687837,81506783,130774341,49267558,129086504,49267558,79818946,0,0
132741200,254,2,1688643,3328031,132741200,129413169,131052557,61895184,69157373,79,0
134289352,308,8,1865430,81779599,134289352,52509753,132423922,52509753,79914169,0,0
136739902,370,8,2334145,82182813,136739902,54557089,134405757,54557089,79848668,0,0
145096443,324,8,1999327,88787875,145096443,56308568,143097116,56308568,86788548,0,0
147937918,109,4,820530,71601927,147937918,76335991,147117388,65975316,81142072,6,0
149978750,23,16,400914,94790163,149978750,55188587,149577836,55188587,94389249,0,0
151285303,203,16,1550385,94957045,151285303,56328258,149734918,56328258,93406660,0,0
159089470,201,4,1530230,90051175,159089470,69038295,157559240,69038295,88520945,3,0
166148367,329,4,2037560,90051175,166148367,76097192,164110807,70134821,93975986,2,0
171547327,3,4,178298,178298,171547327,171369029,171369029,72814604,98554425,13,0
182349376,412,16,2594117,120480141,182349376,61869235,179755259,61869235,117886024,0,0
190334794,5,4,313422,313422,190334794,190021372,190021372,77242644,112778728,3,0
200398111,197,8,1450073,116304057,200398111,84094054,198948038,80921890,118026148,1,0
207589119,204,16,1551062,129073536,207589119,78515583,206038057,78515583,127522474,0,0
211728209,325,8,1999460,128312683,211728209,83415526,209728749,81714721,128014028,1,0
230419577,6,8,318554,318554,230419577,230101023,230101023,96206445,133894578,4,0
254968654,10,16,320203,320203,254968654,254648451,254648451,109946618,144701833,4,0
261584504,14,8,330439,330439,261584504,261254065,261254065,122067462,139186603,4,0
347333820,179,8,1096070,149978750,347333820,197355070,346237750,197355070,148882680,0,0
348245909,127,8,857759,149978750,348245909,198267159,347388150,198267159,149120991,0,0
755119908,250,8,1687855,151285303,755119908,603834605,753432053,603834605,149597448,0,0
