time,job_id,num_gpu,submit_time,start_time,end_time,executed_time,JCT,duration,pending_time,preempt,promote
524706,4,8,512614,512614,524706,12092,12092,12092,0,0,0
559303,1,4,1456,1456,559303,557847,557847,557847,0,0,0
566163,7,8,542432,542432,566163,23731,23731,23731,0,0,0
597706,8,8,589714,589714,597706,7992,7992,7992,0,0,0
700895,16,8,680163,680163,700895,20732,20732,20732,0,0,0
710452,9,8,665621,665621,710452,44831,44831,44831,0,0,0
711640,15,8,680146,680146,711640,31494,31494,31494,0,0,0
872119,17,1,773814,773814,872119,98305,98305,98305,0,0,0
1017657,18,8,895207,895207,1017657,122450,122450,122450,0,0,0
1088393,24,8,972336,972336,1088393,116057,116057,116057,0,0,0
1108976,22,32,937097,943298,1108976,165678,171879,165678,6201,0,0
1121086,5,8,517969,517969,1121086,603117,603117,603117,0,0,0
1151426,23,1,943298,972336,1151426,179090,208128,179090,29038,0,0
1172065,19,8,929584,929584,1172065,242481,242481,242481,0,0,0
1209494,38,8,1207098,1207098,1209494,2396,2396,2396,0,0,0
1211878,6,8,533527,533527,1211878,678351,678351,678351,0,0,0
1217530,37,8,1205035,1205035,1217530,12495,12495,12495,0,0,0
1224367,39,8,1209098,1209098,1224367,15269,15269,15269,0,0,0
1231904,21,32,937075,972336,1231904,259568,294829,259568,35261,0,0
1233895,41,4,1222021,1222021,1233895,11874,11874,11874,0,0,0
1277529,32,8,1198208,1198208,1277529,79321,79321,79321,0,0,0
1294832,47,8,1288816,1288816,1294832,6016,6016,6016,0,0,0
1301124,30,8,1198165,1198165,1301124,102959,102959,102959,0,0,0
1308960,40,8,1212768,1212768,1308960,96192,96192,96192,0,0,0
1334260,2,4,352430,352430,1334260,981830,981830,981830,0,0,0
1362931,53,8,1362087,1362087,1362931,844,844,844,0,0,0
1367580,55,8,1366817,1366817,1367580,763,763,763,0,0,0
1371382,54,8,1363741,1363741,1371382,7641,7641,7641,0,0,0
1379426,48,8,1300065,1300065,1379426,79361,79361,79361,0,0,0
1382774,58,8,1379974,1379974,1382774,2800,2800,2800,0,0,0
1396822,49,8,1300853,1300853,1396822,95969,95969,95969,0,0,0
1405009,57,32,1379074,1379426,1405009,25583,25935,25583,352,0,0
1432724,52,8,1361647,1361647,1432724,71077,71077,71077,0,0,0
1437296,64,8,1408253,1408253,1437296,29043,29043,29043,0,0,0
1455344,65,8,1435521,1435521,1455344,19823,19823,19823,0,0,0
1468415,72,8,1461874,1461874,1468415,6541,6541,6541,0,0,0
1470164,70,8,1453262,1453262,1470164,16902,16902,16902,0,0,0
1479908,71,8,1457822,1457822,1479908,22086,22086,22086,0,0,0
1517459,10,8,665969,665969,1517459,851490,851490,851490,0,0,0
1540778,66,8,1441858,1441858,1540778,98920,98920,98920,0,0,0
1546669,83,8,1529623,1529623,1546669,17046,17046,17046,0,0,0
1552485,85,8,1536518,1536518,1552485,15967,15967,15967,0,0,0
1562119,82,8,1499394,1499394,1562119,62725,62725,62725,0,0,0
1617155,62,8,1385826,1385826,1617155,231329,231329,231329,0,0,0
1641229,56,32,1379050,1379974,1641229,261255,262179,261255,924,0,0
1660251,86,8,1545400,1545400,1660251,114851,114851,114851,0,0,0
1705891,63,32,1387257,1396822,1705891,309069,318634,309069,9565,0,0
1721881,67,8,1441922,1441922,1721881,279959,279959,279959,0,0,0
1739657,59,8,1382142,1382142,1739657,357515,357515,357515,0,0,0
1976114,111,8,1971303,1971303,1976114,4811,4811,4811,0,0,0
1986234,25,8,972341,972341,1986234,1013893,1013893,995921,17972,3,0
1989501,116,8,1987448,1987448,1989501,2053,2053,2053,0,0,0
1990266,108,8,1968479,1968479,1990266,21787,21787,21787,0,0,0
1997661,107,8,1963257,1963257,1997661,34404,34404,34404,0,0,0
2084710,100,8,1741404,1741404,2084710,343306,343306,343306,0,0,0
2085800,124,1,2080187,2080187,2085800,5613,5613,5613,0,0,0
2109633,117,8,1991832,1991832,2109633,117801,117801,117801,0,0,0
2115085,115,16,1986862,1986862,2115085,128223,128223,128223,0,0,0
2125504,125,8,2092764,2092764,2125504,32740,32740,32740,0,0,0
2143607,45,32,1274054,1405009,2143607,738598,869553,529696,339857,1,0
2146542,126,8,2131377,2131377,2146542,15165,15165,15165,0,0,0
2183694,122,8,2064450,2064450,2183694,119244,119244,119244,0,0,0
2185740,42,32,1273988,1641229,2185740,544511,911752,544511,367241,0,0
2192704,133,8,2187386,2190963,2192704,1741,5318,1741,3577,0,0
2201633,105,8,1818396,1818396,2201633,383237,383237,383237,0,0,0
2281751,113,8,1978758,1978758,2281751,302993,302993,302993,0,3,0
2324688,140,8,2235073,2281751,2324688,42937,89615,42937,46678,0,0
2342223,114,32,1984102,2143607,2342223,198616,358121,198616,159505,0,0
2346137,74,8,1463038,1470164,2346137,875973,883099,815550,67549,38,0
2351264,141,1,2347736,2347736,2351264,3528,3528,3528,0,0,0
2354511,134,8,2189193,2192704,2354511,161807,165318,161807,3511,0,0
2364485,128,1,2159458,2159458,2364485,205027,205027,205027,0,0,0
2396295,131,1,2168059,2168059,2396295,228236,228236,228236,0,0,0
2469521,142,8,2352139,2352139,2469521,117382,117382,117382,0,0,0
2511473,89,32,1548830,1705891,2511473,805582,962643,588321,374322,1,0
2532355,112,8,1976623,1976623,2532355,555732,555732,508280,47452,12,0
2533728,151,8,2533111,2533111,2533728,617,617,617,0,0,0
2576786,156,1,2569772,2569772,2576786,7014,7014,7014,0,0,0
2580765,159,1,2575880,2575880,2580765,4885,4885,4885,0,0,0
2590129,135,8,2190963,2201633,2590129,388496,399166,388496,10670,0,0
2593298,165,1,2575958,2575958,2593298,17340,17340,17340,0,0,0
2596295,157,1,2575861,2575861,2596295,20434,20434,20434,0,0,0
2609877,160,1,2575888,2575888,2609877,33989,33989,33989,0,0,0
2622752,154,8,2567407,2567407,2622752,55345,55345,55345,0,0,0
2629052,162,1,2575928,2575928,2629052,53124,53124,53124,0,0,0
2678922,174,8,2671796,2671796,2678922,7126,7126,7126,0,0,0
2680629,161,1,2575898,2575898,2680629,104731,104731,104731,0,0,0
2716931,164,1,2575948,2575948,2716931,140983,140983,140983,0,0,0
2726920,163,1,2575937,2575937,2726920,150983,150983,150983,0,0,0
2758745,92,8,1548882,1552485,2758745,1206260,1209863,815752,394111,14,0
2779054,170,8,2648030,2648030,2779054,131024,131024,131024,0,0,0
2817682,171,8,2665170,2665170,2817682,152512,152512,152512,0,0,0
2834319,181,8,2763952,2763974,2834319,70345,70367,70345,22,0,0
2835488,176,8,2693483,2758745,2835488,76743,142005,76743,65262,0,0
2839099,158,1,2575871,2575871,2839099,263228,263228,263228,0,0,0
2840083,123,8,2078637,2115085,2840083,724998,761446,724998,36448,6,0
2856536,137,8,2235058,2324688,2856536,531848,621478,531848,89630,0,0
2857429,153,8,2561473,2569772,2857429,287657,295956,287657,8299,0,0
2879479,177,8,2739679,2779054,2879479,100425,139800,100425,39375,0,0
2896044,152,8,2535022,2535022,2896044,361022,361022,361022,0,0,0
2898150,132,1,2183382,2183382,2898150,714768,714768,714768,0,0,0
3004495,106,2,1933693,2080187,3004495,924308,1070802,850650,220152,19,0
3084924,11,8,672805,672805,3084924,2412119,2412119,1586713,825406,30,0
3113847,198,8,3010664,3010664,3113847,103183,103183,103183,0,0,0
3127231,195,8,3009785,3009785,3127231,117446,117446,117446,0,0,0
3143716,130,8,2161892,2342223,3143716,801493,981824,801493,180331,0,0
3146862,200,1,3085485,3085485,3146862,61377,61377,61377,0,0,0
3180224,102,8,1789807,2342223,3180224,838001,1390417,838001,552416,0,0
3182801,188,32,3003988,3143716,3182801,39085,178813,39085,139728,0,0
3185580,202,2,3184949,3184949,3185580,631,631,631,0,0,0
3205064,104,8,1811028,2342223,3205064,862841,1394036,862841,531195,0,0
3210864,199,8,3021360,3021360,3210864,189504,189504,189504,0,0,0
3234179,205,8,3208775,3208775,3234179,25404,25404,25404,0,0,0
3260429,187,32,3000184,3182801,3260429,77628,260245,77628,182617,0,0
3284419,212,1,3280677,3280677,3284419,3742,3742,3742,0,0,0
3297419,120,8,2045101,2346137,3297419,951282,1252318,942794,309524,3,0
3299571,166,1,2575975,2575975,3299571,723596,723596,723596,0,0,0
3335076,213,8,3302269,3302269,3335076,32807,32807,32807,0,0,0
3365592,215,1,3347810,3347810,3365592,17782,17782,17782,0,0,0
3449692,214,1,3347678,3347678,3449692,102014,102014,102014,0,0,0
3457908,186,32,2959239,3260429,3457908,197479,498669,197479,301190,0,0
3501004,143,8,2352143,2469521,3501004,1031483,1148861,1023002,125859,1,0
3532112,182,8,2763974,2817682,3532112,714430,768138,714430,53708,0,0
3607721,168,8,2647617,2647617,3607721,960104,960104,882633,77471,2,0
3782679,225,1,3723295,3723295,3782679,59384,59384,59384,0,0,0
3849451,208,8,3227576,3227576,3849451,621875,621875,621875,0,0,0
3875690,233,8,3869987,3869987,3875690,5703,5703,5703,0,0,0
3879058,184,8,2808341,2835488,3879058,1043570,1070717,1043570,27147,0,0
3938331,201,2,3173344,3173344,3938331,764987,764987,764987,0,0,0
3950376,235,8,3949328,3949328,3950376,1048,1048,1048,0,0,0
3952728,232,8,3815828,3815828,3952728,136900,136900,136900,0,0,0
4077692,238,8,4031998,4031998,4077692,45694,45694,45694,0,0,0
4141273,79,32,1466095,2511473,4141273,1629800,2675178,747780,1927398,1,0
4143213,223,32,3694824,4141273,4143213,1940,448389,1940,446449,0,0
4159421,13,8,672933,672933,4159421,3486488,3486488,2052171,1434317,25,0
4187838,228,32,3780749,4143213,4187838,44625,407089,44625,362464,0,0
4198195,247,8,4095598,4095598,4198195,102597,102597,102597,0,0,0
4239475,236,8,3950721,3950721,4239475,288754,288754,288754,0,0,0
4239978,252,1,4221357,4221357,4239978,18621,18621,18621,0,0,0
4254732,256,8,4234303,4234303,4254732,20429,20429,20429,0,0,0
4261123,259,8,4258673,4259031,4261123,2092,2450,2092,358,0,0
4270752,224,32,3702669,4187838,4270752,82914,568083,82914,485169,0,0
4272498,260,8,4259031,4261123,4272498,11375,13467,11375,2092,0,0
4284505,258,8,4258552,4258552,4284505,25953,25953,25953,0,0,0
4297005,251,32,4199711,4270752,4297005,26253,97294,26253,71041,0,0
4299193,266,8,4296879,4296986,4299193,2207,2314,2207,107,0,0
4299714,138,8,2235061,2590129,4299714,1709585,2064653,1501079,563574,8,0
4300561,261,8,4261348,4272498,4300561,28063,39213,28063,11150,0,0
4306110,275,8,4302372,4302372,4306110,3738,3738,3738,0,0,0
4323746,272,8,4302316,4302316,4323746,21430,21430,21430,0,0,0
4339264,274,8,4302344,4306110,4339264,33154,36920,33154,3766,0,0
4348351,280,8,4326892,4339264,4348351,9087,21459,9087,12372,0,0
4348984,283,8,4344304,4348351,4348984,633,4680,633,4047,0,0
4351325,263,8,4288473,4297005,4351325,54320,62852,54320,8532,0,0
4358703,210,8,3267778,3267778,4358703,1090925,1090925,1090925,0,0,0
4359663,269,8,4297062,4299193,4359663,60470,62601,60470,2131,0,0
4365401,286,8,4357299,4358703,4365401,6698,8102,6698,1404,0,0
4384133,217,8,3418308,3418308,4384133,965825,965825,965825,0,0,0
4390962,273,8,4302322,4302322,4390962,88640,88640,88640,0,0,0
4414235,291,1,4396907,4396907,4414235,17328,17328,17328,0,0,0
4416070,277,1,4315128,4315128,4416070,100942,100942,100942,0,0,0
4418350,296,8,4405380,4405380,4418350,12970,12970,12970,0,0,0
4424580,279,8,4324936,4348984,4424580,75596,99644,75596,24048,0,0
4471166,91,8,1548860,2622752,4471166,1848414,2922306,1638602,1283704,11,0
4483470,226,8,3724758,3724758,4483470,758712,758712,758712,0,0,0
4493845,301,1,4489380,4489380,4493845,4465,4465,4465,0,0,0
4510431,304,8,4502258,4502258,4510431,8173,8173,8173,0,0,0
4519155,305,8,4517911,4517911,4519155,1244,1244,1244,0,0,0
4522079,307,8,4518440,4518440,4522079,3639,3639,3639,0,0,0
4522849,310,8,4519286,4522079,4522849,770,3563,770,2793,0,0
4528914,309,8,4518933,4519155,4528914,9759,9981,9759,222,0,0
4532906,313,8,4524203,4524230,4532906,8676,8703,8676,27,0,0
4536963,289,8,4396331,4396392,4536963,140571,140632,140571,61,0,0
4540038,314,8,4524230,4528914,4540038,11124,15808,11124,4684,0,0
4545480,303,1,4494659,4494659,4545480,50821,50821,50821,0,0,0
4549116,315,8,4524238,4532906,4549116,16210,24878,16210,8668,0,0
4556811,282,8,4343615,4351325,4556811,205486,213196,205486,7710,0,0
4566470,302,2,4491418,4491418,4566470,75052,75052,75052,0,0,0
4566663,219,8,3639937,3639937,4566663,926726,926726,926726,0,4,0
4572808,312,8,4524192,4536963,4572808,35845,48616,35845,12771,0,0
4575218,320,1,4565596,4565596,4575218,9622,9622,9622,0,0,0
4580714,318,1,4562297,4562297,4580714,18417,18417,18417,0,0,0
4587080,268,8,4296986,4297005,4587080,290075,290094,290075,19,0,0
4592482,243,8,4095543,4095543,4592482,496939,496939,496939,0,0,0
4622035,321,8,4603845,4603845,4622035,18190,18190,18190,0,0,0
4630747,285,8,4355239,4359663,4630747,271084,275508,271084,4424,0,0
4646864,308,8,4518676,4518676,4646864,128188,128188,128188,0,0,0
4650530,319,1,4562735,4562735,4650530,87795,87795,87795,0,0,0
4658587,97,8,1549769,2879479,4658587,1779108,3108818,1679036,1429782,34,0
4672032,311,8,4520722,4522849,4672032,149183,151310,149183,2127,0,0
4698768,293,8,4403339,4403339,4698768,295429,295429,295429,0,0,0
4700252,328,8,4687814,4687814,4700252,12438,12438,12438,0,0,0
4701928,242,1,4089062,4089062,4701928,612866,612866,612866,0,5,0
4710380,306,8,4518167,4540038,4710380,170342,192213,170342,21871,0,0
4730747,270,8,4302251,4302288,4730747,428459,428496,428459,37,0,0
4768429,237,8,3951467,3951467,4768429,816962,816962,753139,63823,12,0
4773951,290,8,4396392,4418350,4773951,355601,377559,355601,21958,0,0
4790521,323,8,4661051,4672032,4790521,118489,129470,118489,10981,0,0
4794778,338,8,4780877,4790521,4794778,4257,13901,4257,9644,0,0
4807071,317,8,4549316,4556811,4807071,250260,257755,250260,7495,0,0
4810584,336,8,4759010,4759014,4810584,51570,51574,51570,4,0,0
4810878,334,8,4751881,4751881,4810878,58997,58997,58997,0,0,0
4815419,327,8,4687811,4698768,4815419,116651,127608,116651,10957,0,0
4819447,341,8,4814673,4814673,4819447,4774,4774,4774,0,0,0
4823152,337,8,4759014,4768429,4823152,54723,64138,54723,9415,0,0
4850891,333,8,4751873,4759007,4850891,91884,99018,91884,7134,0,0
4877914,292,1,4397285,4397285,4877914,480629,480629,480629,0,8,0
4882125,271,8,4302288,4323746,4882125,558379,579837,533493,46344,1,0
4886805,175,1,2672949,2672949,4886805,2213856,2213856,2213856,0,155,0
4910390,332,8,4725976,4730747,4910390,179643,184414,179643,4771,0,0
4942110,343,8,4935698,4935946,4942110,6164,6412,6164,248,0,0
4957357,339,8,4814491,4814491,4957357,142866,142866,142866,0,0,0
4966040,347,8,4945345,4945345,4966040,20695,20695,20695,0,0,0
4977398,257,8,4235083,4239475,4977398,737923,742315,582214,160101,5,0
4986429,326,8,4687806,4700252,4986429,286177,298623,286177,12446,0,0
4989923,346,8,4942249,4957357,4989923,32566,47674,32566,15108,0,0
4999518,353,8,4995385,4995385,4999518,4133,4133,4133,0,0,0
5000544,322,8,4635387,4635387,5000544,365157,365157,365157,0,0,0
5001101,354,8,4996513,4996513,5001101,4588,4588,4588,0,0,0
5001299,356,8,4997990,4997990,5001299,3309,3309,3309,0,0,0
5009229,363,8,5006129,5006129,5009229,3100,3100,3100,0,0,0
5013147,348,8,4988524,4988585,5013147,24562,24623,24562,61,0,0
5025613,351,8,4994587,4995038,5025613,30575,31026,30575,451,0,0
5038913,372,8,5020578,5020578,5038913,18335,18335,18335,0,0,0
5082790,367,32,5006163,5081896,5082790,894,76627,894,75733,0,0
5090540,342,1,4931129,4931129,5090540,159411,159411,159411,0,0,0
5093570,366,32,5006158,5082790,5093570,10780,87412,10780,76632,0,0
5097342,364,8,5006133,5006133,5097342,91209,91209,91209,0,0,0
5098947,344,8,4935946,4935954,5098947,162993,163001,162993,8,0,0
5102153,264,8,4295990,4297005,5102153,805148,806163,601142,205021,3,0
5103650,371,8,5020574,5020574,5103650,83076,83076,83076,0,0,0
5110294,376,1,5073789,5073789,5110294,36505,36505,36505,0,0,0
5111618,377,1,5081896,5081896,5111618,29722,29722,29722,0,0,0
5135632,384,8,5125628,5125628,5135632,10004,10004,10004,0,0,0
5135658,382,8,5125621,5125621,5135658,10037,10037,10037,0,0,0
5144670,365,32,5006155,5093570,5144670,51100,138515,51100,87415,0,0
5152827,378,8,5081986,5081986,5152827,70841,70841,70841,0,0,0
5152949,380,8,5103828,5103828,5152949,49121,49121,49121,0,0,0
5161490,385,8,5156232,5160256,5161490,1234,5258,1234,4024,0,0
5169395,349,8,4988585,4989789,5169395,179606,180810,179606,1204,0,0
5173708,386,8,5160256,5161490,5173708,12218,13452,12218,1234,0,0
5181239,389,8,5177565,5177565,5181239,3674,3674,3674,0,0,0
5205815,352,8,4995038,4997986,5205815,207829,210777,207829,2948,0,0
5227334,375,32,5020989,5144670,5227334,82664,206345,82664,123681,0,0
5286196,394,8,5203304,5203304,5286196,82892,82892,82892,0,0,0
5291423,265,8,4296830,4299714,5291423,991709,994593,738643,255950,4,0
5353180,350,1,4989789,4989789,5353180,363391,363391,363391,0,0,0
5393939,381,8,5103846,5103846,5393939,290093,290093,290093,0,0,0
5409725,379,32,5086226,5227334,5409725,182391,323499,182391,141108,0,0
5415833,362,8,5006125,5006125,5415833,409708,409708,409708,0,0,0
5417538,297,1,4410658,4410658,5417538,1006880,1006880,1006006,874,46,0
5436305,402,8,5428045,5428045,5436305,8260,8260,8260,0,0,0
5445738,401,8,5428042,5436305,5445738,9433,17696,9433,8263,0,0
5450684,404,1,5448204,5448204,5450684,2480,2480,2480,0,0,0
5481104,406,8,5450756,5450756,5481104,30348,30348,30348,0,0,0
5481724,118,8,2035614,2896044,5481724,2585680,3446110,1692621,1753489,62,0
5503765,330,8,4725969,4794778,5503765,708987,777796,708987,68809,5,0
5508535,409,32,5500582,5503765,5508535,4770,7953,4770,3183,0,0
5515363,278,1,4318284,4318284,5515363,1197079,1197079,1193344,3735,94,0
5533116,410,32,5500589,5508535,5533116,24581,32527,24581,7946,0,0
5546090,335,8,4759007,4807071,5546090,739019,787083,713659,73424,3,0
5556501,407,8,5498736,5498736,5556501,57765,57765,57765,0,0,0
5617715,429,8,5611873,5611873,5617715,5842,5842,5842,0,0,0
5635468,428,4,5606701,5606701,5635468,28767,28767,28767,0,0,0
5648404,426,8,5526213,5533116,5648404,115288,122191,115288,6903,0,0
5671656,395,8,5203307,5203362,5671656,468294,468349,468294,55,0,0
5676298,427,1,5604341,5604341,5676298,71957,71957,71957,0,0,0
5711785,218,32,3625903,5409725,5711785,302060,2085882,302060,1783822,0,0
5712140,345,8,4935954,4942110,5712140,770030,776186,742942,33244,9,0
5723923,433,8,5678408,5678408,5723923,45515,45515,45515,0,0,0
5741743,434,4,5694659,5694659,5741743,47084,47084,47084,0,0,0
5775457,403,4,5448068,5448068,5775457,327389,327389,327389,0,0,0
5793079,360,8,5006087,5006087,5793079,786992,786992,717754,69238,20,0
5827803,316,8,4549310,4630747,5827803,1197056,1278493,999715,278778,18,0
5845814,435,1,5700199,5700199,5845814,145615,145615,145615,0,0,0
5877267,276,2,4314048,4314048,5877267,1563219,1563219,1470346,92873,148,0
5906640,437,8,5708753,5711785,5906640,194855,197887,194855,3032,0,0
5923075,438,8,5708757,5711785,5923075,211290,214318,211290,3028,0,0
6001967,432,8,5678402,5678402,6001967,323565,323565,323565,0,0,0
6039214,234,8,3930863,3930863,6039214,2108351,2108351,1035897,1072454,13,0
6158461,445,8,6025188,6025188,6158461,133273,133273,133273,0,0,0
6161596,421,8,5526185,5533116,6161596,628480,635411,628480,6931,0,0
6169760,451,8,6168786,6168786,6169760,974,974,974,0,0,0
6192060,453,8,6169176,6169760,6192060,22300,22884,22300,584,0,0
6253154,300,8,4418589,4850891,6253154,1402263,1834565,1061203,773362,13,0
6265760,454,8,6254582,6254582,6265760,11178,11178,11178,0,0,0
6265973,430,8,5623444,5623444,6265973,642529,642529,642529,0,0,0
6270563,452,8,6168884,6168884,6270563,101679,101679,101679,0,0,0
6272099,420,32,5525972,6025069,6272099,247030,746127,247030,499097,0,0
6280368,456,8,6254600,6254600,6280368,25768,25768,25768,0,0,0
6320214,455,8,6254586,6265760,6320214,54454,65628,54454,11174,0,0
6381548,391,8,5181157,5393939,6381548,987609,1200391,958258,242133,17,0
6393579,448,8,6111283,6111283,6393579,282296,282296,282296,0,0,0
6471269,450,8,6168349,6168349,6471269,302920,302920,302920,0,0,0
6499844,392,8,5181178,5415833,6499844,1084011,1318666,958653,360013,26,0
6511824,464,32,6502921,6503276,6511824,8548,8903,8548,355,0,0
6530688,472,32,6528388,6528428,6530688,2260,2300,2260,40,0,0
6537601,477,32,6529219,6530688,6537601,6913,8382,6913,1469,0,0
6538774,442,32,6025069,6272099,6538774,266675,513705,266675,247030,0,0
6538936,480,32,6530869,6534164,6538936,4772,8067,4772,3295,0,0
6544843,482,32,6534164,6537601,6544843,7242,10679,7242,3437,0,0
6545772,470,32,6528322,6537601,6545772,8171,17450,8171,9279,0,0
6547762,476,32,6528442,6538774,6547762,8988,19320,8988,10332,0,0
6552593,467,32,6502977,6511824,6552593,40769,49616,39434,10182,1,0
6566734,479,32,6529964,6544843,6566734,21891,36770,21891,14879,0,0
6569112,478,32,6529901,6545772,6569112,23340,39211,23340,15871,0,0
6581995,474,32,6528415,6547762,6581995,34233,53580,34233,19347,0,0
6595242,449,8,6116635,6116635,6595242,478607,478607,460178,18429,1,0
6632789,405,1,5448702,5450684,6632789,1182105,1184087,1163676,20411,53,0
6637535,465,32,6502941,6566734,6637535,70801,134594,70801,63793,0,0
6638330,229,8,3799877,3879058,6638330,2759272,2838453,1133260,1705193,23,0
6737736,424,8,5526206,5671656,6737736,1066080,1211530,1013913,197617,12,0
6740701,484,1,6739370,6739370,6740701,1331,1331,1331,0,0,0
6748668,475,32,6528428,6569112,6748668,179556,220240,179556,40684,0,0
6753652,483,1,6738661,6738661,6753652,14991,14991,14991,0,0,0
6761564,463,32,6502613,6581995,6761564,179569,258951,179569,79382,0,0
6771070,370,1,5012390,5012390,6771070,1758680,1758680,1621258,137422,106,0
6812193,457,8,6365548,6365548,6812193,446645,446645,379831,66814,1,0
6817116,466,32,6502960,6637535,6817116,179581,314156,179581,134575,0,0
6820466,489,4,6806776,6806776,6820466,13690,13690,13690,0,0,0
6828825,487,8,6774169,6806776,6828825,22049,54656,22049,32607,0,0
6872755,493,8,6817841,6828825,6872755,43930,54914,43930,10984,0,0
6895725,491,8,6817147,6817147,6895725,78578,78578,78578,0,0,0
6913296,504,8,6911191,6911191,6913296,2105,2105,2105,0,0,0
6916686,505,8,6915290,6915290,6916686,1396,1396,1396,0,0,0
6917643,415,8,5523615,5723923,6917643,1193720,1394028,1049269,344759,12,0
6946813,506,4,6915524,6915524,6946813,31289,31289,31289,0,0,0
6950046,500,4,6906477,6906477,6950046,43569,43569,43569,0,0,0
6950677,507,8,6931848,6946813,6950677,3864,18829,3864,14965,0,0
6958278,499,1,6832918,6832918,6958278,125360,125360,125360,0,0,0
6968172,502,1,6909082,6909082,6968172,59090,59090,59090,0,0,0
6976932,485,1,6739551,6739551,6976932,237381,237381,237381,0,0,0
7003355,490,8,6817138,6817138,7003355,186217,186217,186217,0,0,0
7021015,461,8,6499021,6499021,7021015,521994,521994,312686,209308,7,0
7047666,469,32,6503276,6748668,7047666,298998,544390,298998,245392,0,0
7063718,459,8,6394624,6394624,7063718,669094,669094,435958,233136,7,0
7076900,508,8,6932130,6950046,7076900,126854,144770,126854,17916,0,0
7131160,503,8,6910110,6910110,7131160,221050,221050,221050,0,0,0
7147613,462,8,6499094,6499094,7147613,648519,648519,390231,258288,1,0
7161999,488,1,6804949,6804949,7161999,357050,357050,357050,0,0,0
7168221,509,1,6977272,6977272,7168221,190949,190949,190949,0,0,0
7201848,486,8,6765853,6812193,7201848,389655,435995,389655,46340,0,0
7226035,357,8,4997993,5775457,7226035,1450578,2228042,1050115,1177927,15,0
7261659,492,8,6817802,6817802,7261659,443857,443857,443857,0,0,0
7325043,511,8,7293462,7293462,7325043,31581,31581,31581,0,0,0
7335084,431,8,5678399,5793079,7335084,1542005,1656685,1095857,560828,17,0
7338458,513,8,7324131,7324131,7338458,14327,14327,14327,0,0,0
7347163,515,1,7334402,7334402,7347163,12761,12761,12761,0,0,0
7351212,501,8,6907927,6907927,7351212,443285,443285,438196,5089,3,0
7357607,510,8,7293344,7293344,7357607,64263,64263,64263,0,0,0
7363232,520,8,7352063,7352063,7363232,11169,11169,11169,0,0,0
7400947,517,1,7339932,7339932,7400947,61015,61015,61015,0,0,0
7410320,519,1,7340612,7340612,7410320,69708,69708,69708,0,0,0
7410570,516,1,7339906,7339906,7410570,70664,70664,70664,0,0,0
7443487,518,1,7340449,7340449,7443487,103038,103038,103038,0,0,0
7541937,494,8,6817860,6872755,7541937,669182,724077,575937,148140,1,0
7604394,497,1,6828268,6828268,7604394,776126,776126,766451,9675,11,0
7632656,397,32,5203362,7047666,7632656,584990,2429294,584990,1844304,0,0
7653389,253,1,4221911,4221911,7653389,3431478,3431478,2996875,434603,338,0
7658340,514,8,7329044,7329044,7658340,329296,329296,329296,0,0,0
7736505,447,8,6111079,6320214,7736505,1416291,1625426,894690,730736,16,0
7815419,498,1,6828288,6828288,7815419,987131,987131,974851,12280,19,0
7946886,436,8,5708749,5827803,7946886,2119083,2238137,1096071,1142066,9,0
7949385,524,8,7932314,7946886,7949385,2499,17071,2499,14572,0,0
8023034,525,8,7962000,7962000,8023034,61034,61034,61034,0,0,0
8046996,529,8,7987121,8023034,8046996,23962,59875,23962,35913,0,0
8087983,530,8,7997757,8046996,8087983,40987,90226,40987,49239,0,0
8092568,523,1,7894819,7894819,8092568,197749,197749,197749,0,0,0
8108871,255,8,4232574,4886805,8108871,3222066,3876297,1147437,2728860,7,0
8146047,532,8,8141054,8141054,8146047,4993,4993,4993,0,0,0
8159143,390,8,5180533,5923075,8159143,2236068,2978610,1113524,1865086,14,0
8188640,526,1,7974515,7974515,8188640,214125,214125,214125,0,0,0
8258899,439,8,6025027,6025027,8258899,2233872,2233872,1050141,1183731,19,0
8334787,288,32,4396265,7632656,8334787,702131,3938522,702131,3236391,0,0
8414491,446,8,6025207,7226035,8414491,1188456,2389284,1127316,1261968,14,0
8466741,419,32,5525969,7736505,8466741,730236,2940772,730236,2210536,0,0
8485237,241,8,4039030,4910390,8485237,3574847,4446207,1197489,3248718,8,0
8576420,521,8,7384480,7410320,8576420,1166100,1191940,1166100,25840,4,0
8597419,527,1,7975556,7975556,8597419,621863,621863,621863,0,0,0
8663442,528,1,7976735,7976735,8663442,686707,686707,686707,0,2,0
9111398,441,32,6025060,8334787,9111398,776611,3086338,776611,2309727,0,0
9210287,68,8,1447269,2898150,9210287,6312137,7763018,1729653,6033365,34,0
9392210,531,8,8042503,8108871,9392210,1283339,1349707,1278346,71361,3,0
9418352,473,32,6528402,8466741,9418352,951611,2889950,951611,1938339,0,0
9443953,408,8,5500560,7604394,9443953,1839559,3943393,1416921,2526472,6,0
9608169,299,8,4418240,7658340,9608169,1949829,5189929,1427435,3762494,3,0
9611010,0,4,0,0,9611010,9611010,9611010,5352613,4258397,265,0
9913468,324,8,4661056,8414491,9913468,1498977,5252412,1498977,3753435,2,0
10088103,329,8,4690733,8485237,10088103,1602866,5397370,1602866,3794504,2,0
10144640,481,32,6530882,9111398,10144640,1033242,3613758,1033242,2580516,0,0
10226377,398,8,5203379,8576420,10226377,1649957,5022998,1649957,3373041,2,0
10552288,203,32,3188710,9418352,10552288,1133936,7363578,1133936,6229642,0,0
10870010,239,8,4035377,9210287,10870010,1659723,6834633,1659723,5174910,0,0
10994701,522,1,7894655,7894819,10994701,3099882,3100046,2984049,115997,23,0
11052063,246,8,4095577,9392210,11052063,1659853,6956486,1659853,5296633,1,0
11108680,240,8,4037130,9443953,11108680,1664727,7071550,1664727,5406823,0,0
11275894,193,8,3009771,3607721,11275894,7668173,8266123,1699941,6566182,2,0
11546381,36,32,1202360,1231904,11546381,10314477,10344021,1549811,8794210,1,0
11634252,393,8,5203300,9913468,11634252,1720784,6430952,1720784,4710168,0,0
11812643,325,8,4661059,10088103,11812643,1724540,7151584,1724540,5427044,0,0
11969301,331,8,4725972,10226377,11969301,1742924,7243329,1742924,5500405,0,0
12062104,99,2,1574758,2183382,12062104,9878722,10487346,7372645,3114701,398,0
12342958,355,8,4997986,10552288,12342958,1790670,7344972,1790670,5554302,0,0
12354504,496,8,6826013,10552288,12354504,1802216,5528491,1802216,3726275,0,0
12362528,172,8,2668028,10552288,12362528,1810240,9694500,1810240,7884260,0,0
12422826,33,8,1198246,1198246,12422826,11224580,11224580,2064845,9159735,7,0
12749563,414,8,5500647,10870010,12749563,1879553,7248916,1879553,5369363,0,0
12958604,173,8,2668371,11052063,12958604,1906541,10290233,1906541,8383692,0,0
13109640,425,8,5526210,11108680,13109640,2000960,7583430,2000960,5582470,0,0
13309347,411,8,5500609,11275894,13309347,2033453,7808738,2033453,5775285,0,0
13619033,150,8,2443694,11546381,13619033,2072652,11175339,2072652,9102687,0,0
13702113,295,8,4405375,11546381,13702113,2155732,9296738,2155732,7141006,0,0
13737167,359,8,5006082,11546381,13737167,2190786,8731085,2190786,6540299,0,0
13740831,361,8,5006109,11546381,13740831,2194450,8734722,2194450,6540272,0,0
13835155,76,8,1463193,11634252,13835155,2200903,12371962,2200903,10171059,0,0
14034622,512,8,7317610,11812643,14034622,2221979,6717012,2221979,4495033,0,0
14290895,417,8,5523622,11969301,14290895,2321594,8767273,2321594,6445679,0,0
14461123,281,8,4326953,12062104,14461123,2399019,10134170,2399019,7735151,0,0
14881991,60,8,1383820,12342958,14881991,2539033,13498171,2539033,10959138,2,0
14895091,144,8,2352269,12354504,14895091,2540587,12542822,2540587,10002235,2,0
14939882,146,8,2352304,12362528,14939882,2577354,12587578,2577354,10010224,1,0
15038984,96,8,1549002,12422826,15038984,2616158,13489982,2616158,10873824,0,0
15376730,287,8,4396213,12749563,15376730,2627167,10980517,2627167,8353350,1,0
15659676,28,8,972388,1108976,15659676,14550700,14687288,2971674,11715614,4,0
15871516,423,8,5526192,13109640,15871516,2761876,10345324,2761876,7583448,1,0
16077885,422,8,5526189,13309347,16077885,2768538,10551696,2768538,7783158,1,0
16147901,471,32,6528374,13740831,16147901,2407070,9619527,2407070,7212457,0,0
16502936,368,8,5010472,13619033,16502936,2883903,11492464,2789579,8702885,4,0
16788363,373,8,5020582,13702113,16788363,3086250,11767781,2792459,8975322,3,0
17089314,73,8,1463016,13737167,17089314,3352147,15626298,2802083,12824215,2,0
17367979,194,8,3009781,14461123,17367979,2906856,14358198,2906856,11451342,1,0
18062675,358,8,5006076,14881991,18062675,3180684,13056599,3180684,9875915,2,0
18124781,413,8,5500642,14895091,18124781,3229690,12624139,3229690,9394449,2,0
18258393,222,8,3646247,14939882,18258393,3318511,14612146,3318511,11293635,2,0
18395552,388,8,5172342,15038984,18395552,3356568,13223210,3356568,9866642,2,0
18573522,468,32,6502996,16147901,18573522,2425621,12070526,2425621,9644905,0,0
18797518,227,8,3724810,15376730,18797518,3420788,15072708,3420788,11651920,2,0
19143981,101,8,1784044,15659676,19143981,3484305,17359937,3484305,13875632,2,0
19488867,230,8,3799985,15871516,19488867,3617351,15688882,3617351,12071531,2,0
19757242,231,8,3814560,16077885,19757242,3679357,15942682,3679357,12263325,2,0
20231236,248,8,4095603,16502936,20231236,3728300,16135633,3728300,12407333,2,0
20524871,119,8,2045080,16788363,20524871,3736508,18479791,3736508,14743283,2,0
20880232,169,8,2648019,17089314,20880232,3790918,18232213,3790918,14441295,1,0
21028551,78,32,1466073,18395552,21028551,2632999,19562478,2632999,16929479,0,0
21213988,27,8,972384,1108976,21213988,20105012,20241604,4106917,16134687,11,0
21713244,206,32,3226969,18573522,21713244,3139722,18486275,3139722,15346553,0,0
22613494,129,8,2161867,18062675,22613494,4550819,20451627,4148853,16302774,3,0
23161983,383,8,5125625,18124781,23161983,5037202,18036358,4288773,13747585,3,0
23936692,121,16,2052086,19757242,23936692,4179450,21884606,4179450,17705156,1,0
24483895,51,8,1316099,1316099,24483895,23167796,23167796,4713035,18454761,10,0
24511466,418,32,5525965,21028551,24511466,3482915,18985501,3482915,15502586,0,0
25276054,29,8,1198143,1198143,25276054,24077911,24077911,4885556,19192355,22,0
25466538,374,32,5020986,21713244,25466538,3753294,20445552,3753294,16692258,0,0
25735046,148,8,2398878,20880232,25735046,4854814,23336168,4854814,18481354,2,0
26097566,267,8,4296919,21213988,26097566,4883578,21800647,4883578,16917069,1,0
27571988,298,8,4417969,22613494,27571988,4958494,23154019,4958494,18195525,1,0
28161995,87,8,1546505,23161983,28161995,5000012,26615490,5000012,21615478,0,0
28773474,396,32,5203358,24511466,28773474,4262008,23570116,4262008,19308108,0,0
29055068,369,8,5011091,23936692,29055068,5118376,24043977,5118376,18925601,2,0
29116763,196,8,3009789,23936692,29116763,5180071,26106974,5180071,20926903,2,0
29709731,244,8,4095548,24483895,29709731,5225836,25614183,5225836,20388347,1,0
29971228,189,32,3008241,25466538,29971228,4504690,26962987,4504690,22458297,0,0
30513248,167,8,2647611,25276054,30513248,5237194,27865637,5237194,22628443,2,0
30979244,221,8,3642919,25735046,30979244,5244198,27336325,5244198,22092127,1,0
31467298,495,8,6826006,26097566,31467298,5369732,24641292,5369732,19271560,0,0
33313736,20,32,937052,937052,33313736,32376684,32376684,4575546,27801138,1,0
33452420,50,8,1315692,1315692,33452420,32136728,32136728,5880839,26255889,2,0
34219374,387,8,5172333,28161995,34219374,6057379,29047041,6057379,22989662,3,0
34669309,183,32,2764358,29971228,34669309,4698081,31904951,4698081,27206870,0,0
35780135,443,8,6025159,29055068,35780135,6725067,29754976,6725067,23029909,3,0
35978457,458,8,6365553,29116763,35978457,6861694,29612904,6861694,22751210,3,0
36624681,147,8,2387276,29709731,36624681,6914950,34237405,6914950,27322455,3,0
37449662,207,8,3227452,30513248,37449662,6936414,34222210,6936414,27285796,2,0
38381381,43,32,1274009,33313736,38381381,5067645,37107372,5067645,32039727,0,0
38683932,191,8,3009764,30979244,38683932,7704688,35674168,7704688,27969480,2,0
39312026,220,8,3642869,31467298,39312026,7844728,35669157,7844728,27824429,2,0
39781646,35,32,1202338,34669309,39781646,5112337,38579308,5112337,33466971,0,0
41484726,185,8,2959121,33452420,41484726,8032306,38525605,8032306,30493299,2,0
42347776,294,8,4405368,34219374,42347776,8128402,37942408,8128402,29814006,3,0
43454429,88,32,1548807,37449662,43454429,6004767,41905622,6004767,35900855,0,0
44412445,249,32,4095722,38381381,44412445,6031064,40316723,6031064,34285659,0,0
45297200,31,8,1198187,1198187,45297200,44099013,44099013,8306106,35792907,8,0
45871586,340,32,4814582,39781646,45871586,6089940,41057004,6089940,34967064,0,0
46305129,245,8,4095572,35978457,46305129,10326672,42209557,8464308,33745249,3,0
49157049,26,8,972381,1108976,49157049,48048073,48184668,8586536,39598132,3,0
50361395,46,32,1274076,43454429,50361395,6906966,49087319,6906966,42180353,0,0
50882269,211,8,3267795,42347776,50882269,8534493,47614474,8534493,39079981,1,0
52385542,44,32,1274032,44412445,52385542,7973097,51111510,7973097,43138413,0,0
53871548,216,8,3385021,45297200,53871548,8574348,50486527,8574348,41912179,0,0
54299591,34,32,1202315,45871586,54299591,8428005,53097276,8428005,44669271,0,0
54896523,98,8,1572361,46305129,54896523,8591394,53324162,8591394,44732768,0,0
58813741,61,8,1383824,49157049,58813741,9656692,57429917,9656692,47773225,0,0
59710916,250,32,4095727,50361395,59710916,9349521,55615189,9349521,46265668,0,0
61313993,262,8,4283179,50882269,61313993,10431724,57030814,10431724,46599090,0,0
63018337,93,8,1548919,52385542,63018337,10632795,61469418,10632795,50836623,0,0
63293306,284,8,4345030,52385542,63293306,10907764,58948276,10907764,48040512,0,0
63442703,178,8,2739684,52385542,63442703,11057161,60703019,11057161,49645858,0,0
63532063,209,8,3267755,52385542,63532063,11146521,60264308,11146521,49117787,0,0
65161331,254,8,4229008,53871548,65161331,11289783,60932323,11289783,49642540,0,0
66159178,180,8,2763894,54299591,66159178,11859587,63395284,11859587,51535697,0,0
66174917,103,8,1794916,54299591,66174917,11875326,64380001,11875326,52504675,0,0
66321323,90,8,1548833,54299591,66321323,12021732,64772490,12021732,52750758,0,0
66841640,190,8,3009761,54299591,66841640,12542049,63831879,12542049,51289830,0,0
67444107,149,8,2399558,54896523,67444107,12547584,65044549,12547584,52496965,0,0
71719297,416,8,5523619,58813741,71719297,12905556,66195678,12905556,53290122,0,0
72966361,192,8,3009768,59710916,72966361,13255445,69956593,13255445,56701148,0,0
73095295,399,8,5203382,59710916,73095295,13384379,67891913,13384379,54507534,0,0
73494885,80,8,1488829,59710916,73494885,13783969,72006056,13783969,58222087,0,0
74071025,12,8,672911,672911,74071025,73398114,73398114,14707597,58690517,3,0
75765898,69,8,1448138,61313993,75765898,14451905,74317760,14451905,59865855,0,0
77678956,95,8,1548982,63018337,77678956,14660619,76129974,14660619,61469355,0,0
78241061,77,8,1463214,63293306,78241061,14947755,76777847,14947755,61830092,0,0
78533396,400,8,5203386,63442703,78533396,15090693,73330010,15090693,58239317,0,0
78687238,110,8,1971299,63532063,78687238,15155175,76715939,15155175,61560764,0,0
80492824,155,8,2567954,65161331,80492824,15331493,77924870,15331493,62593377,0,0
82435117,145,8,2352279,66159178,82435117,16275939,80082838,16275939,63806899,0,0
83732068,179,8,2739687,66174917,83732068,17557151,80992381,17557151,63435230,0,0
84983761,460,8,6396962,66321323,84983761,18662438,78586799,18662438,59924361,0,0
86329363,440,8,6025037,66841640,86329363,19487723,80304326,19487723,60816603,0,0
87539301,109,8,1971294,67444107,87539301,20095194,85568007,20095194,65472813,0,0
92411859,204,8,3188727,71719297,92411859,20692562,89223132,20692562,68530570,0,0
94304538,136,8,2191769,72966361,94304538,21338177,92112769,21338177,70774592,0,0
95040087,84,8,1533742,73095295,95040087,21944792,93506345,21944792,71561553,0,0
96439626,412,8,5500618,73494885,96439626,22944741,90939008,22944741,67994267,0,0
98419775,94,8,1548940,74071025,98419775,24348750,96870835,24348750,72522085,0,0
104254495,81,8,1491324,75765898,104254495,28488597,102763171,28488597,74274574,0,0
106640252,14,8,672959,672959,106640252,105967293,105967293,29278374,76688919,5,0
107801464,75,8,1463152,78241061,107801464,29560403,106338312,29560403,76777909,0,0
111456854,127,8,2136227,78533396,111456854,32923458,109320627,32923458,76397169,0,0
115316724,139,8,2235070,78687238,115316724,36629486,113081654,36629486,76452168,0,0
117910796,444,8,6025169,80492824,117910796,37417972,111885627,37417972,74467655,0,0
120650599,197,8,3009792,82435117,120650599,38215482,117640807,38215482,79425325,0,0
136027475,3,4,352712,352712,136027475,135674763,135674763,55459546,80215217,49,0
