time,job_id,num_gpu,submit_time,start_time,end_time,executed_time,JCT,duration,pending_time,preempt,promote
2621825,41,1,1945408,1945408,2621825,676417,676417,676417,0,0,0
2875091,58,1,2326954,2326954,2875091,548137,548137,548137,0,0,0
2895433,1,8,201694,201694,2895433,2693739,2693739,2693739,0,0,0
2932576,32,1,1943942,1943942,2932576,988634,988634,988634,0,0,0
3105119,55,8,2094682,2094682,3105119,1010437,1010437,1010437,0,0,0
3112940,24,1,1943873,1943873,3112940,1169067,1169067,1169067,0,0,0
3120200,57,1,2324998,2324998,3120200,795202,795202,795202,0,0,0
3141941,30,1,1943932,1943932,3141941,1198009,1198009,1198009,0,0,0
3184635,18,1,1943813,1943813,3184635,1240822,1240822,1240822,0,0,0
3219858,53,1,1945550,1945550,3219858,1274308,1274308,1274308,0,0,0
3278061,66,1,2348780,2348780,3278061,929281,929281,929281,0,0,0
3288611,86,1,2372731,2372731,3288611,915880,915880,915880,0,0,0
3368457,64,1,2341345,2341345,3368457,1027112,1027112,1027112,0,0,0
3575285,133,8,3572938,3573973,3575285,1312,2347,1312,1035,0,0
3584467,122,8,3390490,3575285,3584467,9182,193977,9182,184795,0,0
3623220,126,8,3407887,3584467,3623220,38753,215333,38753,176580,0,0
3630176,140,8,3586358,3623220,3630176,6956,43818,6956,36862,0,0
3678117,111,8,3236670,3630176,3678117,47941,441447,47941,393506,0,0
3695084,144,8,3668447,3672188,3695084,22896,26637,22896,3741,0,0
3741660,148,8,3672188,3678117,3741660,63543,69472,63543,5929,0,0
3759593,141,8,3587038,3695084,3759593,64509,172555,64509,108046,0,0
3802113,156,8,3775871,3775871,3802113,26242,26242,26242,0,0,0
3811774,147,8,3670526,3741660,3811774,70114,141248,70114,71134,0,0
3856319,165,8,3852752,3852752,3856319,3567,3567,3567,0,0,0
3875793,151,8,3771896,3802113,3875793,73680,103897,73680,30217,0,0
3880064,110,8,3235945,3759593,3880064,120471,644119,120471,523648,0,0
3922627,162,8,3831486,3855623,3922627,67004,91141,67004,24137,0,0
3935438,124,8,3391008,3811774,3935438,123664,544430,123664,420766,0,0
3958503,164,8,3845388,3856319,3958503,102184,113115,102184,10931,0,0
3963992,174,8,3922206,3922206,3963992,41786,41786,41786,0,0,0
3972741,170,4,3887819,3887819,3972741,84922,84922,84922,0,0,0
3998306,130,8,3514096,3856319,3998306,141987,484210,141987,342223,0,0
4002006,177,4,3960923,3960923,4002006,41083,41083,41083,0,0,0
4003709,171,8,3892069,3892069,4003709,111640,111640,111640,0,0,0
4040489,199,4,4038772,4038772,4040489,1717,1717,1717,0,0,0
4041111,188,8,3996027,3996027,4041111,45084,45084,45084,0,0,0
4053690,195,4,4022105,4022105,4053690,31585,31585,31585,0,0,0
4065311,193,8,4011623,4022127,4065311,43184,53688,43184,10504,0,0
4081868,142,8,3602731,3875793,4081868,206075,479137,206075,273062,0,0
4088581,116,8,3251613,3875793,4088581,212788,836968,212788,624180,0,0
4118449,181,8,3993309,3994883,4118449,123566,125140,123566,1574,0,0
4127639,202,4,4072703,4072703,4127639,54936,54936,54936,0,0,0
4135581,194,8,4017576,4022127,4135581,113454,118005,113454,4551,0,0
4137733,189,8,3996109,3996109,4137733,141624,141624,141624,0,0,0
4162410,112,8,3237153,3880064,4162410,282346,925257,282346,642911,0,0
4175405,117,8,3253439,3880064,4175405,295341,921966,295341,626625,0,0
4222656,191,8,4002150,4003709,4222656,218947,220506,218947,1559,0,0
4232596,223,1,4225248,4225248,4232596,7348,7348,7348,0,0,0
4241000,159,8,3817978,3910570,4241000,330430,423022,330430,92592,0,0
4248038,256,4,4245994,4246023,4248038,2015,2044,2015,29,0,0
4260156,259,4,4251434,4251434,4260156,8722,8722,8722,0,0,0
4262067,226,1,4225258,4225258,4262067,36809,36809,36809,0,0,0
4264380,257,4,4246023,4248038,4264380,16342,18357,16342,2015,0,0
4297201,125,8,3407881,3910611,4297201,386590,889320,386590,502730,0,0
4299989,224,1,4225252,4225252,4299989,74737,74737,74737,0,0,0
4306781,263,4,4302753,4305079,4306781,1702,4028,1702,2326,0,0
4316935,212,1,4099912,4099912,4316935,217023,217023,217023,0,0,0
4319048,266,4,4305079,4306781,4319048,12267,13969,12267,1702,0,0
4327923,251,1,4238583,4238583,4327923,89340,89340,89340,0,0,0
4343211,265,4,4304374,4319048,4343211,24163,38837,24163,14674,0,0
4347769,214,1,4100924,4100924,4347769,246845,246845,246845,0,0,0
4353617,225,1,4225255,4225255,4353617,128362,128362,128362,0,0,0
4357312,258,4,4251430,4251434,4357312,105878,105882,105878,4,0,0
4359771,192,8,4002172,4022127,4359771,337644,357599,337644,19955,0,0
4364577,269,4,4363768,4363768,4364577,809,809,809,0,0,0
4367025,260,4,4253391,4260156,4367025,106869,113634,106869,6765,0,0
4377686,106,8,3182305,3910611,4377686,467075,1195381,467075,728306,0,0
4388267,205,8,4098808,4118449,4388267,269818,289459,269818,19641,0,0
4408015,264,1,4302787,4302787,4408015,105228,105228,105228,0,0,0
4418025,268,4,4322941,4343211,4418025,74814,95084,74814,20270,0,0
4419504,105,8,3181760,3910611,4419504,508893,1237744,508893,728851,0,0
4425714,272,4,4394242,4418025,4425714,7689,31472,7689,23783,0,0
4451265,186,4,3994633,3994633,4451265,456632,456632,454915,1717,1,0
4469003,143,8,3664267,3922206,4469003,546797,804736,527813,276923,1,0
4486215,233,1,4238523,4238523,4486215,247692,247692,247692,0,0,0
4486226,238,1,4238539,4238539,4486226,247687,247687,247687,0,0,0
4486257,247,1,4238569,4238569,4486257,247688,247688,247688,0,0,0
4514225,215,8,4117439,4135581,4514225,378644,396786,378644,18142,0,0
4522751,275,8,4436304,4469003,4522751,53748,86447,53748,32699,0,0
4528525,286,4,4522984,4523905,4528525,4620,5541,4620,921,0,0
4531288,232,1,4238519,4238519,4531288,292769,292769,292769,0,0,0
4549375,235,1,4238529,4238529,4549375,310846,310846,310846,0,0,0
4549895,153,8,3773359,3922627,4549895,627268,776536,584084,192452,1,0
4552430,270,8,4388907,4419504,4552430,132926,163523,132926,30597,0,0
4556581,252,1,4238586,4238586,4556581,317995,317995,317995,0,0,0
4557394,283,4,4521634,4522751,4557394,34643,35760,34643,1117,0,0
4560737,228,1,4238506,4238506,4560737,322231,322231,322231,0,0,0
4589879,273,4,4414052,4425714,4589879,164165,175827,164165,11662,0,0
4599761,296,4,4531335,4549895,4599761,49866,68426,49866,18560,0,0
4611894,222,1,4225244,4225244,4611894,386650,386650,386650,0,0,0
4613534,301,4,4570131,4570131,4613534,43403,43403,43403,0,0,0
4617183,135,8,3575927,3935438,4617183,681745,1041256,619807,421449,2,0
4620668,280,4,4507993,4514225,4620668,106443,112675,106443,6232,0,0
4622753,267,4,4308027,4357312,4622753,265441,314726,265441,49285,0,0
4629545,287,4,4523016,4524134,4629545,105411,106529,105411,1118,0,0
4668255,198,4,4022238,4053690,4668255,614565,646017,598687,47330,5,0
4669248,285,4,4522932,4528525,4669248,140723,146316,140723,5593,0,0
4700748,200,4,4072661,4088581,4700748,612167,628087,584440,43647,8,0
4749764,304,8,4688734,4748606,4749764,1158,61030,1158,59872,0,0
4751430,315,4,4748327,4749764,4751430,1666,3103,1666,1437,0,0
4767816,310,4,4710506,4710506,4767816,57310,57310,57310,0,0,0
4794100,221,1,4225241,4225241,4794100,568859,568859,568859,0,0,0
4838266,289,4,4523905,4549895,4838266,288371,314361,288371,25990,0,0
4842566,305,4,4710424,4710486,4842566,132080,132142,132080,62,0,0
4899160,290,4,4524134,4552430,4899160,346730,375026,346730,28296,0,0
4902826,309,4,4710499,4721206,4902826,181620,192327,181620,10707,0,0
4911834,321,8,4856485,4899160,4911834,12674,55349,12674,42675,0,0
4917110,128,8,3513854,3958503,4917110,958607,1403256,816901,586355,1,0
5000420,313,8,4721206,4911834,5000420,88586,279214,88586,190628,0,0
5001731,118,8,3288962,3963992,5001731,1037739,1712769,870212,842557,1,0
5033369,328,8,4974958,5000420,5033369,32949,58411,32949,25462,0,0
5038503,314,8,4721246,4917110,5038503,121393,317257,121393,195864,0,0
5067937,299,4,4570061,4589879,5067937,478058,497876,478058,19818,0,0
5080229,341,1,5078427,5078427,5080229,1802,1802,1802,0,0,0
5081034,347,1,5078631,5078631,5081034,2403,2403,2403,0,0,0
5081855,343,1,5078491,5078491,5081855,3364,3364,3364,0,0,0
5106865,332,1,5060944,5060944,5106865,45921,45921,45921,0,0,0
5108805,346,1,5078599,5078599,5108805,30206,30206,30206,0,0,0
5116519,300,4,4570110,4599761,5116519,516758,546409,516758,29651,0,0
5127616,339,1,5078331,5078331,5127616,49285,49285,49285,0,0,0
5132484,274,8,4431116,4617183,5132484,515301,701368,515301,186067,0,0
5136361,288,4,4523114,4552430,5136361,583931,613247,583931,29316,0,0
5151185,329,8,4974991,5001731,5151185,149454,176194,149454,26740,0,0
5151552,354,1,5147893,5147893,5151552,3659,3659,3659,0,0,0
5151610,356,1,5147961,5147961,5151610,3649,3649,3649,0,0,0
5151763,353,1,5147866,5147866,5151763,3897,3897,3897,0,0,0
5160717,344,1,5078533,5078533,5160717,82184,82184,82184,0,0,0
5177224,307,4,4710486,4721246,5177224,455978,466738,455978,10760,0,0
5177305,302,8,4620804,4629545,5177305,547760,556501,547760,8741,0,0
5177902,363,1,5176427,5176427,5177902,1475,1475,1475,0,0,0
5221474,364,1,5176435,5176435,5221474,45039,45039,45039,0,0,0
5271313,137,8,3581378,4175405,5271313,1095908,1689935,1047710,642225,2,0
5297470,312,8,4721038,5033369,5297470,264101,576432,264101,312331,0,0
5308493,394,1,5306114,5306114,5308493,2379,2379,2379,0,0,0
5309685,361,1,5176420,5176420,5309685,133265,133265,133265,0,0,0
5311290,338,8,5078194,5078371,5311290,232919,233096,232919,177,0,0
5319183,389,1,5305167,5305167,5319183,14016,14016,14016,0,0,0
5320503,395,1,5306185,5306185,5320503,14318,14318,14318,0,0,0
5322400,367,8,5214587,5271313,5322400,51087,107813,51087,56726,0,0
5323908,342,1,5078461,5078461,5323908,245447,245447,245447,0,0,0
5334222,404,1,5331943,5331943,5334222,2279,2279,2279,0,0,0
5334880,384,4,5303127,5304384,5334880,30496,31753,30496,1257,0,0
5335767,291,8,4525610,4669248,5335767,666519,810157,666519,143638,0,0
5337769,382,4,5303075,5306185,5337769,31584,34694,31584,3110,0,0
5343826,359,1,5148078,5148078,5343826,195748,195748,195748,0,0,0
5353054,360,1,5172053,5172053,5353054,181001,181001,181001,0,0,0
5353429,386,1,5304384,5304384,5353429,49045,49045,49045,0,0,0
5365711,335,1,5066231,5066231,5365711,299480,299480,299480,0,0,0
5368166,398,1,5309936,5309936,5368166,58230,58230,58230,0,0,0
5377458,362,1,5176424,5176424,5377458,201034,201034,201034,0,0,0
5381656,385,4,5304303,5306224,5381656,75432,77353,75432,1921,0,0
5382654,397,1,5309886,5309886,5382654,72768,72768,72768,0,0,0
5384468,337,8,5078173,5132484,5384468,251984,306295,251984,54311,0,0
5388591,407,4,5365237,5377458,5388591,11133,23354,11133,12221,0,0
5392566,369,1,5219928,5219928,5392566,172638,172638,172638,0,0,0
5411777,320,4,4753084,4753084,5411777,658693,658693,658693,0,0,0
5413800,409,4,5367404,5381638,5413800,32162,46396,32162,14234,0,0
5432107,358,1,5148051,5148051,5432107,284056,284056,284056,0,0,0
5437101,406,4,5363283,5381656,5437101,55445,73818,55445,18373,0,0
5451942,255,4,4243885,4264380,5451942,1187562,1208057,1132870,75187,1,0
5458855,387,1,5304995,5304995,5458855,153860,153860,153860,0,0,0
5463279,388,1,5305025,5305025,5463279,158254,158254,158254,0,0,0
5466786,372,8,5281861,5297470,5466786,169316,184925,169316,15609,0,0
5467602,415,4,5381638,5384468,5467602,83134,85964,83134,2830,0,0
5469586,426,1,5448992,5448992,5469586,20594,20594,20594,0,0,0
5489275,345,1,5078566,5078566,5489275,410709,410709,410709,0,0,0
5501267,413,1,5379404,5379404,5501267,121863,121863,121863,0,0,0
5508123,295,4,4531328,4556581,5508123,951542,976795,951542,25253,0,0
5526254,38,1,1945158,1945158,5526254,3581096,3581096,3484068,97028,40,0
5530995,414,4,5381592,5384468,5530995,146527,149403,146527,2876,0,0
5550583,410,4,5367428,5388591,5550583,161992,183155,161992,21163,0,0
5556158,366,8,5214473,5311290,5556158,244868,341685,244868,96817,0,0
5564521,348,8,5078919,5151185,5564521,413336,485602,413336,72266,0,0
5566540,375,4,5284972,5306224,5566540,260316,281568,260316,21252,0,0
5568589,429,4,5539973,5550583,5568589,18006,28616,18006,10610,0,0
5628418,318,4,4748606,4749764,5628418,878654,879812,878654,1158,0,0
5638976,352,1,5137187,5137187,5638976,501789,501789,501789,0,0,0
5640462,401,8,5321027,5322400,5640462,318062,319435,318062,1373,0,0
5649739,432,8,5562718,5564521,5649739,85218,87021,85218,1803,0,0
5654480,433,4,5565210,5566540,5654480,87940,89270,87940,1330,0,0
5668970,340,1,5078371,5078371,5668970,590599,590599,590599,0,0,0
5681018,454,1,5661691,5661691,5681018,19327,19327,19327,0,0,0
5682894,443,8,5628790,5640462,5682894,42432,54104,42432,11672,0,0
5684537,445,4,5652948,5654480,5684537,30057,31589,30057,1532,0,0
5684769,403,1,5330994,5330994,5684769,353775,353775,353775,0,0,0
5685740,355,1,5147921,5147921,5685740,537819,537819,537819,0,0,0
5688266,408,4,5365278,5411777,5688266,276489,322988,276489,46499,0,0
5695845,322,8,4857727,5038503,5695845,657342,838118,657342,180776,0,0
5703797,451,8,5655938,5682894,5703797,20903,47859,20903,26956,0,0
5704637,421,4,5427880,5437101,5704637,267536,276757,267536,9221,0,0
5705128,434,8,5569193,5649739,5705128,55389,135935,55389,80546,0,0
5705149,435,4,5569206,5628418,5705149,76731,135943,76731,59212,0,0
5723258,243,1,4238556,4238569,5723258,1484689,1484702,1468645,16057,20,0
5724541,376,4,5284976,5334880,5724541,389661,439565,389661,49904,0,0
5730480,476,1,5729137,5729137,5730480,1343,1343,1343,0,0,0
5730973,477,1,5729215,5729215,5730973,1758,1758,1758,0,0,0
5735974,484,1,5735206,5735206,5735974,768,768,768,0,0,0
5738900,457,4,5690742,5690742,5738900,48158,48158,48158,0,0,0
5750628,475,1,5726501,5726501,5750628,24127,24127,24127,0,0,0
5756629,470,4,5709256,5724541,5756629,32088,47373,32088,15285,0,0
5757142,479,1,5729899,5729899,5757142,27243,27243,27243,0,0,0
5762795,459,1,5699161,5699161,5762795,63634,63634,63634,0,0,0
5787439,474,1,5718484,5718484,5787439,68955,68955,68955,0,0,0
5787448,478,1,5729250,5729250,5787448,58198,58198,58198,0,0,0
5788639,102,8,3173969,4222656,5788639,1565983,2614670,1424202,1190468,1,0
5790155,402,8,5321274,5335767,5790155,454388,468881,454388,14493,0,0
5793378,399,1,5309965,5309965,5793378,483413,483413,483413,0,0,0
5798404,480,4,5735148,5735206,5798404,63198,63256,63198,58,0,0
5807111,467,1,5704346,5704346,5807111,102765,102765,102765,0,0,0
5836602,504,4,5820527,5820527,5836602,16075,16075,16075,0,0,0
5842258,490,4,5789711,5790155,5842258,52103,52547,52103,444,0,0
5844211,114,8,3245414,4377686,5844211,1466525,2598797,1466525,1132272,0,0
5845743,505,8,5826341,5844211,5845743,1532,19402,1532,17870,0,0
5850512,396,1,5306224,5306224,5850512,544288,544288,544288,0,0,0
5867785,513,1,5865216,5865216,5867785,2569,2569,2569,0,0,0
5872600,507,1,5832079,5832079,5872600,40521,40521,40521,0,0,0
5878368,520,1,5872774,5872774,5878368,5594,5594,5594,0,0,0
5886544,515,4,5865263,5865263,5886544,21281,21281,21281,0,0,0
5886651,486,8,5758806,5788639,5886651,98012,127845,98012,29833,0,0
5887441,423,4,5427893,5451942,5887441,435499,459548,435499,24049,0,0
5887755,493,4,5799377,5799681,5887755,88074,88378,88074,304,0,0
5894685,514,4,5865253,5865253,5894685,29432,29432,29432,0,0,0
5895625,472,4,5709293,5738900,5895625,156725,186332,156725,29607,0,0
5899753,523,4,5875152,5877516,5899753,22237,24601,22237,2364,0,0
5910789,530,4,5904197,5906942,5910789,3847,6592,3847,2745,0,0
5911991,500,4,5809095,5818950,5911991,93041,102896,93041,9855,0,0
5913940,444,8,5628842,5695845,5913940,218095,285098,218095,67003,0,0
5918104,516,4,5868672,5871041,5918104,47063,49432,47063,2369,0,0
5949388,532,8,5906977,5906977,5949388,42411,42411,42411,0,0,0
5957916,303,4,4680987,4700748,5957916,1257168,1276929,1193422,83507,2,0
5958517,424,4,5428226,5466786,5958517,491731,530291,491731,38560,0,0
5960168,529,4,5904192,5907010,5960168,53158,55976,53158,2818,0,0
5961241,512,1,5865204,5865204,5961241,96037,96037,96037,0,0,0
5978483,531,8,5906942,5913940,5978483,64543,71541,64543,6998,0,0
5983810,551,1,5971016,5971016,5983810,12794,12794,12794,0,0,0
5992250,487,4,5778243,5787439,5992250,204811,214007,204811,9196,0,0
6003384,496,4,5799681,5826341,6003384,177043,203703,177043,26660,0,0
6011320,552,1,5975373,5975373,6011320,35947,35947,35947,0,0,0
6015302,556,1,5983209,5983209,6015302,32093,32093,32093,0,0,0
6017260,416,4,5390064,5466786,6017260,550474,627196,550474,76722,0,0
6026565,495,4,5799426,5836602,6026565,189963,227139,189963,37176,0,0
6050455,419,4,5399324,5467602,6050455,582853,651131,582853,68278,0,0
6053443,468,1,5704825,5704825,6053443,348618,348618,348618,0,0,0
6063690,511,1,5846215,5846215,6063690,217475,217475,217475,0,0,0
6069435,456,4,5690721,5703797,6069435,365638,378714,365638,13076,0,0
6081057,569,1,6057618,6057618,6081057,23439,23439,23439,0,0,0
6082230,541,1,5920902,5920902,6082230,161328,161328,161328,0,0,0
6084793,544,1,5966578,5966578,6084793,118215,118215,118215,0,0,0
6084825,560,4,6045036,6050455,6084825,34370,39789,34370,5419,0,0
6085213,565,1,6050552,6050552,6085213,34661,34661,34661,0,0,0
6097683,553,1,5983198,5983198,6097683,114485,114485,114485,0,0,0
6108558,336,8,5077256,5177305,6108558,931253,1031302,681319,349983,1,0
6113266,380,4,5284995,5508123,6113266,605143,828271,605143,223128,0,0
6121607,568,1,6050566,6050566,6121607,71041,71041,71041,0,0,0
6129038,357,1,5148023,5148023,6129038,981015,981015,981015,0,36,0
6130678,525,4,5879609,5886544,6130678,244134,251069,244134,6935,0,0
6144863,464,4,5702763,5703797,6144863,441066,442100,441066,1034,0,0
6160603,567,1,6050559,6050559,6160603,110044,110044,110044,0,0,0
6167523,561,1,6050364,6050364,6167523,117159,117159,117159,0,0,0
6173938,483,4,5735159,5756629,6173938,417309,438779,417309,21470,0,0
6194062,528,4,5904060,5910789,6194062,283273,290002,283273,6729,0,0
6194793,542,1,5930372,5930372,6194793,264421,264421,264421,0,0,0
6197456,550,1,5971012,5971012,6197456,226444,226444,226444,0,0,0
6199462,465,4,5703486,5704637,6199462,494825,495976,494825,1151,0,0
6206932,438,8,5577140,5705128,6206932,501804,629792,501804,127988,0,0
6209648,524,4,5877516,5886651,6209648,322997,332132,322997,9135,0,0
6239465,446,4,5652958,5684537,6239465,554928,586507,554928,31579,0,0
6246271,535,4,5918849,5949388,6246271,296883,327422,296883,30539,0,0
6257532,549,1,5970067,5970067,6257532,287465,287465,287465,0,0,0
6269299,577,4,6243133,6243133,6269299,26166,26166,26166,0,0,0
6272657,557,1,6011425,6011425,6272657,261232,261232,261232,0,0,0
6295940,583,1,6294558,6294558,6295940,1382,1382,1382,0,0,0
6296534,510,1,5844749,5844749,6296534,451785,451785,451785,0,0,0
6323308,584,1,6297078,6297078,6323308,26230,26230,26230,0,0,0
6323600,587,1,6297090,6297090,6323600,26510,26510,26510,0,0,0
6330739,592,1,6302344,6302344,6330739,28395,28395,28395,0,0,0
6330918,412,1,5379332,5379332,6330918,951586,951586,951586,0,21,0
6342315,582,4,6247207,6247207,6342315,95108,95108,95108,0,0,0
6346280,497,4,5800140,5842258,6346280,504022,546140,504022,42118,0,0
6350249,597,1,6307819,6307819,6350249,42430,42430,42430,0,0,0
6365367,425,4,5428233,5526254,6365367,839113,937134,829978,107156,1,0
6369475,579,4,6246704,6269299,6369475,100176,122771,100176,22595,0,0
6420670,581,4,6247024,6302336,6420670,118334,173646,118334,55312,0,0
6443031,575,8,6135933,6206932,6443031,236099,307098,236099,70999,0,0
6465789,519,4,5871041,5887441,6465789,578348,594748,578348,16400,0,0
6491584,636,1,6489790,6489790,6491584,1794,1794,1794,0,0,0
6496613,411,4,5367449,5530995,6496613,965618,1129164,943923,185241,2,0
6496678,570,1,6058023,6058023,6496678,438655,438655,438655,0,0,0
6529953,578,4,6246689,6246689,6529953,283264,283264,283264,0,0,0
6532707,566,1,6050556,6050556,6532707,482151,482151,482151,0,0,0
6536994,665,1,6534521,6534521,6536994,2473,2473,2473,0,0,0
6538731,644,1,6495804,6495804,6538731,42927,42927,42927,0,0,0
6539987,522,4,5875152,5894685,6539987,645302,664835,615159,49676,2,0
6543323,656,4,6510635,6510635,6543323,32688,32688,32688,0,0,0
6543592,640,1,6495588,6495588,6543592,48004,48004,48004,0,0,0
6546223,591,1,6302340,6302340,6546223,243883,243883,243883,0,0,0
6563504,586,1,6297086,6297086,6563504,266418,266418,266418,0,0,0
6572569,649,4,6509153,6509186,6572569,63383,63416,63383,33,0,0
6577963,509,1,5840101,5840101,6577963,737862,737862,735293,2569,41,0
6581045,622,1,6482589,6482589,6581045,98456,98456,98456,0,0,0
6582273,620,1,6482580,6482580,6582273,99693,99693,99693,0,0,0
6585497,639,1,6495516,6495516,6585497,89981,89981,89981,0,0,0
6590337,502,8,5818950,5845743,6590337,744594,771387,649679,121708,1,0
6593975,660,4,6510883,6529953,6593975,64022,83092,64022,19070,0,0
6609286,521,1,5873137,5878368,6609286,730918,736149,721448,14701,26,0
6626926,669,4,6588893,6590337,6626926,36589,38033,36589,1444,0,0
6629232,603,1,6435044,6435044,6629232,194188,194188,194188,0,0,0
6633403,590,1,6302336,6302336,6633403,331067,331067,331067,0,0,0
6636794,534,8,5910762,5978483,6636794,658311,726032,658311,67721,0,0
6645306,675,4,6597402,6626926,6645306,18380,47904,18380,29524,0,0
6647007,645,1,6495809,6495809,6647007,151198,151198,151198,0,0,0
6651498,613,1,6477896,6477896,6651498,173602,173602,173602,0,0,0
6652483,506,1,5831497,5831497,6652483,820986,820986,758279,62707,24,0
6654514,428,4,5475741,5568589,6654514,1085925,1178773,944478,234295,5,0
6656493,617,1,6477916,6477916,6656493,178577,178577,178577,0,0,0
6658309,650,4,6509168,6509211,6658309,149098,149141,149098,43,0,0
6668454,671,4,6596579,6636794,6668454,31660,71875,31660,40215,0,0
6675465,672,4,6596586,6636794,6675465,38671,78879,38671,40208,0,0
6686995,638,1,6495511,6495511,6686995,191484,191484,191484,0,0,0
6732656,637,1,6489880,6489880,6732656,242776,242776,242776,0,0,0
6761472,676,4,6605282,6645306,6761472,116166,156190,116166,40024,0,0
6773349,621,1,6482584,6482584,6773349,290765,290765,290765,0,0,0
6796841,427,1,5449015,5449015,6796841,1347826,1347826,1248257,99569,49,0
6813281,635,1,6489786,6489786,6813281,323495,323495,323495,0,0,0
6836853,482,4,5735156,5787448,6836853,1049405,1101697,854323,247374,2,0
6847767,576,1,6177711,6177711,6847767,670056,670056,670056,0,0,0
6901753,489,4,5784307,5790155,6901753,1111598,1117446,885114,232332,2,0
6966537,652,4,6509211,6509211,6966537,457326,457326,457326,0,0,0
6981004,674,4,6597372,6652483,6981004,328521,383632,328521,55111,0,0
6991277,237,1,4238536,4238569,6991277,2752708,2752741,2538184,214557,370,0
7006332,588,1,6297659,6297659,7006332,708673,708673,708673,0,0,0
7023797,627,1,6482616,6482616,7023797,541181,541181,541181,0,0,0
7027881,651,4,6509186,6509211,7027881,518670,518695,518670,25,0,0
7039289,499,8,5808930,6108558,7039289,930731,1230359,930731,299628,0,0
7053860,598,1,6307824,6307824,7053860,746036,746036,746036,0,0,0
7058718,680,4,6636543,6654514,7058718,404204,422175,404204,17971,0,0
7060422,589,1,6302332,6302332,7060422,758090,758090,758090,0,0,0
7064512,466,4,5703986,5705149,7064512,1359363,1360526,1011021,349505,2,0
7106067,653,4,6509232,6539987,7106067,566080,596835,566080,30755,0,0
7113718,658,4,6510870,6543323,7113718,570395,602848,570395,32453,0,0
7147202,377,4,5284981,5685740,7147202,1461462,1862221,1077411,784810,1,0
7199045,585,1,6297083,6297083,7199045,901962,901962,901962,0,0,0
7203324,614,1,6477901,6477901,7203324,725423,725423,725423,0,0,0
7206011,679,4,6636534,6658309,7206011,547702,569477,547702,21775,0,0
7209870,615,1,6477905,6477905,7209870,731965,731965,731965,0,0,0
7214602,629,1,6483616,6483616,7214602,730986,730986,730986,0,0,0
7228502,463,4,5702741,6130678,7228502,1097824,1525761,1097824,427937,0,0
7236292,697,4,7221212,7221212,7236292,15080,15080,15080,0,0,0
7263853,711,4,7244608,7244616,7263853,19237,19245,19237,8,0,0
7267469,540,8,5920134,6209648,7267469,1057821,1347335,1057821,289514,0,0
7269955,670,8,6590711,7027881,7269955,242074,679244,242074,437170,0,0
7285363,713,4,7247378,7263853,7285363,21510,37985,21510,16475,0,0
7286792,716,4,7278253,7285363,7286792,1429,8539,1429,7110,0,0
7289297,715,4,7256318,7267469,7289297,21828,32979,21828,11151,0,0
7297186,196,4,4022127,4225244,7297186,3071942,3275059,1931525,1343534,19,0
7312186,548,1,5968127,6003384,7312186,1308802,1344059,1308792,35267,31,0
7314517,708,1,7229878,7229878,7314517,84639,84639,84639,0,0,0
7319837,702,1,7229858,7229858,7319837,89979,89979,89979,0,0,0
7320220,703,1,7229861,7229861,7320220,90359,90359,90359,0,0,0
7358067,373,1,5284155,5284155,7358067,2073912,2073912,1888884,185028,241,0
7365398,422,4,5427889,6173938,7365398,1191460,1937509,1156969,780540,1,0
7366465,724,4,7363367,7363367,7366465,3098,3098,3098,0,0,0
7367863,725,4,7363664,7365398,7367863,2465,4199,2465,1734,0,0
7372316,717,4,7282240,7286792,7372316,85524,90076,85524,4552,0,0
7387573,719,4,7359724,7365942,7387573,21631,27849,21631,6218,0,0
7395243,721,4,7361616,7365955,7395243,29288,33627,29288,4339,0,0
7408483,726,4,7365656,7366465,7408483,42018,42827,42018,809,0,0
7415249,729,4,7369089,7372316,7415249,42933,46160,42933,3227,0,0
7430232,685,8,6996605,7039289,7430232,390943,433627,390943,42684,0,0
7438704,722,4,7361741,7367863,7438704,70841,76963,70841,6122,0,0
7447933,695,8,7217520,7236292,7447933,211641,230413,211641,18772,0,0
7452093,641,1,6495592,6495592,7452093,956501,956501,956501,0,6,0
7455776,630,1,6483622,6483622,7455776,972154,972154,972154,0,11,0
7464197,723,4,7363337,7387573,7464197,76624,100860,76624,24236,0,0
7478476,730,4,7369337,7395243,7478476,83233,109139,83233,25906,0,0
7508929,720,4,7359778,7408483,7508929,100446,149151,100446,48705,0,0
7545775,417,4,5399276,6194062,7545775,1351713,2146499,1245835,900664,2,0
7548992,692,8,7186665,7269955,7548992,279037,362327,279037,83290,0,0
7614680,700,4,7223190,7223190,7614680,391490,391490,391490,0,0,0
7631053,738,1,7619099,7619099,7631053,11954,11954,11954,0,0,0
7651617,741,8,7651115,7651115,7651617,502,502,502,0,0,0
7655979,378,4,5284986,6197456,7655979,1458523,2370993,1259237,1111756,2,0
7658478,740,8,7651017,7651617,7658478,6861,7461,6861,600,0,0
7660618,595,1,6307812,6307824,7660618,1352794,1352806,1345826,6980,42,0
7674207,727,4,7365942,7415249,7674207,258958,308265,258958,49307,0,0
7682973,736,1,7556319,7556319,7682973,126654,126654,126654,0,0,0
7686990,739,8,7651010,7658478,7686990,28512,35980,28512,7468,0,0
7709742,712,4,7244616,7267469,7709742,442273,465126,442273,22853,0,0
7752322,698,4,7221218,7228502,7752322,523820,531104,523820,7284,0,0
7760809,648,4,6509134,6593975,7760809,1166834,1251675,1166834,84841,0,0
7795995,746,8,7788414,7788414,7795995,7581,7581,7581,0,0,0
7798253,749,8,7794273,7795995,7798253,2258,3980,2258,1722,0,0
7815205,742,8,7651118,7670655,7815205,144550,164087,144550,19537,0,0
7840641,699,4,7223150,7229861,7840641,610780,617491,610780,6711,0,0
7843529,231,1,4238516,4238516,7843529,3605013,3605013,3229829,375184,506,0
7878804,753,1,7869565,7869565,7878804,9239,9239,9239,0,0,0
7883031,752,8,7819776,7840641,7883031,42390,63255,42390,20865,0,0
7883380,580,4,6246733,6369475,7883380,1513905,1636647,1333761,302886,9,0
7893075,743,8,7670655,7674207,7893075,218868,222420,218868,3552,0,0
7911781,744,8,7670658,7686990,7911781,224791,241123,224791,16332,0,0
7924876,661,4,6510890,6675465,7924876,1249411,1413986,1249411,164575,0,0
7938068,755,8,7911435,7911781,7938068,26287,26633,26287,346,0,0
7939448,756,8,7912457,7938068,7939448,1380,26991,1380,25611,0,0
7955543,701,1,7229854,7229854,7955543,725689,725689,725689,0,0,0
7984390,681,4,6707833,6761472,7984390,1222918,1276557,1222918,53639,0,0
7984445,731,4,7370217,7430232,7984445,554213,614228,554213,60015,0,0
7998649,757,8,7914914,7939448,7998649,59201,83735,59201,24534,0,0
8003066,747,8,7789076,7798253,8003066,204813,213990,204813,9177,0,0
8005065,761,8,7989607,7998649,8005065,6416,15458,6416,9042,0,0
8016418,759,8,7967407,7984445,8016418,31973,49011,31973,17038,0,0
8073081,673,4,6596601,6813281,8073081,1259800,1476480,1259800,216680,0,0
8102356,748,8,7792122,7815205,8102356,287151,310234,287151,23083,0,0
8114192,771,8,8083275,8083275,8114192,30917,30917,30917,0,0,0
8136563,659,4,6510876,6836853,8136563,1299710,1625687,1299710,325977,0,0
8151255,623,1,6482594,6482594,8151255,1668661,1668661,1625199,43462,58,0
8160522,775,8,8123816,8136563,8160522,23959,36706,23959,12747,0,0
8165371,777,8,8143698,8160522,8165371,4849,21673,4849,16824,0,0
8172426,782,8,8152202,8165371,8172426,7055,20224,7055,13169,0,0
8180179,751,8,7819773,7883031,8180179,297148,360406,297148,63258,0,0
8185769,781,8,8151887,8172426,8185769,13343,33882,13343,20539,0,0
8199536,783,8,8167016,8180179,8199536,19357,32520,19357,13163,0,0
8208622,420,4,5399341,6199462,8208622,2009160,2809281,1378372,1430909,12,0
8234476,750,8,7794276,7893075,8234476,341401,440200,341401,98799,0,0
8244722,779,8,8148661,8185769,8244722,58953,96061,58953,37108,0,0
8246932,768,8,8055044,8084946,8246932,161986,191888,161986,29902,0,0
8249769,787,8,8242117,8244722,8249769,5047,7652,5047,2605,0,0
8252496,766,8,8051903,8051903,8252496,200593,200593,200593,0,0,0
8261876,780,8,8151835,8199536,8261876,62340,110041,62340,47701,0,0
8268143,788,8,8242131,8246932,8268143,21211,26012,21211,4801,0,0
8280369,647,1,6505672,6505672,8280369,1774697,1774697,1740291,34406,51,0
8338242,607,1,6435097,6435097,8338242,1903145,1903145,1847497,55648,71,0
8343558,786,8,8242114,8249769,8343558,93789,101444,93789,7655,0,0
8344714,765,8,8051849,8102356,8344714,242358,292865,242358,50507,0,0
8400522,430,4,5547539,6465789,8400522,1934733,2852983,1446097,1406886,6,0
8404933,47,1,1945499,1945499,8404933,6459434,6459434,5807674,651760,498,0
8415310,773,8,8084950,8114192,8415310,301118,330360,301118,29242,0,0
8430896,655,4,6509275,6981004,8430896,1449892,1921621,1449892,471729,0,0
8441716,709,1,7233791,7233791,8441716,1207925,1207925,1207925,0,0,0
8456445,449,8,5655926,6443031,8456445,2013414,2800519,1074692,1725827,1,0
8462630,633,1,6486730,6577963,8462630,1884667,1975900,1884667,91233,52,0
8478750,790,8,8398984,8400522,8478750,78228,79766,78228,1538,0,0
8508603,503,4,5820504,7023797,8508603,1484806,2688099,1453969,1234130,1,0
8509256,793,8,8434461,8441716,8509256,67540,74795,67540,7255,0,0
8517765,600,1,6314498,6323600,8517765,2194165,2203267,2091025,112242,86,0
8540467,643,1,6495756,6582273,8540467,1958194,2044711,1958194,86517,74,0
8598912,593,1,6307598,6330739,8598912,2268173,2291314,2160572,130742,122,0
8619264,728,4,7365955,7430232,8619264,1189032,1253309,1189032,64277,0,0
8620123,798,8,8493846,8493846,8620123,126277,126277,126277,0,0,0
8631271,760,8,7989604,8003066,8631271,628205,641667,628205,13462,0,0
8633074,437,8,5576137,6477901,8633074,2155173,3056937,1136030,1920907,1,0
8650204,794,16,8462235,8619264,8650204,30940,187969,30940,157029,0,0
8653755,494,4,5799387,7064512,8653755,1589243,2854368,1471813,1382555,3,0
8669941,792,8,8434457,8456445,8669941,213496,235484,213496,21988,0,0
8682517,808,8,8680077,8680077,8682517,2440,2440,2440,0,0,0
8688221,365,8,5214469,7548992,8688221,1139229,3473752,1139229,2334523,0,0
8690215,810,8,8689418,8689418,8690215,797,797,797,0,0,0
8694991,812,8,8690431,8690456,8694991,4535,4560,4535,25,0,0
8710279,562,1,6050367,6084793,8710279,2625486,2659912,2422715,237197,183,0
8716620,772,8,8084946,8234476,8716620,482144,631674,482144,149530,0,0
8788879,814,8,8690456,8690456,8788879,98423,98423,98423,0,0,0
8789251,770,8,8083271,8252496,8789251,536755,705980,536755,169225,0,0
8793087,22,1,1943851,1943851,8793087,6849236,6849236,5854815,994421,534,0
8796802,791,8,8398988,8415310,8796802,381492,397814,381492,16322,0,0
8819631,774,16,8095109,8631271,8819631,188360,724522,188360,536162,0,0
8827101,809,1,8689233,8689233,8827101,137868,137868,137868,0,0,0
8864951,778,8,8143701,8261876,8864951,603075,721250,603075,118175,0,0
8879059,776,8,8125796,8268143,8879059,610916,753263,610916,142347,0,0
8893867,381,4,5288603,7106067,8893867,1787800,3605264,1475743,2129521,27,0
8920184,811,8,8690423,8690423,8920184,229761,229761,229761,0,0,0
8935611,816,8,8931250,8931256,8935611,4355,4361,4355,6,0,0
8939131,815,8,8844933,8864951,8939131,74180,94198,74180,20018,0,0
8970199,819,1,8959230,8959230,8970199,10969,10969,10969,0,0,0
9012043,820,1,8964394,8964394,9012043,47649,47649,47649,0,0,0
9025135,826,8,9023473,9023473,9025135,1662,1662,1662,0,0,0
9031428,827,8,9023477,9023477,9031428,7951,7951,7951,0,0,0
9054431,821,32,8967286,9031428,9054431,23003,87145,23003,64142,0,0
9066152,818,1,8958896,8958896,9066152,107256,107256,107256,0,0,0
9072092,799,8,8493852,8508603,9072092,563489,578240,563489,14751,0,0
9104930,796,16,8463334,8633074,9104930,471856,641596,471856,169740,0,0
9123127,732,16,7407929,8650204,9123127,472923,1715198,472923,1242275,0,0
9131683,830,1,9089233,9089233,9131683,42450,42450,42450,0,0,0
9146339,837,8,9142149,9142856,9146339,3483,4190,3483,707,0,0
9198190,374,1,5284184,5284184,9198190,3914006,3914006,3088829,825177,352,0
9209863,838,8,9142856,9146339,9209863,63524,67007,63524,3483,0,0
9221355,822,32,8967975,9054431,9221355,166924,253380,166924,86456,0,0
9250326,784,8,8167020,8343558,9250326,906768,1083306,880722,202584,5,0
9259992,797,16,8463342,8688221,9259992,571771,796650,472976,323674,1,0
9265667,834,8,9131722,9131726,9265667,133941,133945,133941,4,0,0
9267429,831,8,9128320,9128320,9267429,139109,139109,139109,0,0,0
9285036,825,1,8999938,8999938,9285036,285098,285098,285098,0,0,0
9300856,832,8,9128323,9128323,9300856,172533,172533,172533,0,0,0
9307647,835,8,9131726,9131726,9307647,175921,175921,175921,0,0,0
9309025,813,8,8690449,8716620,9309025,592405,618576,592405,26171,0,0
9327141,861,1,9320231,9320231,9327141,6910,6910,6910,0,0,0
9327297,856,1,9318625,9318625,9327297,8672,8672,8672,0,0,0
9344802,860,1,9320228,9320228,9344802,24574,24574,24574,0,0,0
9380454,875,8,9353239,9371269,9380454,9185,27215,9185,18030,0,0
9380568,605,1,6435087,6647007,9380568,2733561,2945481,2678003,267478,237,0
9389397,850,1,9318601,9318601,9389397,70796,70796,70796,0,0,0
9395913,880,1,9391141,9391141,9395913,4772,4772,4772,0,0,0
9397177,851,1,9318604,9318604,9397177,78573,78573,78573,0,0,0
9397202,854,1,9318613,9318613,9397202,78589,78589,78589,0,0,0
9397211,855,1,9318617,9318617,9397211,78594,78594,78594,0,0,0
9401679,847,1,9318591,9318591,9401679,83088,83088,83088,0,0,0
9410170,733,16,7409520,8819631,9410170,590539,2000650,590539,1410111,0,0
9413419,878,1,9388849,9388849,9413419,24570,24570,24570,0,0,0
9457927,859,1,9320225,9320225,9457927,137702,137702,137702,0,0,0
9472306,883,1,9393712,9393712,9472306,78594,78594,78594,0,0,0
9498275,852,1,9318607,9318607,9498275,179668,179668,179668,0,0,0
9503587,845,1,9318584,9318584,9503587,185003,185003,185003,0,0,0
9505236,858,1,9320221,9320221,9505236,185015,185015,185015,0,0,0
9519479,657,4,6510828,7113718,9519479,2405761,3008651,1481587,1527064,35,0
9525570,884,1,9407056,9407056,9525570,118514,118514,118514,0,0,0
9529132,881,1,9391363,9391363,9529132,137769,137769,137769,0,0,0
9563229,848,1,9318594,9318594,9563229,244635,244635,244635,0,0,0
9563249,849,1,9318597,9318597,9563249,244652,244652,244652,0,0,0
9564753,863,1,9320237,9320237,9564753,244516,244516,244516,0,0,0
9565424,887,1,9560361,9560361,9565424,5063,5063,5063,0,0,0
9565925,928,1,9562316,9562316,9565925,3609,3609,3609,0,0,0
9566045,927,1,9562310,9562310,9566045,3735,3735,3735,0,0,0
9568656,846,1,9318587,9318587,9568656,250069,250069,250069,0,0,0
9568790,909,1,9561036,9561036,9568790,7754,7754,7754,0,0,0
9568853,857,1,9318628,9318628,9568853,250225,250225,250225,0,0,0
9568900,931,1,9562340,9562340,9568900,6560,6560,6560,0,0,0
9570345,894,1,9560938,9560938,9570345,9407,9407,9407,0,0,0
9570617,912,1,9562206,9562206,9570617,8411,8411,8411,0,0,0
9571869,916,1,9562229,9562229,9571869,9640,9640,9640,0,0,0
9575778,879,1,9390865,9390865,9575778,184913,184913,184913,0,0,0
9585383,918,1,9562241,9562241,9585383,23142,23142,23142,0,0,0
9588309,917,1,9562235,9562235,9588309,26074,26074,26074,0,0,0
9591712,893,1,9560933,9560933,9591712,30779,30779,30779,0,0,0
9592189,891,1,9560917,9560917,9592189,31272,31272,31272,0,0,0
9602066,905,1,9561013,9561013,9602066,41053,41053,41053,0,0,0
9615819,876,1,9371269,9371269,9615819,244550,244550,244550,0,0,0
9629654,903,1,9560997,9560997,9629654,68657,68657,68657,0,0,0
9629878,920,1,9562253,9562253,9629878,67625,67625,67625,0,0,0
9636482,868,8,9352340,9353218,9636482,283264,284142,283264,878,0,0
9640631,911,1,9562201,9562201,9640631,78430,78430,78430,0,0,0
9650609,817,8,8931256,8935611,9650609,714998,719353,607327,112026,4,0
9661088,890,1,9560906,9560906,9661088,100182,100182,100182,0,0,0
9662722,914,1,9562217,9562217,9662722,100505,100505,100505,0,0,0
9680519,921,1,9562260,9562260,9680519,118259,118259,118259,0,0,0
9681714,913,1,9562212,9562212,9681714,119502,119502,119502,0,0,0
9690493,925,1,9562292,9562292,9690493,128201,128201,128201,0,0,0
9698133,896,1,9560955,9560955,9698133,137178,137178,137178,0,0,0
9705475,897,1,9560962,9560962,9705475,144513,144513,144513,0,0,0
9714326,926,1,9562304,9562304,9714326,152022,152022,152022,0,0,0
9735554,898,1,9560967,9560967,9735554,174587,174587,174587,0,0,0
9740193,922,1,9562271,9562271,9740193,177922,177922,177922,0,0,0
9752939,899,1,9560974,9560974,9752939,191965,191965,191965,0,0,0
9762443,842,1,9317096,9317096,9762443,445347,445347,445347,0,0,0
9772706,924,1,9562284,9562284,9772706,210422,210422,210422,0,0,0
9781519,895,1,9560944,9560944,9781519,220575,220575,220575,0,0,0
9782870,823,16,8968659,9025135,9782870,757735,814211,594604,219607,2,0
9786796,943,8,9780306,9782870,9786796,3926,6490,3926,2564,0,0
9795539,941,8,9778827,9778827,9795539,16712,16712,16712,0,0,0
9797695,871,8,9352949,9371269,9797695,426426,444746,426426,18320,0,0
9817493,919,1,9562246,9562246,9817493,255247,255247,255247,0,0,0
9819283,910,1,9561041,9561041,9819283,258242,258242,258242,0,0,0
9834981,874,8,9353218,9380454,9834981,454527,481763,454527,27236,0,0
9837147,944,8,9812781,9834981,9837147,2166,24366,2166,22200,0,0
9853886,915,1,9562223,9562223,9853886,291663,291663,291663,0,0,0
9884154,902,1,9560991,9560991,9884154,323163,323163,323163,0,0,0
9892274,950,8,9879334,9884154,9892274,8120,12940,8120,4820,0,0
9920785,945,8,9812818,9837147,9920785,83638,107967,83638,24329,0,0
9927422,954,8,9904351,9920785,9927422,6637,23071,6637,16434,0,0
9950099,948,8,9867954,9892274,9950099,57825,82145,57825,24320,0,0
9952321,864,1,9320241,9320241,9952321,632080,632080,632080,0,0,0
9983979,942,8,9780149,9782870,9983979,201109,203830,201109,2721,0,0
9986294,929,1,9562322,9562322,9986294,423972,423972,423972,0,0,0
9992932,904,1,9561002,9561002,9992932,431930,431930,431930,0,0,0
9994856,951,8,9886114,9927422,9994856,67434,108742,67434,41308,0,0
10003336,906,1,9561018,9561018,10003336,442318,442318,442318,0,0,0
10012788,936,8,9649809,9650609,10012788,362179,362979,362179,800,0,0
10063372,800,16,8505702,9123127,10063372,940245,1557670,847210,710460,1,0
10063523,932,8,9618714,9636482,10063523,427041,444809,427041,17768,0,0
10064188,956,8,10048690,10063372,10064188,816,15498,816,14682,0,0
10070767,957,8,10050687,10063372,10070767,7395,20080,7395,12685,0,0
10096127,882,1,9392244,9392244,10096127,703883,703883,703883,0,0,0
10099898,947,8,9867948,9950099,10099898,149799,231950,149799,82151,0,0
10123490,940,8,9723284,9786796,10123490,336694,400206,336694,63512,0,0
10136500,246,1,4238566,4408015,10136500,5728485,5897934,4248549,1649385,502,0
10146831,104,8,3180113,4388267,10146831,5758564,6966718,1555334,5411384,9,0
10185985,949,8,9879329,9983979,10185985,202006,306656,202006,104650,0,0
10222998,938,8,9718865,9795539,10222998,427459,504133,427459,76674,0,0
10262712,455,4,5690674,7147202,10262712,3115510,4572038,1485581,3086457,49,0
10268029,862,1,9320234,9320234,10268029,947795,947795,947795,0,8,0
10275981,958,8,10064333,10070767,10275981,205214,211648,205214,6434,0,0
10307728,935,16,9647037,10288886,10307728,18842,660691,18842,641849,0,0
10314852,961,1,10287315,10287315,10314852,27537,27537,27537,0,0,0
10320123,908,1,9561030,9561030,10320123,759093,759093,759093,0,8,0
10321301,959,8,10216368,10216368,10321301,104933,104933,104933,0,0,0
10341803,885,16,9484002,10307728,10341803,34075,857801,34075,823726,0,0
10351206,844,1,9318580,9318580,10351206,1032626,1032626,1032596,30,19,0
10356241,962,2,10288864,10288864,10356241,67377,67377,67377,0,0,0
10360732,933,8,9621946,9797695,10360732,563037,738786,563037,175749,0,0
10364911,946,8,9822965,9994856,10364911,370055,541946,370055,171891,0,0
10503614,901,1,9560986,9560986,10503614,942628,942628,942584,44,14,0
10521388,889,1,9560896,9560896,10521388,960492,960492,960429,63,20,0
10527765,964,1,10291099,10291099,10527765,236666,236666,236666,0,0,0
10647500,806,8,8666263,8893867,10647500,1753633,1981237,1066670,914567,3,0
10737021,966,8,10729202,10729202,10737021,7819,7819,7819,0,0,0
10741079,807,1,8678070,8827101,10741079,1913978,2063009,1734881,328128,104,0
10755380,953,8,9904293,10063523,10755380,691857,851087,691857,159230,0,0
10809054,892,1,9560923,9560923,10809054,1248131,1248131,1247129,1002,26,0
10865924,969,1,10817213,10817213,10865924,48711,48711,48711,0,0,0
10870312,963,2,10288886,10288886,10870312,581426,581426,581426,0,0,0
10885824,843,1,9318577,9318584,10885824,1567240,1567247,1553844,13403,70,0
10898799,955,8,9983541,10064188,10898799,834611,915258,834611,80647,0,0
10911851,714,4,7251689,8920184,10911851,1991667,3660162,1489781,2170381,36,0
10970119,970,8,10817519,10870312,10970119,99807,152600,99807,52793,0,0
10972206,836,8,9142146,9265667,10972206,1706539,1830060,1115672,714388,12,0
11041784,965,1,10646927,10646927,11041784,394857,394857,394857,0,0,0
11142695,298,4,4570030,4611894,11142695,6530801,6572665,1922754,4649911,15,0
11143625,907,1,9561023,9561030,11143625,1582595,1582602,1578241,4361,31,0
11160825,508,1,5839200,6129038,11160825,5031787,5321625,3391975,1929650,330,0
11286166,448,8,5654290,8016418,11286166,3269748,5631876,1274545,4357331,14,0
11295844,734,16,7409860,9309025,11295844,1986819,3885984,1016285,2869699,1,0
11404822,960,8,10224956,10224956,11404822,1179866,1179866,1179866,0,0,0
11412101,539,8,5920105,9300856,11412101,2111245,5491996,1306352,4185644,8,0
11424148,829,1,9089228,9344802,11424148,2079346,2334920,2059425,275495,130,0
11433747,930,1,9562335,9568656,11433747,1865091,1871412,1865091,6321,84,0
11468203,853,1,9318610,9397177,11468203,2071026,2149593,2063244,86349,123,0
11527272,666,4,6554555,9752939,11527272,1774333,4972717,1580403,3392314,26,0
11637975,923,1,9562278,9568853,11637975,2069122,2075697,2069122,6575,92,0
11718615,368,8,5214593,9307647,11718615,2410968,6504022,1457207,5046815,8,0
11767921,634,1,6486734,6796841,11767921,4971080,5281187,3386462,1894725,286,0
11806969,536,4,5918858,9772706,11806969,2034263,5888111,1581144,4306967,8,0
11808991,967,8,10730007,10737021,11808991,1071970,1078984,1071970,7014,0,0
11960480,281,4,4508009,4514225,11960480,7446255,7452471,1964410,5488061,10,0
11982210,166,8,3852784,10364911,11982210,1617299,8129426,1617299,6512127,0,0
12142815,888,1,9560890,9560890,12142815,2581925,2581925,2548806,33119,118,0
12217395,684,1,6880435,7203324,12217395,5014071,5336960,3421339,1915621,221,0
12258447,763,16,8040988,10898799,12258447,1359648,4217459,1359648,2857811,1,0
12310594,379,4,5284990,10647500,12310594,1663094,7025604,1623864,5401740,3,0
12466464,737,16,7557853,10972206,12466464,1494258,4908611,1494258,3414353,1,0
12762060,900,1,9560979,9571869,12762060,3190191,3201081,3127871,73210,122,0
12770738,517,4,5870152,10647500,12770738,2123238,6900586,1839739,5060847,12,0
12782346,599,1,6314494,7209870,12782346,5572476,6467852,3655431,2812421,190,0
12815792,764,16,8041056,11295844,12815792,1519948,4774736,1519948,3254788,0,0
12935562,801,16,8513322,11404822,12935562,1530740,4422240,1530740,2891500,0,0
13031436,453,8,5659730,11286166,13031436,1745270,7371706,1737991,5633715,3,0
13156193,971,1,10817570,10817570,13156193,2338623,2338623,2182663,155960,13,0
13396995,179,4,3979177,4522751,13396995,8874244,9417818,1973216,7444602,8,0
13413875,805,16,8517527,11806969,13413875,1606906,4896348,1606906,3289442,0,0
13424272,886,1,9498086,9498086,13424272,3926186,3926186,3502212,423974,128,0
13565409,123,8,3390490,11718615,13565409,1846794,10174919,1844772,8330147,2,0
13848587,208,8,4098825,11982210,13848587,1866377,9749762,1866377,7883385,1,0
13915531,691,16,7142056,12258447,13915531,1657084,6773475,1657084,5116391,0,0
13948088,351,4,5088196,11767921,13948088,2180167,8859892,2026656,6833236,4,0
13995957,839,32,9308070,13915531,13995957,80426,4687887,80426,4607461,0,0
13998046,624,1,6482599,7214602,13998046,6783444,7515447,4016668,3498779,155,0
14380367,571,4,6083344,12310594,14380367,2069773,8297023,2069773,6227250,0,0
14446869,785,8,8173466,12466464,14446869,1980405,6273403,1980405,4292998,0,0
14514291,968,8,10805328,12466464,14514291,2047827,3708963,2047827,1661136,0,0
14544270,4,1,966542,966542,14544270,13577728,13577728,7835151,5742577,268,0
14804647,841,32,9313816,13995957,14804647,808690,5490831,808690,4682141,0,0
14914124,101,8,3077111,3105119,14914124,11809005,11837013,2915419,8921594,1,0
14970063,431,8,5549352,12815792,14970063,2154271,9420711,2154271,7266440,0,0
14984164,319,4,4751993,12770738,14984164,2213426,10232171,2213426,8018745,2,0
15115368,103,8,3179744,12935562,15115368,2179806,11935624,2179806,9755818,0,0
15245367,952,8,9904218,12935562,15245367,2309805,5341149,2309805,3031344,0,0
15518069,185,4,3994609,4622753,15518069,10895316,11523460,2494418,9029042,2,0
15631708,608,4,6440206,13031436,15631708,2600272,9191502,2600272,6591230,0,0
15746016,705,1,7229868,9503587,15746016,6242429,8516148,4486700,4029448,82,0
15880392,789,32,8334448,14804647,15880392,1075745,7545944,1075745,6470199,0,0
15921887,139,8,3585839,13413875,15921887,2508012,12336048,2508012,9828036,0,0
16009029,173,8,3910611,13413875,16009029,2595154,12098418,2595154,9503264,0,0
16013220,492,4,5799365,13396995,16013220,2616225,10213855,2616225,7597630,2,0
16075357,279,4,4505268,13424272,16075357,2651085,11570089,2651085,8919004,3,0
16195288,227,1,4238503,4238503,16195288,11956785,11956785,4937645,7019140,156,0
16541386,458,4,5691065,13848587,16541386,2692799,10850321,2660242,8190079,3,0
16743432,937,8,9717883,13565409,16743432,3178023,7025549,2646685,4378864,2,0
17078005,545,4,5967213,13848587,17078005,3229418,11110792,2764582,8346210,2,0
17199788,325,8,4952491,14514291,17199788,2685497,12247297,2685497,9561800,0,0
17571592,824,1,8998764,9525570,17571592,8046022,8572828,4659385,3913443,65,0
17671591,866,8,9323676,14914124,17671591,2757467,8347915,2757467,5590448,0,0
17737715,152,8,3772318,14970063,17737715,2767652,13965397,2767652,11197745,1,0
17793909,537,4,5918952,14984164,17793909,2809745,11874957,2809745,9065212,0,0
17998639,491,4,5790362,15115368,17998639,2883271,12208277,2883271,9325006,0,0
18013125,518,4,5871027,15115368,18013125,2897757,12142098,2897757,9244341,1,0
18191080,330,8,5030414,15245367,18191080,2945713,13160666,2945713,10214953,0,0
18503478,469,4,5709221,15518069,18503478,2985409,12794257,2985409,9808848,1,0
18543372,234,1,4238526,4486257,18543372,14057115,14304846,5119517,9185329,102,0
18569985,804,16,8517361,15880392,18569985,2689593,10052624,2689593,7363031,0,0
18618484,690,16,7063550,15880392,18618484,2738092,11554934,2738092,8816842,0,0
18667423,668,4,6588873,15631708,18667423,3035715,12078550,3035715,9042835,2,0
18914908,157,8,3780272,15921887,18914908,2993021,15134636,2993021,12141615,0,0
19037583,138,8,3583341,16009029,19037583,3028554,15454242,3028554,12425688,0,0
19108884,371,8,5281775,16075357,19108884,3033527,13827109,3033527,10793582,0,0
19635172,710,4,7244582,16013220,19635172,3621952,12390590,3155923,9234667,1,0
19823467,219,8,4207092,16743432,19823467,3080035,15616375,3080035,12536340,0,0
20237616,678,4,6636526,17078005,20237616,3159611,13601090,3159611,10441479,0,0
20429384,132,8,3572883,17199788,20429384,3229596,16856501,3229596,13626905,0,0
20567419,604,1,6435049,9629878,20567419,10937541,14132370,5225950,8906420,36,0
20954244,160,8,3828965,17671591,20954244,3282653,17125279,3282653,13842626,0,0
21030043,155,8,3775315,17737715,21030043,3292328,17254728,3292328,13962400,0,0
21488269,119,8,3307318,17998639,21488269,3489630,18180951,3489630,14691321,0,0
21651620,178,4,3976270,17793909,21651620,3857711,17675350,3843225,13832125,1,0
21766080,210,8,4099456,18191080,21766080,3575000,17666624,3575000,14091624,0,0
22179240,872,8,9352960,18569985,22179240,3609255,12826280,3609255,9217025,0,0
22200357,601,1,6435016,9640631,22200357,12559726,15765341,6110639,9654702,29,0
22238517,182,8,3993416,18569985,22238517,3668532,18245101,3668532,14576569,0,0
22367043,498,4,5805669,18503478,22367043,3863565,16561374,3863565,12697809,1,0
22459787,538,8,5920075,18618484,22459787,3841303,16539712,3841303,12698409,0,0
22531326,683,8,6713307,18618484,22531326,3912842,15818019,3912842,11905177,0,0
22721789,546,4,5967229,18667423,22721789,4054366,16754560,4054366,12700194,0,0
22856310,131,8,3556332,18914908,22856310,3941402,19299978,3941402,15358576,0,0
23050895,939,8,9722372,19037583,23050895,4013312,13328523,4013312,9315211,0,0
23219873,317,4,4748477,19108884,23219873,4110989,18471396,4110989,14360407,0,0
23331621,294,4,4531321,19108884,23331621,4222737,18800300,4222737,14577563,0,0
23826042,92,1,2372766,2372766,23826042,21453276,21453276,7937697,13515579,37,0
23869104,176,4,3960108,19635172,23869104,4233932,19908996,4233932,15675064,0,0
24098907,129,8,3514079,19823467,24098907,4275440,20584828,4275440,16309388,0,0
24709744,271,8,4389136,20429384,24709744,4280360,20320608,4280360,16040248,0,0
24748536,284,4,4522057,20237616,24748536,4510920,20226479,4510920,15715559,1,0
24940777,596,1,6307815,9740193,24940777,15200584,18632962,6410151,12222811,12,0
25234889,803,8,8516889,20954244,25234889,4280645,16718000,4280645,12437355,0,0
25479532,2,8,724670,724670,25479532,24754862,24754862,7635430,17119432,1,0
25993777,292,8,4525638,21488269,25993777,4505508,21468139,4505508,16962631,0,0
26274303,735,8,7537843,21766080,26274303,4508223,18736460,4508223,14228237,0,0
26408879,277,4,4488504,21651620,26408879,4757259,21920375,4757259,17163116,1,0
26705401,677,8,6619673,22179240,26705401,4526161,20085728,4526161,15559567,0,0
26774196,828,8,9041075,22238517,26774196,4535679,17733121,4535679,13197442,0,0
26998017,241,1,4238549,4549375,26998017,22448642,22759468,6437804,16321664,11,0
27151055,485,8,5746918,22459787,27151055,4691268,21404137,4691268,16712869,0,0
27265794,190,4,3999219,22367043,27265794,4898751,23266575,4898751,18367824,1,0
27393121,323,8,4951959,22531326,27393121,4861795,22441162,4861795,17579367,0,0
27728938,802,8,8516854,22856310,27728938,4872628,19212084,4872628,14339456,0,0
27746122,527,4,5888974,22721789,27746122,5024333,21857148,5024333,16832815,1,0
28116880,146,8,3670480,23050895,28116880,5065985,24446400,5065985,19380415,1,0
28417190,488,4,5779955,23219873,28417190,5197317,22637235,5197317,17439918,1,0
28576931,526,4,5884574,23331621,28576931,5245310,22692357,5245310,17447047,0,0
28689442,707,1,7229875,22200357,28689442,6489085,21459567,6489085,14970482,11,0
29350608,184,4,3994590,23869104,29350608,5481504,25356018,5481504,19874514,1,0
29492810,688,16,6998093,24709744,29492810,4783066,22494717,4783066,17711651,0,0
30063199,754,8,7911064,24098907,30063199,5964292,22152135,5439147,16712988,1,0
30323766,460,4,5699331,24748536,30323766,5575230,24624435,5575230,19049205,1,0
30372316,74,1,2353471,2353471,30372316,28018845,28018845,8115009,19903836,8,0
30984364,163,8,3832267,25479532,30984364,5504832,27152097,5504832,21647265,0,0
31487655,72,1,2353435,2353435,31487655,29134220,29134220,8115649,21018571,6,0
31544967,100,8,2918990,25993777,31544967,5551190,28625977,5551190,23074787,1,0
31841625,107,8,3211674,26274303,31841625,5567322,28629951,5567322,23062629,1,0
32035803,297,4,4534242,26408879,32035803,5626924,27501561,5626924,21874637,1,0
32282939,769,8,8055147,26705401,32282939,5577538,24227792,5577538,18650254,1,0
32663779,654,4,6509257,26774196,32663779,5889583,26154522,5889583,20264939,0,0
32762926,481,4,5735152,26774196,32762926,5988730,27027774,5988730,21039044,1,0
33410746,418,4,5399317,27151055,33410746,6259691,28011429,6259691,21751738,0,0
33633388,447,8,5654281,27265794,33633388,6367594,27979107,6367594,21611513,0,0
33663096,56,1,2323019,2323019,33663096,31340077,31340077,8264266,23075811,6,0
33910467,436,4,5574140,27151055,33910467,6759412,28336327,6632085,21704242,1,0
34070198,663,4,6510903,27393121,34070198,6677077,27559295,6677077,20882218,1,0
34453445,452,4,5659723,27728938,34453445,6724507,28793722,6724507,22069215,0,0
34672474,216,8,4117554,27746122,34672474,6926352,30554920,6926352,23628568,1,0
35114664,213,8,4100763,28116880,35114664,6997784,31013901,6997784,24016117,1,0
35464360,631,1,6483706,27728938,35464360,7735422,28980654,7064354,21916300,1,0
35523164,612,1,6477889,27728938,35523164,7794226,29045275,7123158,21922117,1,0
35726820,662,4,6510898,28576931,35726820,7149889,29215922,7149889,22066033,0,0
35742294,70,1,2353402,2353402,35742294,33388892,33388892,8911092,24477800,6,0
35796278,63,1,2341283,2341283,35796278,33454995,33454995,8977195,24477800,6,0
36127409,71,1,2353425,2353425,36127409,33773984,33773984,9006748,24767236,4,0
36500961,108,8,3221514,29492810,36500961,7008151,33279447,7008151,26271296,0,0
36609852,168,8,3854783,29492810,36609852,7117042,32755069,7117042,25638027,0,0
37395698,49,1,1945509,1945509,37395698,35450189,35450189,10021787,25428402,5,0
37428150,767,8,8054934,30063199,37428150,7364951,29373216,7364951,22008265,0,0
37476608,21,1,1943846,1943846,37476608,35532762,35532762,10092765,25439997,4,0
37503802,25,1,1943885,1943885,37503802,35559917,35559917,10119920,25439997,5,0
38313343,248,1,4238572,29350608,38313343,8962735,34074771,8962735,25112036,4,0
38335508,682,4,6711622,30323766,38335508,8011742,31623886,8011742,23612144,1,0
38429018,331,8,5030418,30984364,38429018,7444654,33398600,7444654,25953946,0,0
39338195,239,1,4238543,30372316,39338195,8965879,35099652,8965879,26133773,2,0
39989542,261,8,4257328,31544967,39989542,8444575,35732214,8444575,27287639,1,0
40338879,533,8,5907010,31841625,40338879,8497254,34431869,8497254,25934615,1,0
40453569,240,1,4238546,31487655,40453569,8965914,36215023,8965914,27249109,3,0
40988649,758,8,7967236,32282939,40988649,8705710,33021413,8705710,24315703,0,0
41572190,706,1,7229871,32035803,41572190,9536387,34342319,9536387,24805932,2,0
41650275,554,1,5983202,32035803,41650275,9614472,35667073,9614472,26052601,2,0
41847739,54,1,1945555,1945555,41847739,39902184,39902184,11776992,28125192,6,0
41996631,197,4,4022175,32762926,41996631,9233705,37974456,9233705,28740751,0,0
42440884,450,8,5655933,33633388,42440884,8807496,36784951,8807496,27977455,0,0
42543485,745,1,7785948,32035803,42543485,10507682,34757537,10507682,24249855,4,0
43236256,461,4,5702448,33910467,43236256,9325789,37533808,9325789,28208019,0,0
43268452,97,1,2530524,2530524,43268452,40737928,40737928,11984760,28753168,8,0
43479366,8,1,1245386,1245386,43479366,42233980,42233980,13480812,28753168,9,0
43544029,201,8,4072683,34672474,43544029,8871555,39471346,8871555,30599791,0,0
43871204,555,1,5983205,32663779,43871204,11207425,37887999,11207425,26680574,6,0
44167081,686,8,6997386,35114664,44167081,9052417,37169695,9052417,28117278,0,0
44287455,471,4,5709282,34453445,44287455,9834010,38578173,9834010,28744163,0,0
44691932,76,1,2353494,2353494,44691932,42338438,42338438,13585270,28753168,12,0
45654259,718,8,7314985,36500961,45654259,9153298,38339274,9153298,29185976,0,0
45664576,203,4,4072721,35726820,45664576,9937756,41591855,9937756,31654099,0,0
45797505,870,8,9352373,36609852,45797505,9187653,36445132,9187653,27257479,0,0
45855569,462,4,5702462,35796278,45855569,10059291,40153107,10059291,30093816,0,0
46025702,618,1,6477920,33410746,46025702,12614956,39547782,12614956,26932826,9,0
46053554,0,1,0,0,46053554,46053554,46053554,16553419,29500135,15,0
46564989,7,1,1245348,1245348,46564989,45319641,45319641,15819506,29500135,18,0
46762054,109,8,3232960,37428150,46762054,9333904,43529094,9333904,34195190,0,0
47288545,626,1,6482611,33410746,47288545,13877799,40805934,13877799,26928135,15,0
47870810,172,4,3910570,3910570,47870810,43960240,43960240,10367049,33593191,1,0
48150900,619,1,6477925,33663096,48150900,14487804,41672975,14487804,27185171,17,0
48272198,439,8,5609800,38429018,48272198,9843180,42662398,9843180,32819218,0,0
48667965,65,1,2345983,2345983,48667965,46321982,46321982,16162395,30159587,21,0
48712760,68,1,2353317,2353317,48712760,46359443,46359443,16199856,30159587,22,0
48800317,350,1,5088087,34070198,48800317,14730119,43712230,14730119,28982111,18,0
48854348,262,4,4265546,38335508,48854348,10518840,44588802,10518840,34069962,1,0
48906434,45,1,1945474,1945474,48906434,46960960,46960960,16801373,30159587,24,0
50027703,689,16,7063496,40338879,50027703,9688824,42964207,9688824,33275383,0,0
51094455,693,8,7188172,39989542,51094455,11104913,43906283,10455143,33451140,1,0
51537228,696,1,7219983,35464360,51537228,16072868,44317245,14932196,29385049,17,0
52585963,175,4,3959858,41996631,52585963,10589332,48626105,10589332,38036773,0,0
53173058,161,8,3829332,42440884,53173058,10732174,49343726,10732174,38611552,0,0
54586268,244,1,4238559,35523164,54586268,19063104,50347709,15629291,34718418,14,0
55152207,154,8,3774084,43544029,55152207,11608178,51378123,11608178,39769945,0,0
55999929,383,4,5303101,43236256,55999929,12763673,50696828,12763673,37933155,0,0
57297248,349,8,5079170,44167081,57297248,13130167,52218078,13130167,39087911,0,0
58089596,37,1,1943971,1943971,58089596,56145625,56145625,19683845,36461780,19,0
58887597,115,8,3251335,45654259,58887597,13233338,55636262,13233338,42402924,0,0
59125625,547,4,5967243,44287455,59125625,14838170,53158382,14838170,38320212,0,0
59764274,42,1,1945418,1945418,59764274,57818856,57818856,20157236,37661620,18,0
59952404,136,8,3575962,45797505,59952404,14154899,56376442,14154899,42221543,0,0
60102427,13,1,1943781,1943781,60102427,58158646,58158646,20418941,37739705,17,0
60443282,89,1,2372749,2372749,60443282,58070533,58070533,20133364,37937169,17,0
60506924,558,4,6045015,45664576,60506924,14842348,54461909,14842348,39619561,0,0
60754738,559,4,6045026,45855569,60754738,14899169,54709712,14899169,39810543,0,0
61572467,79,1,2353535,2353535,61572467,59218932,59218932,20586017,38632915,18,0
61885298,169,8,3855623,46762054,61885298,15123244,58029675,15123244,42906431,0,0
62439912,62,1,2341233,2341233,62439912,60098679,60098679,20740797,39357882,18,0
62845396,85,1,2357366,2357366,62845396,60488030,60488030,20919234,39568796,18,0
63412501,11,1,1714609,1714609,63412501,61697892,61697892,21737258,39960634,17,0
63475443,316,4,4748470,47870810,63475443,15604633,58726973,15604633,43122340,0,0
64049363,795,16,8462645,50027703,64049363,14021660,55586718,14021660,41565058,0,0
64330881,83,1,2353718,2353718,64330881,61977163,61977163,21195801,40781362,15,0
64773747,441,8,5611975,48272198,64773747,16501549,59161772,16501549,42660223,0,0
65431264,667,4,6554564,48854348,65431264,16576916,58876700,16576916,42299784,0,0
65689754,867,1,9350020,46025702,65689754,19664052,56339734,19664052,36675682,10,0
67480013,602,1,6435021,46053554,67480013,21426459,61044992,21426459,39618533,12,0
67682724,334,8,5061663,51094455,67682724,16588269,62621061,16588269,46032792,0,0
69157530,632,1,6483711,46564989,69157530,22592541,62673819,22592541,40081278,12,0
69298209,664,4,6510910,51537228,69298209,17760981,62787299,17760981,45026318,0,0
69768491,183,8,3993843,53173058,69768491,16595433,65774648,16595433,49179215,0,0
69944256,245,1,4238563,47288545,69944256,22655711,65705693,22655711,43049982,12,0
70515091,543,4,5961299,52585963,70515091,17929128,64553792,17929128,46624664,1,0
71027754,610,1,6472782,48150900,71027754,22876854,64554972,22876854,41678118,12,0
71986598,187,8,3994883,55152207,71986598,16834391,67991715,16834391,51157324,0,0
73156959,16,1,1943802,1943802,73156959,71213157,71213157,26455762,44757395,19,0
73993430,308,4,4710494,55999929,73993430,17993501,69282936,17993501,51289435,1,0
74213737,393,8,5305810,57297248,74213737,16916489,68907927,16916489,51991438,1,0
76255681,28,1,1943923,1943923,76255681,74311758,74311758,26460528,47851230,19,0
76631039,442,8,5611979,58887597,76631039,17743442,71019060,17743442,53275618,1,0
77881758,158,8,3817947,59952404,77881758,17929354,74063811,17929354,56134457,0,0
78819544,145,8,3668737,60754738,78819544,18064806,75150807,18064806,57086001,0,0
78843793,306,4,4710459,59125625,78843793,19718168,74133334,19718168,54415166,4,0
79875970,91,1,2372761,2372761,79875970,77503209,77503209,26061094,51442115,23,0
80551988,400,8,5321019,61885298,80551988,18666690,75230969,18666690,56564279,0,0
81252624,762,16,8040909,64049363,81252624,17203261,73211715,17203261,56008454,0,0
81920139,704,1,7229865,48906434,81920139,33013705,74690274,24786659,49903615,10,0
84283932,278,4,4494277,60506924,84283932,23777008,79789655,21056303,58733352,1,0
84632052,207,8,4098822,64773747,84632052,19858305,80533230,19858305,60674925,0,0
85216104,642,1,6495752,60102427,85216104,25113677,78720352,25113677,53606675,9,0
86916968,73,1,2353463,2353463,86916968,84563505,84563505,28030793,56532712,21,0
88750620,877,1,9375612,61572467,88750620,27178153,79375008,27178153,52196855,8,0
88835798,501,8,5818917,67682724,88835798,21153074,83016881,21153074,61863807,0,0
90890575,611,1,6472830,62439912,90890575,28450663,84417745,28450663,55967082,8,0
91764177,564,1,6050374,62845396,91764177,28918781,85713803,28918781,56795022,7,0
92907117,121,8,3336253,69298209,92907117,23608908,89570864,23608908,65961956,0,0
93386706,390,8,5305183,69768491,93386706,23618215,88081523,23618215,64463308,0,0
96394419,694,8,7188203,71986598,96394419,24407821,89206216,24407821,64798395,0,0
96450101,27,1,1943907,1943907,96450101,94506194,94506194,34985762,59520432,27,0
97372511,15,1,1943792,1943792,97372511,95428719,95428719,34989907,60438812,25,0
98250235,869,8,9352358,73156959,98250235,25093276,88897877,25093276,63804601,0,0
98476155,17,1,1943808,1943808,98476155,96532347,96532347,34993152,61539195,28,0
99389881,236,1,4238533,65431264,99389881,33958617,95151348,33958617,61192731,11,0
99414081,333,8,5061660,74213737,99414081,25200344,94352421,25200344,69152077,0,0
100749834,625,1,6482605,65431264,100749834,35318570,94267229,34482099,59785130,12,0
102603185,327,8,4968494,76631039,102603185,25972146,97634691,25972146,71662545,0,0
102647499,220,1,4211443,65431264,102647499,37216235,98436056,35733717,62702339,12,0
103620315,39,1,1945383,1945383,103620315,101674932,101674932,37823894,63851038,33,0
104209517,833,16,9129154,78819544,104209517,25389973,95080363,25389973,69690390,0,0
105529225,33,1,1943947,1943947,105529225,103585278,103585278,37943981,65641297,38,0
105968026,9,8,1429823,1429823,105968026,104538203,104538203,28776753,75761450,2,0
108469197,873,8,9352975,81252624,108469197,27216573,99116222,27216573,71899649,0,0
108582328,134,8,3573973,81252624,108582328,27329704,105008355,27329704,77678651,0,0
110483583,253,1,4238590,69157530,110483583,41326053,106244993,37010449,69234544,11,0
113032718,206,8,4098818,84283932,113032718,28748786,108933900,28748786,80185114,0,0
113215100,230,1,4238513,70515091,113215100,42700009,108976587,37013175,71963412,9,0
114822730,572,4,6083370,79875970,114822730,34946760,108739360,34598640,74140720,4,0
118657382,249,1,4238576,71027754,118657382,47629628,114418806,39898625,74520181,7,0
120019464,574,8,6135603,88835798,120019464,31183666,113883861,31183666,82700195,0,0
120589508,473,4,5709310,84632052,120589508,35957456,114880198,35957456,78922742,3,0
124892098,120,8,3336208,92907117,124892098,31984981,121555890,31984981,89570909,0,0
125228471,616,1,6477911,78843793,125228471,46384678,118750560,41044544,77706016,7,0
125406870,211,8,4099614,93386706,125406870,32020164,121307256,32020164,89287092,0,0
127202558,217,1,4126763,78843793,127202558,48358765,123075795,41317767,81758028,7,0
128415414,209,8,4099352,96394419,128415414,32020995,124316062,32020995,92295067,0,0
130957958,865,8,9323577,98250235,130957958,32707723,121634381,32707723,88926658,0,0
132687458,96,8,2471567,2895433,132687458,129792025,130215891,34153815,96062076,1,0
133106030,594,1,6307606,88750620,133106030,44355410,126798424,44355410,82443014,8,0
135919656,628,1,6483527,90890575,135919656,45029081,129436129,45029081,84407048,7,0
137731435,606,1,6435092,91764177,137731435,45967258,131296343,45967258,85329085,8,0
140122288,99,8,2918986,102603185,140122288,37519103,137203302,37519103,99684199,0,0
143810652,87,1,2372737,2372737,143810652,141437915,141437915,48879883,92558032,42,0
145270549,82,1,2353661,2353661,145270549,142916888,142916888,49436446,93480442,46,0
145437171,167,8,3854780,104209517,145437171,41227654,141582391,41227654,100354737,0,0
145880488,687,8,6997579,104209517,145880488,41670971,138882909,41670971,97211938,0,0
148620496,282,8,4513730,105968026,148620496,42652470,144106766,42652470,101454296,0,0
149683099,646,1,6495875,98476155,149683099,51206944,143187224,51206944,91980280,8,0
150858236,60,1,2341107,2341107,150858236,148517129,148517129,53019317,95497812,51,0
151033269,276,4,4483075,105529225,151033269,45504044,146550194,45504044,101046150,3,0
152164638,370,8,5232515,108469197,152164638,43695441,146932123,43695441,103236682,2,0
153187088,440,8,5609804,108582328,153187088,44604760,147577284,44604760,102972524,2,0
157240807,19,1,1943819,1943819,157240807,155296988,155296988,53480615,101816373,49,0
158478269,113,8,3244307,113032718,158478269,45445551,155233962,45445551,109788411,2,0
166733693,609,1,6472517,102647499,166733693,64086194,160261176,56400319,103860857,4,0
172934259,218,8,4207065,120019464,172934259,52914795,168727194,52914795,115812399,0,0
173329598,29,1,1943927,1943927,173329598,171385671,171385671,62359670,109026001,47,0
175264381,36,1,1943965,1943965,175264381,173320416,173320416,62385505,110934911,47,0
184161218,93,1,2372773,2372773,184161218,181788445,181788445,70853534,110934911,50,0
186118019,563,1,6050371,114822730,186118019,71295289,180067648,71295289,108772359,3,0
189353389,149,8,3675831,124892098,189353389,64461291,185677558,64461291,121216267,0,0
192464162,180,8,3991832,125406870,192464162,67057292,188472330,67057292,121415038,0,0
192637141,242,1,4238553,118657382,192637141,73979759,188398588,73979759,114418829,2,0
198924682,67,1,2352468,2352468,198924682,196572214,196572214,79862770,116709444,52,0
199191135,204,8,4098805,128415414,199191135,70775721,195092330,70775721,124316609,0,0
199716684,78,1,2353524,2353524,199716684,197363160,197363160,80653716,116709444,54,0
199735154,77,1,2353516,2353516,199735154,197381638,197381638,80672194,116709444,56,0
206830083,250,1,4238580,120589508,206830083,86240575,202591503,86240575,116350928,5,0
208642470,311,8,4720969,130957958,208642470,77684512,203921501,77684512,126236989,0,0
211473057,229,1,4238510,125228471,211473057,86244586,207234547,86244586,120989961,5,0
214865419,40,1,1945403,1945403,214865419,212920016,212920016,89597522,123322494,56,0
220935084,20,1,1943835,1943835,220935084,218991249,218991249,90183855,128807394,54,0
221154932,26,1,1943901,1943901,221154932,219211031,219211031,90403637,128807394,55,0
221364678,293,8,4527914,140122288,221364678,81242390,216836764,81242390,135594374,0,0
222734423,405,1,5343745,132687458,222734423,90046965,217390678,90046965,127343713,0,0
230277922,324,8,4951999,145437171,230277922,84840751,225325923,84840751,140485172,0,0
230501353,52,1,1945545,1945545,230501353,228555808,228555808,99748414,128807394,57,0
231446681,31,1,1943937,1943937,231446681,229502744,229502744,100695350,128807394,59,0
235070455,840,32,9312655,230277922,235070455,4792533,225757800,4792533,220965267,0,0
239211630,254,1,4242644,132687458,239211630,106524172,234968986,106524172,128444814,2,0
243112776,934,32,9632785,235070455,243112776,8042321,233479991,8042321,225437670,0,0
248289492,69,1,2353391,2353391,248289492,245936101,245936101,117124436,128811665,61,0
259422770,59,1,2326970,2326970,259422770,257095800,257095800,128284135,128811665,63,0
265463386,48,1,1945503,1945503,265463386,263517883,263517883,134287646,129230237,63,0
281764323,12,1,1943248,1943248,281764323,279821075,279821075,147777212,132043863,65,0
286209191,150,8,3698317,145880488,286209191,140328703,282510874,140328703,142182171,0,0
293564479,51,1,1945520,1945520,293564479,291618959,291618959,157763317,133855642,67,0
315139465,326,8,4959086,148620496,315139465,166518969,310180379,166518969,143661410,0,0
316524776,90,1,2372756,2372756,316524776,314152020,314152020,174217161,139934859,68,0
317985633,88,1,2372744,2372744,317985633,315612889,315612889,174218133,141394756,69,0
324291760,84,1,2354619,2354619,324291760,321937141,321937141,176129835,145807306,69,0
327493661,75,1,2353483,2353483,327493661,325140178,325140178,178138261,147001917,68,0
329783368,392,8,5305807,152164638,329783368,177618730,324477561,177618730,146858831,0,0
332343888,391,8,5305187,153187088,332343888,179156800,327038701,179156800,147881901,0,0
336872084,3,1,945683,945683,336872084,335926401,335926401,188749451,147176950,70,0
348916845,95,8,2471552,158478269,348916845,190438576,346445293,190438576,156006717,0,0
357506556,43,1,1945454,1945454,357506556,355561102,355561102,208384152,147176950,73,0
368773448,50,1,1945514,1945514,368773448,366827934,366827934,219650984,147176950,75,0
370749769,35,1,1943959,1943959,370749769,368805810,368805810,221628860,147176950,77,0
377697644,23,1,1943861,1943861,377697644,375753783,375753783,222369295,153384488,76,0
399269126,80,1,2353564,2353564,399269126,396915562,396915562,234038188,162877374,76,0
414803244,46,1,1945483,1945483,414803244,412857761,412857761,243779821,169077940,77,0
415600424,98,8,2746135,189353389,415600424,226247035,412854289,226247035,186607254,0,0
444268687,81,1,2353630,2353630,444268687,441915057,441915057,272836421,169078636,78,0
447165904,573,8,6135599,192464162,447165904,254701742,441030305,254701742,186328563,0,0
453487424,94,1,2372779,2372779,453487424,451114645,451114645,282036009,169078636,79,0
466279993,14,1,1943786,1943786,466279993,464336207,464336207,295257571,169078636,80,0
496609006,127,8,3512880,199191135,496609006,297417871,493096126,297417871,195678255,0,0
512105975,44,1,1945464,1945464,512105975,510160511,510160511,341081875,169078636,83,0
515272445,34,1,1943953,1943953,515272445,513328492,513328492,344249856,169078636,89,0
562878017,10,1,1639747,1639747,562878017,561238270,561238270,392159634,169078636,95,0
563215279,5,1,1245115,1245115,563215279,561970164,561970164,392891528,169078636,103,0
616078864,61,1,2341194,2341194,616078864,613737670,613737670,444263695,169473975,115,0
630880505,6,1,1245337,1245337,630880505,629635168,629635168,458042975,171592193,179,0
